id,name,da_ban,sku,price,list_price,discount,discount_rate,review_count,category
58132909,"Sống, Làm Việc Và Yêu",21.0,8259298798089,118100,139000,20900,15,2,nha-sach-tiki
67991602,Đừng Làm Việc Chăm Chỉ Hãy Làm Việc Thông Minh,4.0,5192596929430,131250,175000,43750,25,0,nha-sach-tiki
262977989,Kế Toán Vỉa Hè - Thực Hành Báo Cáo Tài Chính Căn Bản Từ Quầy Bán Nước Chanh,13631.0,9472868482700,169000,199000,30000,15,271,nha-sach-tiki
272422879,Truyện Ehon bé 3-4-5 tuổi - Bộ 4 cuốn Phát triển sáng tạo,72.0,8676821081453,194000,194000,0,0,12,nha-sach-tiki
55319105,Những Quy Luật Của Bản Chất Con Người,1185.0,9806315321486,240000,300000,60000,20,196,nha-sach-tiki
277809376,Tư duy dã tràng - Tim trí giao tranh,108.0,6179999342527,119000,160000,41000,26,2,nha-sach-tiki
277770425,"Hồi Ký Nguyễn Thị Bình - Gia Đình, Bạn Bè và Đất Nước",3.0,5135233071781,151000,159000,8000,5,0,nha-sach-tiki
277748735,"Hồi Ký Nguyễn Thị Bình - Gia Đình, Bạn Bè, Đất Nước - Omega Plus",304.0,5403820741864,151000,159000,8000,5,5,nha-sach-tiki
277728224,"Nói Chuyện Là Bản Năng, Giữ Miệng Là Tu Dưỡng, Im Lặng Là Trí Tuệ",8781.0,8328117300409,127000,189000,62000,33,417,nha-sach-tiki
277607921,Nghĩ khác - Làm khác,109.0,8034881062025,131400,179000,47600,27,2,nha-sach-tiki
271729831,Sách - Combo 4 Cuốn Lén Nhặt Chuyện Đời + Dẫu Có Ra Đi Vẫn Sẽ Cười + Ai Rồi Cũng Sẽ Bình Yên + Lữ Khách Ven Đường (Sbooks),381.0,8895405993267,199000,380000,181000,48,40,nha-sach-tiki
271631013,Truyện Ehon bé 1-2-3 tuổi - Bộ 4 cuốn Em bé biết yêu thương,0.0,5960994616520,187000,187000,0,0,0,nha-sach-tiki
57815506,Sách Tư Duy Ngược Dịch Chuyển Thế Giới,0.0,5711422372945,151300,178000,26700,15,0,nha-sach-tiki
277748886,TÂN PHÙ THỦY TÀI CHÍNH - Đối Thoại Cùng Những Nhà Giao Dịch Hàng Đầu Nước Mỹ (The New Market Wizards),7.0,5759275872659,399000,399000,0,0,0,nha-sach-tiki
179072427,Sách: Bộ Việt Kiệu Thư (3 Tập) - MaiHaBooks,49.0,7385448175393,1256000,1570000,314000,20,8,nha-sach-tiki
277358711,Mưa Đỏ - Chu Lai,191.0,8312487174692,153750,205000,51250,25,16,nha-sach-tiki
276960030,Khi Mọi Điều Không Như Ý,860.0,7888506246746,80600,109000,28400,26,32,nha-sach-tiki
276948798,"Lên Đỉnh Núi Mở Tiệm Bánh Mì - Triết lí Wazawaza: Những con người hạnh phúc, 2 loại bánh mì, và doanh thu thường niên 300 triệu Yên",1286.0,2551569601283,99000,120000,21000,18,36,nha-sach-tiki
276922095,Thế Hệ Lo Âu,551.0,5870044247876,159400,229000,69600,30,21,nha-sach-tiki
276346703,Combo 4 cuốn: ChatGPT + ChatGPT thực chiến + AI 5.0 + AI Công cụ nâng cao hiệu suất,2.0,1113700093725,608000,716000,108000,15,0,nha-sach-tiki
190843478,COMBO 4 - (TRÍ TUỆ CỦA NGƯỜI XƯA - ĐẠO LÝ NGƯỜI XƯA - HIỂU NGƯỜI để DÙNG NGƯỜI - CỔ HỌC TINH HOA) - MINH TRIẾT PHƯƠNG ĐÔNG,9.0,3131508636029,582000,582000,0,0,2,nha-sach-tiki
275512528,Sách Word Soạn Thảo Văn Bản Ứng Dụng Tin Học Thực Tế Từ Cơ Bản Đến Nâng Cao Có Tặng Kèm Video Hướng Dẫn,38.0,5369923164777,198000,225000,27000,12,4,nha-sach-tiki
109515304,Truyện Cổ Grim 1,7.0,3096223188275,199500,210000,10500,5,2,nha-sach-tiki
76045394,Combo 50 cái bao lì xì nhỏ + tặng 20 thẻ treo cành mai/đào (mẫu ngẫu nhiên)-BLX01,21.0,4516831937829,40000,40000,0,0,2,nha-sach-tiki
273733183,Sách - Hết Thảy Chúng Ta Đều Là Quá Khứ - SBOOKS,5.0,1440386915809,79000,118000,39000,33,0,nha-sach-tiki
275948240,Same As Ever: Quy Luật Bất Biến Về Bản Chất Con Người Và Tâm Lý Làm Giàu,1.0,9134834976118,186000,219000,33000,15,0,nha-sach-tiki
275905148,Nâng Cao Tần Số Năng Lượng Cá Nhân,288.0,1827938321527,125000,179000,54000,30,11,nha-sach-tiki
275702538,Chat GPT Thực Chiến,69.0,3188639955884,121680,169000,47320,28,1,nha-sach-tiki
275599939,Sưởi Ấm Mặt Trời: Tập 2 Của Cây Cam Ngọt,2297.0,5207908422455,120000,160000,40000,25,138,nha-sach-tiki
275406600,Dẫn Dắt Một Bầy Sói Hay Chăn Một Đàn Cừu,36.0,8268219402991,140400,195000,54600,28,2,nha-sach-tiki
274363543,Con Đường Chẳng Mấy Ai Đi,3311.0,6778152837712,115000,165000,50000,30,182,nha-sach-tiki
273819808,Tâm Lý Học Về Tiền,27413.0,3092195659088,127000,189000,62000,33,3693,nha-sach-tiki
271380890,Đúng Việc,16321.0,2175212721938,87000,125000,38000,30,936,nha-sach-tiki
271379451,Lý Thuyết Trò Chơi,9257.0,8865080400814,125000,179000,54000,30,456,nha-sach-tiki
263070154,Giải mã Hoóc-môn Dopamine,3643.0,3183328469252,140000,198000,58000,29,242,nha-sach-tiki
262590428,Búp Sen Xanh,2842.0,7899223661173,52700,72000,19300,27,191,nha-sach-tiki
249876840,"Beartown - Thị trấn nhỏ, giấc mơ lớn",1132.0,4754647446871,131000,210000,79000,38,99,nha-sach-tiki
212597849,Bookmark kẹp sách giấy cứng,3139.0,9995489672755,9000,9000,0,0,2,nha-sach-tiki
207256575,Định luật Murphy – Mọi bí mật tâm lý thao túng cuộc đời bạn,7946.0,1888647655871,83600,119000,35400,30,594,nha-sach-tiki
202879294,Người Đàn Ông Mang Tên Ove (Tái Bản 2022),4719.0,7387168030853,119000,160000,41000,26,377,nha-sach-tiki
199582064,Sổ tay ghi chép / sổ lò xo ghi chép A5 - B5 - A4 160 trang – giấy kẻ ngang – giấy ô vuông ,2319.0,2534935681919,50000,99000,49000,49,157,nha-sach-tiki
195291930,Bốn Thỏa Ước,3700.0,7386322561468,89100,130000,40900,31,226,nha-sach-tiki
194960730,Nỗi buồn chiến tranh,3158.0,3853955433686,101000,130000,29000,22,292,nha-sach-tiki
190335975,Combo 2 cuốn Truyện Dành Cho Thiếu Nhi : Tuổi Thơ Dữ Dội - Tập 1 + 2 (Tái Bản),1094.0,6939903082631,119000,160000,41000,26,95,nha-sach-tiki
187843291,Nhật ký Đặng Thùy Trâm,1759.0,7302391711222,64800,90000,25200,28,114,nha-sach-tiki
181122317,Chân Trần Chí Thép (Tái Bản 2022),361.0,9852550682954,129000,168000,39000,23,34,nha-sach-tiki
170708233,Thay Đổi Tí Hon - Hiệu Quả Bất Ngờ Atomic Habits (Tái Bản Lần 4),10696.0,2330392359694,143000,189000,46000,24,822,nha-sach-tiki
165030729,Những Kẻ Âu Lo,1286.0,1605330498488,117000,180000,63000,35,121,nha-sach-tiki
140416370,Flow - Dòng Chảy,8308.0,7822684494840,163000,228000,65000,29,741,nha-sach-tiki
101782486,"Deep Work - Làm Ra Làm, Chơi Ra Chơi (Tái Bản)",2931.0,3118886931216,116700,159000,42300,27,278,nha-sach-tiki
76013370,Được Học (Tái Bản),2347.0,5311141894270,138300,182000,43700,24,294,nha-sach-tiki
74021317,Cây Cam Ngọt Của Tôi,4924.0,5977911599303,86400,108000,21600,20,653,nha-sach-tiki
50322710,48 Nguyên Tắc Chủ Chốt Của Quyền Lực (Tái Bản 2020),724.0,9545013579590,200000,200000,0,0,82,nha-sach-tiki
3954355,Yêu Những Điều Không Hoàn Hảo,42319.0,3044489264000,106000,169000,63000,37,4029,nha-sach-tiki
25728855,Kinh Dịch (Ngô Tất Tố),10.0,4332718620451,192850,192850,0,0,2,nha-sach-tiki
257503554,Lặng - Tuệ An ( Lặng Rồi Sẽ Yên - Yên Rồi Sẽ An ),137.0,8745921703222,213750,213750,0,0,15,nha-sach-tiki
277425002,Án Mạng Giữa Không Trung (Agatha Christie) - NXB Trẻ,142.0,5525414223208,82000,125000,43000,34,8,nha-sach-tiki
277409853,Bí Ẩn Thảm Án Ở Styles (Agatha Christie) (NXB Trẻ),136.0,4648624828440,80000,122000,42000,34,7,nha-sach-tiki
277381902,Tiếng gọi chân trời - Nguyễn Ngọc Tư,393.0,3254708776949,62000,95000,33000,35,11,nha-sach-tiki
277361862,Kỹ thuật đặt câu lệnh cho ChatGPT,191.0,9878130509349,124600,179000,54400,30,7,nha-sach-tiki
277348449,MƯA ĐỎ - Chu Lai - Vietnambook,89.0,2813050121742,153750,205000,51250,25,11,nha-sach-tiki
276114606,"Sổ kế hoạch planner 52 tuần 2025 SDstationery “Fall In Love With Your Life” kèm hộp quà, gáy lò xo, phong cách retro 14,3x20,8 cm",67.0,8486217256209,70000,140000,70000,50,1,nha-sach-tiki
273498038,"Sổ kế hoạch planner 18 tháng 7/2024-12/2025 SDstationery Goal Path 16.5x20.5, 48 trang, gáy dập ghim",51.0,7181146964211,39000,39000,0,0,3,nha-sach-tiki
8293201,Tiếng Hàn cơ bản cùng Cheri Hyeri (Tái bản),5666.0,4035704876374,155350,239000,83650,35,427,nha-sach-tiki
7456637,Sách ngữ âm dành cho người mới bắt đầu ,1.0,2697089942543,304000,320000,16000,5,0,nha-sach-tiki
95295984,Combo 12 Cây Bút Dạ Quang Xóa Được PLUS,8.0,2395719219747,250000,250000,0,0,1,nha-sach-tiki
276823777,Tại sao các quốc gia thất bại,424.0,3114584614308,189000,310000,121000,39,25,nha-sach-tiki
276641698,Tiệm sách của nàng (Nguyễn Nhật Ánh),1108.0,4853250309556,98900,125000,26100,21,77,nha-sach-tiki
276388548,Tư Duy Nhanh Và Chậm (Tái Bản),3021.0,8862187347559,188300,269000,80700,30,197,nha-sach-tiki
275243138,Rèn Luyện Tư Duy Phản Biện,30644.0,9291427813589,96900,139000,42100,30,4826,nha-sach-tiki
267208813,Tuổi Thơ Dữ Dội - Tập 2,2611.0,6297652889189,58400,80000,21600,27,351,nha-sach-tiki
276477007,"Túi giấy trung SDstationery Thank You đựng quà cảm ơn, quà tặng sự kiện, văn phòng phẩm, mỹ phẩm, họa tiết trang nhã, xanh pastel, ép kim",7.0,1942126793065,20000,20000,0,0,0,nha-sach-tiki
115093388,"Bộ sách Từ Bạn Đời Đến Bạn Đạo: Yêu Trong Tỉnh Thức, Kiến Tạo Gia Đình Hạnh Phúc - Tuệ An",1017.0,3286782267685,370000,370000,0,0,125,nha-sach-tiki
271628458,Truyện Ehon bé 3-4-5 tuổi - Bộ 4 cuốn Bác sĩ Anton,0.0,2212327178484,204000,204000,0,0,0,nha-sach-tiki
112594560,Kiến Tạo Gia Đình Hạnh Phúc - Từ Bạn Đời Đến Bạn Đạo Tập 2,281.0,8527546406858,185000,185000,0,0,29,nha-sach-tiki
261982682,Cuộc cách mạng Glucose,1512.0,6845440232938,120000,158000,38000,24,81,nha-sach-tiki
251928260,Ông Tướng Tình Báo Bí Ẩn Và Những Điệp Vụ Siêu Hạng,345.0,8129699467386,86500,118000,31500,27,31,nha-sach-tiki
229714486,Giải Trí Đến Chết,1134.0,7156829803875,126000,179000,53000,30,87,nha-sach-tiki
220665663,30 Tuổi - Mọi Thứ Chỉ Mới Bắt Đầu,0.0,2013812569154,114000,135000,21000,16,0,nha-sach-tiki
190238356,Kỷ Luật Bản Thân,3582.0,8906550582998,133000,189000,56000,30,222,nha-sach-tiki
189940673,Học Cách Học (Tái bản),456.0,9272089535156,111300,159000,47700,30,30,nha-sach-tiki
186286187,Nhà Lãnh Đạo Không Chức Danh,4350.0,3562677301033,82700,105000,22300,21,169,nha-sach-tiki
184419723,Sapiens Lược Sử Loài Người (Tái Bản 2022),4543.0,2765004286434,209300,299000,89700,30,394,nha-sach-tiki
177637709,Làm Chủ Bình Minh - Sống Đời Xuất Chúng - CLB 5 Giờ Sáng (Robin Sharma),6464.0,7418843715930,117000,185000,68000,37,162,nha-sach-tiki
177487151,Nếu Biết Trăm Năm Là Hữu Hạn,1646.0,5835196593336,136000,159000,23000,14,239,nha-sach-tiki
172545674,Phía Tây Không Có Gì Lạ - Tái Bản,355.0,9619507560299,54400,80000,25600,32,46,nha-sach-tiki
161008715,Power Vs Force - Trường Năng Lượng Và Những Nhân Tố Quyết Định Hành Vi Của Con Người (Tái Bản),6859.0,9112392882091,128000,179000,51000,28,580,nha-sach-tiki
107802183,Sách Sức Mạnh Tiềm Thức (Tái Bản) (Bìa Mềm),1607.0,9759871079058,102400,128000,25600,20,141,nha-sach-tiki
91947689,7 Thói Quen Hiệu Quả (The 7 Habits Of Highly Effective People) - Stephen R. Covey - PACE Books,529.0,9240011208173,220000,250000,30000,12,49,nha-sach-tiki
90056907,Khởi Nghiệp Tinh Gọn (The Lean Startup) (Tái Bản),4831.0,6661350945326,123000,165000,42000,25,581,nha-sach-tiki
77982982,Trí Tuệ Xúc Cảm,3144.0,4562885391825,146100,199000,52900,27,339,nha-sach-tiki
76776245,Nghệ Thuật Tư Duy Phản Biện,6145.0,3891511574787,88400,129000,40600,31,729,nha-sach-tiki
73787185,Những Tù Nhân Của Địa Lý,1348.0,6372567555779,168000,210000,42000,20,219,nha-sach-tiki
73207098,Làm Chủ - Mastery,390.0,7582177130160,170000,200000,30000,15,64,nha-sach-tiki
56609155,Trường Ca Achilles (Quà Tặng Kèm: 01 Bookmark + 01 Phụ Lục),672.0,1196220485440,124800,156000,31200,20,195,nha-sach-tiki
53728878,Tối Đa Hóa Hiệu Suất Công Việc – Việc 12 Tháng Làm Trong 12 Tuần,1412.0,3542336423209,127000,169000,42000,25,168,nha-sach-tiki
52789367,Nhà Giả Kim (Tái Bản 2020),5043.0,5279951395588,63200,79000,15800,20,1015,nha-sach-tiki
52004412,D. Trump - Nghệ Thuật Đàm Phán (Tái bản 2020),464.0,5469954557735,89300,109000,19700,18,68,nha-sach-tiki
42230121,Sách Hiểu Về Trái Tim (Tái Bản 2019) - Minh Niệm,36787.0,3098193178849,128000,158000,30000,19,3711,nha-sach-tiki
40933971,Một Đời Thương Thuyết (Tái Bản),3623.0,3035316740262,91000,135000,44000,33,373,nha-sach-tiki
32490132,Một Đời Như Kẻ Tìm Đường,1827.0,8771459670374,140000,175000,35000,20,243,nha-sach-tiki
16284286,Tuổi Thơ Dữ Dội - Tập 1 (Tái Bản),327.0,2528351834108,64000,80000,16000,20,52,nha-sach-tiki
13419678,Sách Đi Tìm Lẽ Sống (Tái Bản ),23402.0,9065228641221,67000,88000,21000,24,2483,nha-sach-tiki
10005245,Đàn Ông Sao Hỏa Đàn Bà Sao Kim,53411.0,2496196333059,131000,188000,57000,30,4200,nha-sach-tiki
3304875,Điều Kỳ Diệu Của Tiệm Tạp Hóa NAMIYA (Tái Bản),11.0,2929303348245,94500,105000,10500,10,0,nha-sach-tiki
277827108,Dragon Quest - Cuộc Phiêu Lưu Của Dũng Sĩ Dai - Tập 6: Kị Sĩ Rồng I [Tặng Kèm Postcard],36.0,5550246856767,69000,69000,0,0,0,nha-sach-tiki
277581147,[Sách Màu] Xây Nhà - Ngàn điều cần biết - Phiên bản 2025,63.0,3403630714337,369000,369000,0,0,5,nha-sach-tiki
277464359,(Tập Thơ) NGƯỜI LÀ MỘT BÓNG CHIM KHUÊ TÚ - Nguyễn Thiên Ngân – Phục Hưng Books,283.0,5663744619371,399000,399000,0,0,9,nha-sach-tiki
277228149,Ván bài lật ngửa (Hộp 6 cuốn),115.0,2622361853353,643500,990000,346500,35,12,nha-sach-tiki
276353084,Người Ếch - Kẻ Giết Người Hàng Loạt,293.0,3137030380037,114000,157000,43000,27,25,nha-sach-tiki
276159943,NEXUS - Lược Sử Của Những Mạng Lưới Thông Tin Từ Thời Đại Đồ Đá Đến Trí Tuệ Nhân Tạo,2279.0,4586901579152,238600,325000,86400,27,149,nha-sach-tiki
276077530,Nghệ Thuật Không Nổi Giận,274.0,1582595609094,77000,99000,22000,22,12,nha-sach-tiki
275264393,Chia sẻ từ trái tim,3050.0,6874904987700,120000,168000,48000,29,150,nha-sach-tiki
274566783,Siêu Nhí Hỏi Nhà Khoa Học Trả Lời - 100 Bí Ẩn Mọi Đứa Trẻ Đều Muốn Hỏi Một Nhà Khoa Học,8403.0,7749956448591,210000,299000,89000,30,1389,nha-sach-tiki
273826412,Phạm Xuân Ẩn - Tên Người Như Cuộc Đời,37.0,6525524143434,104400,120000,15600,13,0,nha-sach-tiki
273114488,Tư Duy Ngược,1858.0,6671736498096,123000,179000,56000,31,66,nha-sach-tiki
273079628,Phép Lạ Của Sự Tỉnh Thức,1500.0,1990784863977,58000,79000,21000,27,124,nha-sach-tiki
272449818,MANIFEST – 7 Bước Để Thay Đổi Cuộc Đời Bạn Mãi Mãi,2370.0,5074965088463,60400,89000,28600,32,138,nha-sach-tiki
272367381,Trốn Lên Mái Nhà Để Khóc,2183.0,3590196690787,68100,95000,26900,28,127,nha-sach-tiki
272000024,MBA bằng hình (Trọn gói hai năm kiến thức quản trị kinh doanh qua trực quan sinh động),4606.0,2936371267927,139000,189000,50000,26,242,nha-sach-tiki
271518926,Dám bị ghét,702.0,7038007191135,89400,119000,29600,25,39,nha-sach-tiki
271337379,World History - Lịch Sử Thế Giới,855.0,2897031822340,336000,490000,154000,31,83,nha-sach-tiki
271162836,Beartown 2: Chúng tôi đấu với các bạn,713.0,2481392284760,140000,225000,85000,38,69,nha-sach-tiki
271118010,Giao Tiếp Bất Bạo Động (Nonviolent Communication),2404.0,3495798974223,115000,155000,40000,26,123,nha-sach-tiki
249875170,Hai số phận (bìa cứng),2250.0,4539390751163,169000,235000,66000,28,297,nha-sach-tiki
210277880,Con người và Biểu tượng - Man and his symbols,2008.0,2502375115901,325000,450000,125000,28,196,nha-sach-tiki
207400598,Ung thư không phải là bệnh (Tái bản),814.0,6371803833666,131000,189000,58000,31,40,nha-sach-tiki
195545304,Khéo Ăn Nói Sẽ Có Được Thiên Hạ,3815.0,1251680635532,94600,130000,35400,27,134,nha-sach-tiki
179063564,Tôi Tự Học,3412.0,6024847029566,75000,120000,45000,38,259,nha-sach-tiki
174842858,Sách Sức Mạnh Của Ngôn Từ (Tái Bản 2022),4800.0,1363544330591,79900,108000,28100,26,309,nha-sach-tiki
170708219,Đừng Bao Giờ Chia Đôi Lợi Ích Trong Mọi Cuộc Đàm Phán,1609.0,3217962161554,128000,179000,51000,28,85,nha-sach-tiki
153045603,Sách Người Giỏi Không Phải Là Người Làm Tất Cả (Tái Bản 2021),3725.0,8850035098034,43200,58000,14800,26,215,nha-sach-tiki
139567621,Thức Tỉnh Mục Đích Sống (Tái Bản),3407.0,6092388309702,107000,148000,41000,28,300,nha-sach-tiki
120219394,Tôi Nói Gì Khi Nói Về Chạy Bộ,145.0,1493348887961,64600,76000,11400,15,16,nha-sach-tiki
85923342,Minh Triết Trong Ăn Uống Của Phương Đông (Tái Bản),3808.0,6024807140371,119000,168000,49000,29,256,nha-sach-tiki
75307228,Sách OSHO Yêu - Being In Love - Yêu Trong Tỉnh Thức,1555.0,9038823919989,131000,168000,37000,22,259,nha-sach-tiki
57762732,Nhà Đầu Tư Thông Minh (Tái Bản 2020),993.0,7316437175994,159200,199000,39800,20,138,nha-sach-tiki
52788072,Chiến Binh Cầu Vồng (Tái Bản 2020),709.0,9010512370783,87200,109000,21800,20,123,nha-sach-tiki
14453314,Lược Sử Nước Việt Bằng Tranh: Viet Nam – A Brief History In Pictures (Tái Bản 2019),479.0,4526980612669,156800,196000,39200,20,87,nha-sach-tiki
9687416,Để Trở Thành Người Bán Hàng Giỏi Nhất Thế Giới,183.0,1183130249347,137700,168000,30300,18,39,nha-sach-tiki
8886007,Ngàn Mặt Trời Rực Rỡ (Tái Bản),365.0,3409341057860,104000,130000,26000,20,64,nha-sach-tiki
7982628,Suối Nguồn (Tái Bản),13214.0,4120982499787,238000,380000,142000,37,1473,nha-sach-tiki
4080373,90% Trẻ Thông Minh Nhờ Cách Trò Chuyện Đúng Đắn Của Cha Mẹ,1220.0,2070069826819,30400,39000,8600,22,73,nha-sach-tiki
3639597,Bước Chậm Lại Giữa Thế Gian Vội Vã (Tái Bản),48945.0,8788183623224,70100,100000,29900,30,4024,nha-sach-tiki
750578,Khi Hơi Thở Hóa Thinh Không,62027.0,2506010458896,74200,109000,34800,32,2287,nha-sach-tiki
277837116,Thảm họa tuyết trắng,35.0,2766756536044,185000,185000,0,0,5,nha-sach-tiki
277740191,(Tái bản 2025) HỒI KÝ GIA ĐÌNH - BẠN BÈ - ĐẤT NƯỚC - Nguyễn Thị Bình - NXB CTQGST,108.0,2259095276122,159000,159000,0,0,5,nha-sach-tiki
277599516,Nghịch lý 13,51.0,3099556661161,259000,259000,0,0,4,nha-sach-tiki
277588448,Trăm Dặm Tử Thần,16.0,4029777531961,166300,239000,72700,30,1,nha-sach-tiki
277228095,The AI Edge: Khai Thác Thế Mạnh AI Trong Sales & Marketing,96.0,3698820157091,153000,219000,66000,30,1,nha-sach-tiki
277165432,"Hành Lang Hẹp - Nhà Nước, Xã Hội Và Vận Mệnh Của Tự Do",336.0,7483185062496,263000,397000,134000,34,26,nha-sach-tiki
277024165,Trò Chơi Quyền Lực,236.0,6394054130543,141700,189000,47300,25,20,nha-sach-tiki
276883579,Sống Sáng - Phan Việt - Sáng Books,920.0,7853206998598,180000,180000,0,0,49,nha-sach-tiki
275975633,Kể Chuyện Cụm Tình Báo H.63 Anh Hùng - Những Câu Chuyện Tình Báo Thót Tim Không Phải Ai Cũng Biết (Bản in màu),76.0,6449049877928,238000,280000,42000,15,9,nha-sach-tiki
275243836,Bộ sách Thám tử Sherlock Nhí,25.0,2602137364632,22000,38000,16000,42,1,nha-sach-tiki
275140709,SỨC MẠNH CỦA EQ- Đánh thức trí tuệ cảm xúc - Làm chủ ngôn ngữ - Thu phục lòng người,468.0,9279102192656,65100,99000,33900,34,14,nha-sach-tiki
274458341,Độ nhiễu: Sai lầm trong phán đoán,514.0,9860085030282,149000,245000,96000,39,41,nha-sach-tiki
273386450,Bán Cơm nắm ở tiệm Bánh mì – Bí quyết sáng tạo của người Nhật – 6 phương pháp mở rộng và 6 phương pháp đào sâu để tạo ra những điều chưa từng có ai nghĩ đến,140.0,8547731244091,57100,100000,42900,43,5,nha-sach-tiki
252884778,Móc Khóa 9 Mèo  Bộ Siêu Tập Key Chain_ Hàng Chính Hãng,23.0,5083381945464,59000,59000,0,0,0,nha-sach-tiki
249875150,Hai số phận (bìa mềm),1810.0,2270726656552,149000,195000,46000,24,172,nha-sach-tiki
247858753,Vùng Đất Quỷ Tha Ma Bắt,2599.0,5895600976424,136000,168000,32000,19,244,nha-sach-tiki
243097256,Giận - Thích Nhất Hạnh,3853.0,7124747833915,103000,135000,32000,24,208,nha-sach-tiki
214186191,Những Kẻ Xuất Chúng (Tái Bản),1274.0,7535107260553,106000,159000,53000,33,86,nha-sach-tiki
207946236,Sổ Tay 1980books,708.0,9068350882681,35280,49000,13720,28,0,nha-sach-tiki
206678865,Dám Nghĩ Lại,2709.0,8165683694338,120000,168000,48000,29,136,nha-sach-tiki
195801321,The One Thing - Điều Ý Nghĩa Nhất (Tái Bản 2022),2175.0,6744306338419,81300,119000,37700,32,98,nha-sach-tiki
187827003,Không Diệt Không Sinh Đừng Sợ Hãi (TB5),29326.0,2245106018034,82600,110000,27400,25,1849,nha-sach-tiki
176909221,Ngôi Nhà Bên Bờ Biển Xanh Thẳm,3348.0,5956285607454,120000,199000,79000,40,491,nha-sach-tiki
168283405,Chiến Tranh Tiền Tệ - Phần 1 - Ai Thực Sự Là Người Giàu Nhất Thế Giới ( Tái Bản 2022),7213.0,6893421095594,112000,165000,53000,32,790,nha-sach-tiki
157255752,Sức Mạnh Của Hiện Tại (Tái Bản),2994.0,4871831566007,124000,168000,44000,26,277,nha-sach-tiki
147999778,Không Bao Giờ Là Thất Bại - Tất Cả Là Thử Thách (Ấn Bản Cập Nhật Đầy Đủ Nhất)(Bìa Cứng),10045.0,8193957223084,178000,268000,90000,34,762,nha-sach-tiki
111537683,Và Rồi Chẳng Còn Ai (Agatha Christie),2150.0,7737003013599,67000,110000,43000,39,424,nha-sach-tiki
107802188,Bí Mật Tư Duy Triệu Phú (Tái Bản),404.0,4008140282594,85300,108000,22700,21,47,nha-sach-tiki
104769768,Máy Tính CASIO FX580VN X,2537.0,1731013592789,740000,779000,39000,5,724,nha-sach-tiki
103379147,Bạch Dạ Hành (Tái Bản),5721.0,7576087902248,164000,235000,71000,30,1184,nha-sach-tiki
95289208,Người Bà Tài Giỏi Vùng Saga,376.0,5862624720479,102400,128000,25600,20,78,nha-sach-tiki
78975610,Siêu Tập Trung (Tái Bản),1912.0,7563868822648,93100,140000,46900,34,241,nha-sach-tiki
59262880,Sách Người Bán Hàng Vĩ Đại Nhất Thế Giới (Tái Bản 2020),801.0,5858155258600,118400,148000,29600,20,116,nha-sach-tiki
54266567,Sách Nghĩ Giàu Và Làm Giàu (Bìa Mềm),14415.0,6455629494886,81800,110000,28200,26,1830,nha-sach-tiki
48362502,Sang Chấn Tâm Lý - Hiểu Để Chữa Lành,662.0,1727823273464,273000,350000,77000,22,132,nha-sach-tiki
40933969,Một Đời Quản Trị (Tái Bản),295.0,1904406148764,170000,200000,30000,15,20,nha-sach-tiki
7833728,Dạy Con Làm Giàu (Tập 1) - Để Không Có Tiền Vẫn Tạo Ra Tiền - Cha Giàu Cha Nghèo (Tái Bản),38387.0,3908993025659,60900,80000,19100,24,3574,nha-sach-tiki
7369223,Cho Tôi Xin Một Vé Đi Tuổi Thơ (Bìa Mềm) (Tái Bản),21185.0,8494814360139,57000,90000,33000,37,1693,nha-sach-tiki
3014291,Máy Tính Khoa Học Casio FX-580VN X,5820.0,8142774115435,740000,779000,39000,5,1473,nha-sach-tiki
277769396,"Sách - Hồi Ký Nguyễn Thị Bình - Gia Đình, Bạn Bè Và Đất Nước - Bìa Cứng",50.0,9794872815570,212800,224000,11200,5,1,nha-sach-tiki
277599510,Mê cung của linh hồn,33.0,9018313701548,369000,369000,0,0,3,nha-sach-tiki
277548460,Sách - Từ Sông Bến Hải Đến Dinh Độc Lập,2.0,7767461617318,175200,219000,43800,20,0,nha-sach-tiki
277499663,NVIDIA Cỗ Máy Tư Duy Vĩ Đại,48.0,8936867135032,180000,249000,69000,28,2,nha-sach-tiki
277228145,Ăn gì không già: Phương pháp khoa học để khỏe mạnh hơn khi già đi,61.0,3864930670782,245000,370000,125000,34,3,nha-sach-tiki
276840998,Kiếm Tiền Cùng Chatgpt - Vào Nghề Đồ Họa Ai,56.0,3628941833747,247000,345000,98000,28,0,nha-sach-tiki
276833162,Chuyện Con Mèo Dạy Hải Âu Bay,30501.0,2230170121233,45000,60000,15000,25,2798,nha-sach-tiki
276762206,"Chầm Chậm Gặp Gỡ, Từ Từ Bên Nhau",152.0,5416997455584,62800,88000,25200,29,4,nha-sach-tiki
276659602,Series các tập Claymore,208.0,6400576746486,35800,35800,0,0,10,nha-sach-tiki
276497195,Con Đường Chuyển Hóa - 50 Bài giảng về con đường chân chánh - Thầy Thích Pháp Hòa,604.0,8926978175764,134000,188000,54000,29,28,nha-sach-tiki
276107155,Lịch sử Việt Nam bằng hình - Gần 2000 minh họa tranh ảnh và bản đồ,218.0,6075877969083,720000,900000,180000,20,26,nha-sach-tiki
275576878,Agatha Christie. Thi thể trong thư viện - Một vụ án của Jane Marple,369.0,1545344963693,67000,110000,43000,39,32,nha-sach-tiki
275316345,"AI 5.0 – Nhanh Hơn, Dễ Hơn, Rẻ Hơn, Chính Xác Hơn",561.0,9285695342416,135800,209000,73200,35,10,nha-sach-tiki
274546151,Thư cho em,2551.0,4298763965948,105000,140000,35000,25,152,nha-sach-tiki
272188850,Soul Eater,271.0,8229005083492,82000,95000,13000,14,27,nha-sach-tiki
263500714,Dạy Con Làm Giàu (Tập 2) - Sử Dụng Đồng Vốn,10706.0,2520600792808,91000,145000,54000,37,1460,nha-sach-tiki
219148748,Chú bé mang Pyjama sọc,1485.0,1267598113722,55100,79000,23900,30,139,nha-sach-tiki
207852930,LỊCH SỬ VIỆT NAM BẰNG TRANH - BOXSET 53 TẬP,326.0,3742119440380,1213000,1855000,642000,35,28,nha-sach-tiki
206837303,Chữa Lành Những Sang Chấn Tuổi Thơ,1135.0,1930069705115,150000,220000,70000,32,68,nha-sach-tiki
205942263,Tận Hưởng Hành Trình Nuôi Con Sữa Mẹ,1896.0,6651532097082,95400,132000,36600,28,60,nha-sach-tiki
201845361,"Súng, Vi Trùng Và Thép (Tái bản)",1329.0,5792133950074,241000,339000,98000,29,105,nha-sach-tiki
192949035,Lược Sử Nước Việt Bằng Tranh (Tái Bản 2022),151.0,4253282836927,112000,140000,28000,20,10,nha-sach-tiki
187827445,Lược Sử Thời Gian,0.0,7157203119782,115000,115000,0,0,0,nha-sach-tiki
171289224,Personal Best American B1+ Intermediate Pack A,81.0,4568355220378,236000,236000,0,0,1,nha-sach-tiki
168662171,Vừa Nhắm Mắt Vừa Mở Cửa Số,2574.0,9634570108901,55600,75000,19400,26,181,nha-sach-tiki
154245455,Combo 2 Cuốn Nghiền Từ Vựng Tiếng Anh: Học Qua Gốc Từ Bằng Hình Ảnh - Gốc Từ Là Bí Quyết Để Ghi Nhớ Hàng Nghìn Từ Vựng,2501.0,4022695906765,180000,270000,90000,33,291,nha-sach-tiki
82912488,Từ Tốt Đến Vĩ Đại (Tái bản 2021),11323.0,3580673917869,84000,130000,46000,35,1275,nha-sach-tiki
73207240,Xa Ngoài Kia Nơi Loài Tôm Hát - Where The Crawdads Sing,137.0,8787420605399,148500,165000,16500,10,38,nha-sach-tiki
69644748,Thiền Sư Và Em Bé 5 Tuổi,582.0,7944454223475,92400,120000,27600,23,69,nha-sach-tiki
66619715,Sách Vị Tu Sĩ Bán Chiếc Ferrari (Tái Bản),855.0,5805728029969,78400,98000,19600,20,100,nha-sach-tiki
52329763,Kafka bên bờ biển (Tái Bản 2020),7013.0,1260147729717,136000,188000,52000,28,1200,nha-sach-tiki
45663008,Ngày Xưa Có Một Con Bò…(Tái Bản),11155.0,3744250775420,47700,70000,22300,32,1020,nha-sach-tiki
33492447,Mục Tiêu,43.0,7678874089808,183200,229000,45800,20,4,nha-sach-tiki
14684312,Dấn Thân (Tái Bản),254.0,6959263694003,95200,112000,16800,15,50,nha-sach-tiki
13446508,Cánh Đồng Bất Tận (Tái Bản 2019),272.0,9817946733340,76500,85000,8500,10,65,nha-sach-tiki
10581200,Dế Mèn Phiêu Lưu Ký (Tái Bản),915.0,7734142469588,41500,50000,8500,17,131,nha-sach-tiki
8121633,Văn Minh Vật Chất Của Người Việt,1955.0,9025147739225,227000,330000,103000,31,199,nha-sach-tiki
1647103,Bà Ngoại Tôi Gửi Lời Xin Lỗi,1225.0,5065948649037,119000,190000,71000,37,84,nha-sach-tiki
1080002,Boxset Harry Potter - Tiếng Việt (Trọn Bộ 7 Tập),10631.0,2519625242415,1095000,1750000,655000,37,1574,nha-sach-tiki
347334,Có Hai Con Mèo Ngồi Bên Cửa Sổ,24507.0,2511284177091,63000,100000,37000,37,1334,nha-sach-tiki
277916282,Tạp chí Đẹp T4/2025 (Số 295),5.0,4826620201450,65000,65000,0,0,0,nha-sach-tiki
277857243,Thế Giới Otome Game Thật Khắc Nghiệt Với Nhân Vật Quần Chúng (Tập 12),66.0,8064157106895,139000,139000,0,0,2,nha-sach-tiki
277599506,Đôi mắt của Mona,0.0,5892845051131,287300,338000,50700,15,0,nha-sach-tiki
277599017,Dấu Ấn Hoàng Gia Tập 20,50.0,6447413860465,30000,30000,0,0,0,nha-sach-tiki
277587065,365 Ngày Ký Họa 5 Giây Vẽ Tất Tần Tật Mọi Thứ Trên Đời,25.0,6958885450786,149000,149000,0,0,0,nha-sach-tiki
277312609,Những Điều Bé Nhỏ Xinh Đẹp,77.0,4023314106188,130000,179000,49000,27,4,nha-sach-tiki
276777219,Chăm Sóc Bản Thân Thật Sự,199.0,3637882165249,106000,148000,42000,28,5,nha-sach-tiki
276377311,Ông trăm tuổi tái xuất và giải cứu thế giới (Jonas Jonasson),391.0,8208158390803,120000,190000,70000,37,31,nha-sach-tiki
274728364,Đại Việt Sử Ký Toàn Thư,696.0,2135392048609,191400,275000,83600,30,96,nha-sach-tiki
274031576,Series các tập ATTACK ON TITAN,1372.0,1669326196919,42000,42000,0,0,61,nha-sach-tiki
273355903,"Làm Cha Mẹ Tỉnh Thức - Chuyển Hóa Bản Thân, Trao Quyền Cho Con Cái",7670.0,1782383724166,109000,149000,40000,27,831,nha-sach-tiki
272129446,AI - Công Cụ Nâng Cao Hiệu Suất Công Việc,466.0,2246493289510,116000,169000,53000,31,10,nha-sach-tiki
271916321,"Mùa hè không tên (Nguyễn Nhật Ánh) - Tặng kèm Bookmark, Tranh màu cho cả 2 phiên bản - Tặng thêm ngẫu nhiên 1 trong 2 Lót ly cho Bản bìa cứng",5338.0,9198440397642,84000,130000,46000,35,450,nha-sach-tiki
270847918,Lời Thú Tội Mới Của Một Sát Thủ Kinh Tế,4885.0,3221213326793,177000,245000,68000,28,522,nha-sach-tiki
270504803,4 Nguyên Tắc Thực Thi (The 4 Disciplines Of Execution),692.0,6031387182316,166000,205000,39000,19,17,nha-sach-tiki
253129523,Atomic Habits - Thay Đổi Tí Hon Hiệu Quả Bất Ngờ (Tái Bản 2023),1209.0,5907296908260,151200,189000,37800,20,73,nha-sach-tiki
225912339,Chủ nghĩa khắc kỷ - phong cách sống bản lĩnh và bình thản (Tái Bản),3015.0,6157284510091,110000,149000,39000,26,218,nha-sach-tiki
195885674,Đất Nước Gấm Hoa - Atlas Việt Nam,539.0,6507223294581,279000,350000,71000,20,38,nha-sach-tiki
195545504,Nhật Ký Trong Tù,444.0,9777750595895,54700,80000,25300,32,52,nha-sach-tiki
192377682,Bùi Kiến Thành - Người Mở Khóa Lãng Du (Hồi Ký),110.0,2582028594121,94100,150000,55900,37,12,nha-sach-tiki
189643105,Không Phải Sói Nhưng Cũng Đừng Là Cừu -Tặng kèm bookmark 2 mặt,14207.0,7150413107642,89800,128000,38200,30,1503,nha-sach-tiki
181379116,Hackers Toeic Vocabulary (Tái Bản),777.0,5763192225985,191000,279000,88000,32,110,nha-sach-tiki
153518797,Tôi Đi Học - Nguyễn Ngọc Ký (Tái Bản),487.0,4126438828115,55500,76000,20500,27,29,nha-sach-tiki
117238177,Thư Viện Nửa Đêm,80.0,5673157495853,120000,150000,30000,20,12,nha-sach-tiki
114937969,Rừng Nauy (Tái Bản),398.0,4063406517816,144000,180000,36000,20,57,nha-sach-tiki
94347317,"Câu Chuyện Cơ Thể Con Người: Tiến Hóa, Sức Khỏe Và Bệnh Tật",66.0,1181833357728,185200,195000,9800,5,9,nha-sach-tiki
57354850,Những Con Chim Ẩn Mình Chờ Chết (Tái Bản 2020),248.0,5651458239105,144000,160000,16000,10,45,nha-sach-tiki
57325187,Sách Người Giàu Có Nhất Thành Babylon (Tái Bản 2020),2431.0,2446461571372,75400,98000,22600,23,354,nha-sach-tiki
53452969,Khởi Nghiệp Du Kích - Kinh Doanh Ít Vốn - Vận Dụng Nguồn Lực Nhỏ Chiến Thắng Cuộc Chơi Lớn (Tái Bản),7332.0,5411648147401,199000,199000,0,0,995,nha-sach-tiki
52805060,Chúa Ruồi - Tiểu Thuyết (Nobel Văn Chương 1983)(Tái Bản 2020),141.0,9262112795163,77400,88000,10600,12,34,nha-sach-tiki
37887031,Hiểu Nghèo Thoát Nghèo (Tái Bản),40.0,7001268841032,144000,160000,16000,10,9,nha-sach-tiki
31509726,Làm Bạn Với Bầu Trời (Bìa Mềm) (Tặng Kèm Khung Ảnh Số Lượng Có Hạn),28257.0,6664030992090,72000,110000,38000,35,2173,nha-sach-tiki
15267827,Hoàng Tử Bé (Tái Bản 2019),1833.0,4933955346595,60000,75000,15000,20,315,nha-sach-tiki
14684952,Khu Vườn Bí Mật ( Tái Bản 2019 ),4575.0,7574641962827,74600,96000,21400,22,508,nha-sach-tiki
12138656,Nghệ Thuật Tư Duy Chiến Lược,221.0,6986093891821,195900,239000,43100,18,11,nha-sach-tiki
4780917,Người Đua Diều (Tái Bản 2018),22465.0,3342656016576,99000,129000,30000,23,2688,nha-sach-tiki
3408327,Quân Khu Nam Đồng: Truyện (Tái Bản),2687.0,2396043028889,90000,140000,50000,36,306,nha-sach-tiki
3082815,Tự Truyện Benjamin Franklin (Tái Bản),4206.0,8777925615764,74200,109000,34800,32,580,nha-sach-tiki
1702825,Hóa Thân (Tái Bản),2805.0,9162657193694,40800,54000,13200,24,181,nha-sach-tiki
277857896,Gen Alpha Và Rối Loạn Lo Âu,3.0,2705770210964,152400,219000,66600,30,0,nha-sach-tiki
277810944,"Sách Hồi Ký Nguyễn Thị Bình: Gia Đình, Bạn Bè Và Đất Nước (Phiên Bản Bìa Cứng) - Tái Bản 2025",35.0,8320350618881,213000,224000,11000,5,2,nha-sach-tiki
277780812,Bộ Sách Gieo Mầm Nhân Cách : Combo Tử tế nhưng đừng dại khờ con nhé +  Đắc Nhân Tâm cho trẻ,49.0,7730310444038,250000,250000,0,0,1,nha-sach-tiki
277762055,Dấu Ấn Hoàng Gia – Tập 21 [Tặng Kèm Postcard],30.0,7026892524394,30000,30000,0,0,1,nha-sach-tiki
277744865,Thái Bạch Kim Tinh Đang Phiền Muộn,30.0,3725122422533,179000,179000,0,0,1,nha-sach-tiki
277742606,Bản Sao,27.0,4040007993746,159400,229000,69600,30,2,nha-sach-tiki
277585864,Co - Intellgence - Trí Tuệ Đồng Hành  - Kỷ nguyên sống và làm việc cùng AI,70.0,1173711831508,190000,190000,0,0,1,nha-sach-tiki
277412034,Sách Song Ngữ Lời Thì Thầm Trong Tổ Ấm - Whispers In The Home - Chính Hãng + Mã File Nghe,722.0,1221590090926,182000,182000,0,0,25,nha-sach-tiki
276912267,"Giữa Muôn Vàn Ngã Rẽ Của Cuộc Đời, Tôi Vẫn Chọn Làm Một Người Kiêu Hãnh",129.0,7330184073870,77000,109000,32000,29,3,nha-sach-tiki
276546963,Agatha Christie. Tuyển tập kỳ án của Poirot,336.0,8410456840089,64000,105000,41000,39,28,nha-sach-tiki
276436427,Combo Tâm Lý Học Về Tiền + Same As Ever,28.0,7046602406565,284000,408000,124000,30,0,nha-sach-tiki
276313958,Vẻ Đẹp Của Cảnh Sắc Tầm Thường,917.0,2889121848173,168000,235000,67000,29,44,nha-sach-tiki
275928713,Đọc Vị Mọi Vấn Đề Của Trẻ - Giải Mã Mọi Vấn Đề Về Nuôi Con Nhỏ: Ăn - Ngủ - Kỷ Luật Hành Vi,5513.0,6416837828890,175000,239000,64000,27,582,nha-sach-tiki
275212810,MBA CƠ BẢN - Khóa Học Quản Trị Kinh Doanh Cấp Tốc Cho Người Bận Rộn - Tom Gorman (bìa mềm),2.0,6794492895691,215000,269000,54000,20,0,nha-sach-tiki
274845339,Đắc Nhân Tâm,233.0,4497708615058,61900,86000,24100,28,2,nha-sach-tiki
273717706,Hiểu Về Bản Chất Con Người - Lý Luận Của Bậc Thầy Tâm Thần Học,1076.0,8689851415957,71300,105000,33700,32,61,nha-sach-tiki
273534078,Quản Trị Bằng Văn Hóa,1443.0,5158307201530,179000,250000,71000,28,56,nha-sach-tiki
260811707,Muôn Kiếp Nhân Sinh 3 (Bìa Mềm),7260.0,5843579380988,109000,218000,109000,50,620,nha-sach-tiki
252035395,Tô Màu Động Vật - Song Ngữ Anh-Việt (Tập 2) - Tái Bản,5.0,9978278766713,10200,14000,3800,27,0,nha-sach-tiki
241746531,Bệnh Từ Miệng Mà Ra,156.0,7401803987501,92100,115000,22900,20,4,nha-sach-tiki
209891492,Những Người Hàng Xóm,4896.0,1904872163261,76000,110000,34000,31,508,nha-sach-tiki
206675362,Nâng Cao Tần Số Rung Động Mỗi Ngày: Khám Phá Cách Năng Lượng Vận Hành,16.0,7728703000892,102000,135000,33000,24,0,nha-sach-tiki
194960744,Đừng bao giờ đi ăn một mình,1082.0,3948812019786,90000,145000,55000,38,56,nha-sach-tiki
192475873,Để Con Được Ốm,3531.0,3567820525526,85500,120000,34500,29,104,nha-sach-tiki
189326210,Nghệ thuật tư duy dựa trên dữ liệu - Để ra quyết điịnh thông minh hơn trong một thê giới không chắc chắn,1213.0,2441295523720,91000,150000,59000,39,107,nha-sach-tiki
184070223,OSHO - Cảm Xúc,3373.0,9594312279888,152000,188000,36000,19,320,nha-sach-tiki
160370181,Khói Trời Lộng Lẫy (Tập Truyện Ngắn Nguyễn Ngọc Tư)(Tái Bản),942.0,5080592096041,57000,90000,33000,37,101,nha-sach-tiki
109017985,"Thiên Tài Bên Trái, Kẻ Điên Bên Phải (Tái Bản)",26729.0,8741635599269,123000,179000,56000,31,5478,nha-sach-tiki
102887973,Hôn Em Trước Đã (Tiểu Thuyết Trinh Thám),292.0,6725195644725,89900,89900,0,0,62,nha-sach-tiki
87392046,Con Đường Vạn Dặm Của Hồ Chí Minh (Tái Bản),400.0,8173291026363,87000,145000,58000,40,64,nha-sach-tiki
82936273,Óc Sáng Suốt (Tái Bản 2021),205.0,2531674919859,54000,60000,6000,10,30,nha-sach-tiki
79672197,Bí Mật Của May Mắn (Khổ Nhỏ)(Tái Bản),779.0,1217713291104,38700,45000,6300,14,70,nha-sach-tiki
73222804,Sách Putin Logic Của Quyền Lực (Tái Bản 2020),81.0,9576252906724,134400,168000,33600,20,11,nha-sach-tiki
71345381,Sách Thay Đổi Cuộc Sống Với Nhân Số Học - Lê Đỗ Quỳnh Hương,14973.0,2019473448712,248000,248000,0,0,2979,nha-sach-tiki
35191892,21 Bài Học Cho Thế Kỷ 21,20816.0,1070895004062,155000,209000,54000,26,1827,nha-sach-tiki
32219488,Doanh Nghiệp Của Thế Kỷ 21 (Tái Bản 2019),5656.0,5243473639406,65000,100000,35000,35,485,nha-sach-tiki
19274771,Chuỗi Án Mạng A.B.C (Tái Bản),207.0,6739491019720,97600,105000,7400,7,53,nha-sach-tiki
2619499,​Liễu Phàm Tứ Huấn (Tái Bản 2018),5028.0,3753095632928,43300,59000,15700,27,274,nha-sach-tiki
764032,Bé Tô Màu (2-6+) - Những Con Côn Trùng Bé Nhỏ - Tập 1,45.0,2521875309916,9000,12500,3500,28,1,nha-sach-tiki
480059,Lược Sử Nước Việt Bằng Tranh,1032.0,2521341863973,113000,140000,27000,19,9,nha-sach-tiki
277876898,Dấu Ấn Hoàng Gia – Tập 22,15.0,8547082025799,30000,30000,0,0,0,nha-sach-tiki
277521298,Dấu Ấn Hoàng Gia Tập 19,67.0,9804365940650,27100,30000,2900,10,4,nha-sach-tiki
277441515,Chữa Lành Bằng Reiki,13.0,9595797945207,109300,149000,39700,27,0,nha-sach-tiki
277408902,"Nóng Giận Là Bản Năng, Tĩnh Lặng Là Bản Lĩnh",58.0,7067148443414,65500,109000,43500,40,2,nha-sach-tiki
277393740,Sách Bán Chạy Như Điên,77.0,8663431969000,239000,239000,0,0,3,nha-sach-tiki
277356707,Triệu Lá Thư Gửi Mẹ (Bìa Cứng dạng hộp in bốn màu),64.0,7059064614869,159200,199000,39800,20,2,nha-sach-tiki
276933742,Combo Giáo Trình Chuẩn HSK - Sách Bài Học và Bài tập (Bộ 2 cuốn),40.0,4640925195248,276000,356000,80000,22,2,nha-sach-tiki
276886061,Hạnh Phúc Cầm Tay,3341.0,5834371800304,55000,75000,20000,27,295,nha-sach-tiki
276302840,Cơ Thể Người,73.0,7957702391386,209300,299000,89700,30,2,nha-sach-tiki
276019606,Không Gia Đình (Tái Bản),902.0,8891367440184,117000,160000,43000,27,142,nha-sach-tiki
274933687,Sách GỌI SỮA KHÔNG KHÓ,232.0,6966267829727,179000,179000,0,0,9,nha-sach-tiki
274649745,Luật Tâm Thức – Vũ Trụ Nhất Nguyên Luận,1748.0,9459423049473,210000,288000,78000,27,115,nha-sach-tiki
273691914,Trăm năm cô đơn,97.0,3210103536175,152000,199000,47000,24,5,nha-sach-tiki
272349551,Cú hích - Phiên bản cuối cùng (Tái bản),211.0,2078520533835,157000,198000,41000,21,7,nha-sach-tiki
272349547,"Phương pháp Simon: Cách học nhanh, nhớ lâu mọi kiến thức",170.0,7488224529221,131000,179000,48000,27,9,nha-sach-tiki
271516872,Letting Go - Lộ Trình Đi Đến Sự Buông Bỏ,0.0,7658279037364,143200,179000,35800,20,0,nha-sach-tiki
271278938,AI 2041 - 10 Viễn cảnh cho tương lai,1034.0,2430715681444,224000,298000,74000,25,52,nha-sach-tiki
270546273,Combo Tư Duy Ngược + Tư Duy Mở (Nguyễn Anh Dũng) SBOOKS ,3207.0,3955850316130,135000,276000,141000,51,182,nha-sach-tiki
263790942,Kẻ Thua Cuộc Giỏi Nhất Sẽ Giành Chiến Thắng - Đừng Để Vài Thất Bại Trên Sàn Chứng Khoán Khiến Bạn Chùn Bước,4.0,8286306585514,188000,188000,0,0,0,nha-sach-tiki
217172960,Bút lông bảng Thiên Long WB-03,187.0,5937729756712,8200,9100,900,10,0,nha-sach-tiki
186265449,Bạn Đang Nghịch Gì Với Đời Mình? (Tái Bản 2022),1210.0,2643340082789,88400,124000,35600,29,44,nha-sach-tiki
169377739,Búp Sen Xanh (Tái Bản 2020),299.0,5952153279434,61200,72000,10800,15,26,nha-sach-tiki
158641027,Kẻ Nhắc Tuồng (Tái Bản),857.0,7075456994255,111000,155000,44000,28,176,nha-sach-tiki
158019964,Combo 4 Cuốn Bộ Sách: Nuôi Con Không Phải Là Cuộc Chiến (Tái Bản),0.0,7241191404500,388000,486000,98000,20,0,nha-sach-tiki
155550591,Dinh Dưỡng Học Bị Thất Truyền - Dinh Dưỡng Đẩy Lùi Bệnh Tật,4968.0,4286056675035,136000,178000,42000,24,361,nha-sach-tiki
147920903,Một Thoáng Ta Rực Rỡ Ở Nhân Gian,15238.0,1967959392540,94900,135000,40100,30,2066,nha-sach-tiki
139303869,Nghệ Thuật Tinh Tế Của Việc Đếch Quan Tâm (Tái Bản),5526.0,6866671666215,97400,128000,30600,24,568,nha-sach-tiki
135552451,Các Triều Đại Việt Nam,1102.0,8984896242706,82000,120000,38000,32,143,nha-sach-tiki
106863963,Tâm Lý Học - Phác Họa Chân Dung Kẻ Phạm Tội,2506.0,7417324116157,145000,145000,0,0,613,nha-sach-tiki
91553053,Tiểu Sử Các Quốc Gia Qua Góc Nhìn Lầy Lội,769.0,9395390696757,152000,215000,63000,29,61,nha-sach-tiki
77105730,Tàn Ngày Để Lại (Bìa Cứng),143.0,1945037129756,135200,169000,33800,20,42,nha-sach-tiki
76013378,Storytelling With Data - Kể Chuyện Thông Qua Dữ Liệu (Cuốn Cẩm Nang Hướng Dẫn Trực Quan Hóa Dữ Liệu),12575.0,2491493924269,222000,319000,97000,30,1920,nha-sach-tiki
49002009,DƯỠNG TÂM GIÀU CÓ DƯỠNG THÂN NGHÈO KHÓ - NGUYỄN ANH DŨNG,3007.0,7132256472621,98000,98000,0,0,73,nha-sach-tiki
17336364,Phía Sau Nghi Can X (Tái Bản 2019),19478.0,2144215258059,93200,129000,35800,28,3541,nha-sach-tiki
12107394,Barron's Essential Words For The Toeic (Tái Bản),422.0,2975785987205,190400,238000,47600,20,94,nha-sach-tiki
10866297,Các Cuộc Chiến Tranh Tiền Tệ (Tái Bản),2528.0,3188681297142,97000,160000,63000,39,111,nha-sach-tiki
7496289,Sơn Nam - Lịch Sử Khẩn Hoang Miền Nam (Tái Bản),936.0,4805150779259,70000,115000,45000,39,94,nha-sach-tiki
1938895,Nghệ Thuật PR Bản Thân (Tái Bản 2018),78.0,3248730044865,84100,99000,14900,15,16,nha-sach-tiki
1667307,Quân Vương – Thuật Cai Trị (Tái Bản),115.0,9416226248958,89300,109000,19700,18,24,nha-sach-tiki
427631,Tầm Nhìn Thay Đổi Quốc Gia,2018.0,2423111669986,207000,268000,61000,23,49,nha-sach-tiki
277837132,Những Chủ nhật tháng Tám,17.0,5821521803661,110000,110000,0,0,0,nha-sach-tiki
277808321,Chậm Rãi Động Lòng (Tập 2),12.0,5949440246126,199000,199000,0,0,3,nha-sach-tiki
277750390,"Sách - Hồi Ký Nguyễn Thị Bình - Gia Đình, Bạn Bè, Đất Nước",75.0,4487251531079,151050,159000,7950,5,2,nha-sach-tiki
277742612,Người Mẹ,10.0,2256627299180,131500,189000,57500,30,0,nha-sach-tiki
277526109,Sách - AI Thực Chiến - Cuộc Cách Mạng Toàn Diện Trong Giáo Dục,4.0,8067797970769,179280,249000,69720,28,0,nha-sach-tiki
277360179,Dấu Ấn Hoàng Gia Tập 17,72.0,5421164138888,30000,30000,0,0,3,nha-sach-tiki
277312616,100 Truyền Thuyết Đô Thị Kinh Dị Đài Loan - Tập 1,33.0,5797396876888,120000,149000,29000,19,6,nha-sach-tiki
277165894,Đêm Yên Tĩnh -  Agatha Christie,116.0,1342178450292,99000,150000,51000,34,11,nha-sach-tiki
276756378,"Các Triết Gia Thế Tục - Cuộc Đời, Thời Đại Và Tư Tưởng Của Các Nhà Kinh Tế Vĩ Đại",89.0,6477222946219,214000,299000,85000,28,8,nha-sach-tiki
276394197,Sách - Bước Vào Giấc Mộng Cá Vàng - Truyện Ngôn Tình - Nghiêm Tuyết Giới,24.0,5222540385653,188000,235000,47000,20,2,nha-sach-tiki
276029106,"(Có chữ ký tác giả combo 2 cuốn): Gánh gánh … Gồng gồng, Khắc Đi … Khắc Đến – Xuân Phượng – Nxb Tổng Hợp Tp HCM",122.0,4963332116280,310000,310000,0,0,6,nha-sach-tiki
275948805,Quản Trị Dự Án,106.0,1208455588238,214000,285000,71000,25,5,nha-sach-tiki
275006070,"Giáo dục giới tính cho con trai - Lời khuyên thiết thực về tuổi dậy thì, giới tính và các mối quan hệ",0.0,9595014231640,81000,81000,0,0,0,nha-sach-tiki
273356637,Bác Hana,509.0,5321222075041,79900,109000,29100,27,54,nha-sach-tiki
270234757,Xứ Sở Miên Man,1853.0,3344255524479,155000,220000,65000,30,130,nha-sach-tiki
249960247,Sách Tiếng Anh Y Khoa dành cho người mới bắt đầu - Tác giả BS. Đỗ Trung Kiên (Tái bản mới nhất 2024),2945.0,6910957869059,199000,299000,100000,33,179,nha-sach-tiki
243006533,Britt-Marie Đã Ở Đây (Fredrid Backman),641.0,1368160058416,107000,165000,58000,35,54,nha-sach-tiki
215123449,Trí tuệ cổ xưa - Tất cả các loại nghiệp,467.0,4528008594377,168000,235000,67000,29,33,nha-sach-tiki
205033951,Một chỗ trong đời,1573.0,4241489430129,49800,69000,19200,28,140,nha-sach-tiki
204000450,Combo Sách Giáo Trình Chuẩn HSK 1 - Sách Bài Học Và Bài Tập (Bộ 2 Cuốn),1214.0,3562415822158,274100,356000,81900,23,77,nha-sach-tiki
194130753,Bong bóng số 0-9 nhiều màu 35cm trang trí tiệc xinh,101.0,3257868017266,15000,15000,0,0,6,nha-sach-tiki
191148988,Đèn Không Hắt Bóng (Tái Bản Lần 8),441.0,6798792684606,159000,219000,60000,27,48,nha-sach-tiki
171556602,2030: Những Xu Hướng Lớn Sẽ Định Hình Thế Giới Tương Lai (Tái Bản Lần 1),2819.0,5544600760243,167000,209000,42000,20,243,nha-sach-tiki
155463025,Nghệ Thuật Bán Hàng Bậc Cao - Bí Quyết Chốt Deal Mọi Thời Đại (Khổ Lớn)(Tái Bản),33.0,2853855943951,168000,198000,30000,15,2,nha-sach-tiki
153518828,Hong Tay Khói Lạnh (Tản Văn Nguyễn Ngọc Tư),2607.0,3769761058250,59000,90000,31000,34,349,nha-sach-tiki
145288029,Xứ Cát,8510.0,5282892978499,136950,249000,112050,45,1408,nha-sach-tiki
114046590,Chân Dung Của Dorian Gray,59.0,1199185857288,113400,126000,12600,10,10,nha-sach-tiki
111537689,Án Mạng Trên Sông Nile (Agatha Christie)(Tái Bản),87.0,7023870344613,121500,135000,13500,10,30,nha-sach-tiki
107026335,Trắng,274.0,4387297995161,63200,79000,15800,20,14,nha-sach-tiki
87391039,Thuật Yêu Đương (Tái Bản),1856.0,7316957922937,75000,120000,45000,38,225,nha-sach-tiki
80417220,Việt Nam Sử Lược (Bìa Cứng) (Tái Bản),39.0,4832860614025,153500,153500,0,0,6,nha-sach-tiki
77105703,Lão Tử Tinh Hoa (Ts Thu Giang)(Tái Bản),74.0,4476881478370,82600,95000,12400,13,15,nha-sach-tiki
10095276,Ikigai - Bí Mật Sống Trường Thọ Và Hạnh Phúc Của Người Nhật,181.0,3520360597301,81000,90000,9000,10,17,nha-sach-tiki
8885995,Sự Im Lặng Của Bầy Cừu (Tái Bản),844.0,8671611615413,92000,115000,23000,20,121,nha-sach-tiki
8835159,Đời Ngắn Đừng Ngủ Dài (Tái Bản),45860.0,7265668071233,55000,85000,30000,35,3170,nha-sach-tiki
1681473,Cảm Ơn Vì Đến Trễ,44.0,4441820313080,211500,235000,23500,10,10,nha-sach-tiki
1544255,Băng Keo Trong 5F (2 Cuộn / Lốc),911.0,7987508167295,20000,20000,0,0,100,nha-sach-tiki
648672,Đất Rừng Phương Nam (Tái Bản),2528.0,3105869967437,58800,81000,22200,27,216,nha-sach-tiki
445866,Tịnh Tông Nhập Môn,471.0,2417535604210,17000,17000,0,0,1,nha-sach-tiki
441373,Những Cuộc Phiêu Lưu Của Tom Sawyer (Đinh Tị),117.0,2511361911440,75600,89000,13400,15,26,nha-sach-tiki
176309243,Lô 4 cuộn túi rác tiện dụng Inochi- Soji : 25 Lít (54 x 70cm),62.0,4942336501832,54000,71818,17818,25,8,nha-cua-doi-song
277620082,Nồi Cookplus Speed Cook 16cm - Màu vàng (Một tay cầm) - LCA3161Y-1,13.0,3874801974497,409000,409000,0,0,0,nha-cua-doi-song
83412126,Bình Giữ Nhiệt Lock&Lock Energetic One-Touch Tumbler LHC3249 - 550ML,23047.0,2186358773080,333000,560000,227000,41,3567,nha-cua-doi-song
201040328,Bình giữ nhiệt LocknLock Riga Tumbler Vietnam Edition LHC4160 897ml,2702.0,4080016476690,438000,736000,298000,40,406,nha-cua-doi-song
191918107,Bình lắc LocknLock Balance Shake It Bottle HAP949 800ml,735.0,1171170118704,174000,294000,120000,41,103,nha-cua-doi-song
276440258,"Bình Gas Bơm Bật Lửa Bluesky 5 Đầu Bơm Dung Tích 150gr/275ml Siêu Tiện Dụng, Bình Bơm Gas Bật Lửa Hàn Quốc",306.0,7953843234769,58000,58000,0,0,18,nha-cua-doi-song
276238012,"Hộp nhựa đựng đồ, đựng thực phẩm đa năng có nắp gài và quai xách tiện lợi nhựa PP trong suốt thương hiệu VIệt Nhật",14.0,5373683956058,59000,99000,40000,40,1,nha-cua-doi-song
276165574,[Combo 10] Móc Dán Tường 3D Hình dễ thương – Chịu Lực Tốt – Siêu Dính,11.0,2425414792891,29000,40000,11000,28,1,nha-cua-doi-song
275869950,Đèn LED gắn tường cảm biến GT16.PIR 15W,57.0,3328943438862,193000,367000,174000,47,2,nha-cua-doi-song
73124602,Bình Giữ Nhiệt Bằng Thép Không Gỉ Lock&Lock Vacuum Bottle LHC6180SLV (800ML),41112.0,7494611465205,436000,677000,241000,36,7092,nha-cua-doi-song
207490055,"Kệ góc inox 3 tầng 304 đa năng – Phù hợp cho nhà bếp, nhà tắm, tiết kiệm diện tích",3.0,2153018122230,700000,700000,0,0,0,nha-cua-doi-song
275399332,Tủ Nhựa Đa Năng 3 4 5 Tầng Chính Hãng Giải Pháp Lưu Trữ Thông Minh Để Đồ Di Động,13.0,3305605174451,699000,799000,100000,13,3,nha-cua-doi-song
182971940,Bình giữ nhiệt LocknLock có 2 nắp thay thế New Clip Tumbler 540ml LHC4279,2242.0,7966240754631,368000,572000,204000,36,350,nha-cua-doi-song
226036798,Bình Giữ Nhiệt LocknLock 550ml LHC3249,1124.0,9070987023180,404000,622000,218000,35,153,nha-cua-doi-song
275598585,"Dưỡng Hoa Tươi Lâu Greenhome, Longlife, Phân Bón Cho Hoa Cắt Cành, Gói 5gr, Lâu Tàn, Nở Bông To, Không Bị Hôi Nước",148.0,2240261951909,2750,4900,2150,44,2,nha-cua-doi-song
275570245,Chảo Inox dập nguyên khối Elmich EL-2431OL,114.0,6270168674220,426000,900000,474000,53,21,nha-cua-doi-song
275189108,Cốc giữ nhiệt inox 304 Elmich EL8345 dung tích 480ML - Hàng Chính Hãng,72.0,1370304859415,182000,390000,208000,53,13,nha-cua-doi-song
274721418,Ô Dù Che Mưa Đi Nắng Tự Động Xếp Gấp Gọn Chống UV Cao Cấp Cho Ô Tô Xe Hơi (phiên bản ĐẶC BIỆT 12 nan chịu lực),131.0,6774154135435,129000,139000,10000,7,18,nha-cua-doi-song
273619945,Cốc giữ nhiệt inox 304 Elmich EL8312 dung tích 600ml - Hàng Chính Hãng,169.0,2223675491181,216000,499000,283000,57,23,nha-cua-doi-song
275627576,[KV] Ly giấy 22oz~649ml - Lốc 50 ly giấy trơn ,11.0,7394297488508,56000,56000,0,0,0,nha-cua-doi-song
207478015,KỆ GÓC 2 TẦNG INOX 304 TÍN THÀNH PHÁT,0.0,5292310734472,550000,550000,0,0,0,nha-cua-doi-song
275627325,[KV] Ly giấy 12oz~354ml - Lốc 50 ly giấy trơn ,32.0,2427229248509,35500,35500,0,0,0,nha-cua-doi-song
275627108,[KV] Ly giấy 10oz~295ml - Lốc 50 ly giấy trơn,12.0,3821032114843,31000,31000,0,0,0,nha-cua-doi-song
275627558,[KV] Ly giấy 16oz~472ml - Lốc 50 ly giấy trơn ,9.0,3941667858560,47500,47500,0,0,0,nha-cua-doi-song
273244983,Cốc giữ nhiệt inox 304 Elmich EL8309 dung tích 900ml - Hàng Chính Hãng,119.0,1817709359970,299000,559000,260000,47,25,nha-cua-doi-song
259514009,"10 Muỗng Đong Định Lượng Greenhome, 2 Đầu, Chia Vạch Sẵn, Tiện Lợi, Đong Phân Bón Dạng Bột, Gia Vị",2793.0,5343195603292,2780,4000,1220,31,0,nha-cua-doi-song
195797725,Thớt tre tự nhiên Sunhouse KS-CHB,294.0,5330530874856,85000,125000,40000,32,47,nha-cua-doi-song
195469953,Súng Bắn Keo (Cỡ Lớn/Nhỏ) Kèm 10 Keo Nến Silicon,506.0,8574747222248,95000,100000,5000,5,73,nha-cua-doi-song
169362095,"Bàn Chải Chà Chân , Chà Sàn , Giặt Đồ Có Khay Đựng Xà Phòng Hiện Đại GroFa - Chính Hãng ",41.0,8554843400639,39000,39000,0,0,1,nha-cua-doi-song
149349961,Nhang Xanh Phổ Thông 30cm 500g - Chân mộc,687.0,8668125540659,165000,165000,0,0,50,nha-cua-doi-song
117058329,Giấy lọc cà phê Hario 100 cái (V60-VCF-01-100W),489.0,5629282442663,99000,99000,0,0,55,nha-cua-doi-song
114204741,Bình giữ nhiệt inox 304 Sunhouse 450ml KS-TU450I,137.0,6232257964377,87000,87000,0,0,18,nha-cua-doi-song
94778000,"Ô Dù che nắng, che mưa, có nút bấm 2 chiều, hàng chất lượng, dễ thương, thiết kế sang trọng và bền bỉ, ô dù có lựa chọn màu sắc, ",1337.0,9100607091971,196000,196000,0,0,273,nha-cua-doi-song
84886093,Vợt muỗi thông minh 3in1 SUNHOUSE SHE-PRO11.W,1163.0,6456848067230,229000,344000,115000,33,188,nha-cua-doi-song
82875291,"Bộ 2 thùng vải, hộp vải đựng đồ đa năng -Màu Nâu Kem + Tặng kèm dây cột tóc- Hộp vải đựng quần áo 2 size đựng quần áo, đồ lót, giày, văn phòng phẩm, đồ dùng cá nhân rất tiện lợi-Bộ 2 hộp vải đựng đồ vải canvas siêu xinh có nắp đậy, tủ vải đựng đồ hộp cái ",967.0,5337520824838,99000,99000,0,0,144,nha-cua-doi-song
81895232,"Combo 3 Giỏ treo chậu hoa ban công MONROVIA, giỏ sắt treo chậu hoa ban công, chậu treo ban công, kệ treo ban công, móc treo, khung thép, sơn tĩnh điện chính hãng thương hiệu MONROVIA ",531.0,3937154772308,115000,115000,0,0,94,nha-cua-doi-song
72128693,Bình xịt phun sương tưới cây bình áp suất nén khí cao cấp 2 lít,51.0,4067789264593,98000,135000,37000,27,6,nha-cua-doi-song
71890908,Bộ lau nhà xoay 360 độ Sunhouse KS-CL330S,5663.0,5955369732589,297000,406000,109000,27,692,nha-cua-doi-song
71178441,"Áo Mưa Bít Dù Trơn, Áo Mưa Kín Người Vải Dù Siêu Dày 1M4, Chống Thấm Hiệu Quả, Phù Hợp Nam Và Nữ, Có Túi Đựng, Có Lựa Chọn Màu Sắc",989.0,7933299170181,115000,115000,0,0,243,nha-cua-doi-song
68413077,"Đèn đọc sách mini, pin sạc tiện dụng Baseus Comfort Reading Mini Clip Lamp ( Dịu mắt, chân kẹp, 3 mức sáng, 350mAh, 24h sử dụng)hàng nhập khẩu",915.0,1368952937683,215000,248000,33000,13,192,nha-cua-doi-song
58357614,"Đèn bắt muỗi, ruồi và các loại côn trùng Con Dơi",4854.0,3432364889774,379000,379000,0,0,1021,nha-cua-doi-song
57806524,"Áo Mưa Bộ Vải Dù Cao Cấp Cho Bé Từ 3 -10 Tuổi, Chống Thấm, Che Kín Người An Toàn Cho Bé, Lựa Chọn Màu Sắc Phù Hợp Giới Tính (Giao Màu - Mẫu Ngẫu Nhiên)",516.0,8997883643771,110000,110000,0,0,108,nha-cua-doi-song
46694285,"NỒI INOX CAO CẤP 3 LỚP ĐÁY LIỀN TRI-MAX 2353731, 2353732, 2353733, 2353734, 2353735, 2353736",237.0,8268375340905,800000,999000,199000,20,90,nha-cua-doi-song
46327991,"Hộp Nhựa Đựng Thực Phẩm Trong Suốt GAGI Mã GH01 Nhựa PP Bền Bỉ, Sử Dụng Cho Cả Lò Vi Sóng Không Bám Mùi Dễ Dàng Vệ Sinh - Hàng Chính Hãng",1545.0,1104605685873,47000,79000,32000,41,184,nha-cua-doi-song
17423771,"5 Viên Pin CR2032 3V Panasonic Lithium thay pin Smartkey , Cmos , Pin thay Airtag - Hàng chính hãng",60.0,1693054414764,72000,72000,0,0,10,nha-cua-doi-song
8282408,Ổ Cắm Điện Huntkey SZM401 Power Strip,20.0,4953669488664,109002,109002,0,0,2,nha-cua-doi-song
6652303,"Mền tuyết NIN HOUSE 100% Microfiber 1m3x2m mới 2024, chăn hè cao cấp mịn màng, chăn lông tuyết nhung nhiều màu",213.0,1805613202549,219000,219000,0,0,19,nha-cua-doi-song
892121,Pin Max 8 + 4 Viên Energizer E91 BP8+4 AA,2766.0,8567702194984,140000,140000,0,0,317,nha-cua-doi-song
655371,Đèn Pin Tay Cầm Cỡ Trung Sunhouse SHE-4131 (3W) - Đen Đỏ,44.0,3974274939069,72900,119000,46100,39,5,nha-cua-doi-song
226399119,"Kệ Hộp Đựng Đồ Lớn, Thùng Đựng Đồ 2 Cánh Cửa Đa Năng Có Bánh Xe - HÀNG ĐẸP VANDO",60.0,2398181964640,559000,800000,241000,30,5,nha-cua-doi-song
249891763,Kệ đa năng nhà bếp có nắp đậy kín thép carbon sơn không gỉ SIÊU XỊN - SIÊU ĐẸP - SIÊU BỀN,66.0,6108765252248,1099000,1099000,0,0,17,nha-cua-doi-song
170338168,"Kệ chén bát đa năng VANDO kích thước 1 tầng 95cm bằng thép carbon cao cấp không gỉ, giá để bát trên bồn rửa ráo nước cho nhà bếp sạch sẽ",30.0,7458832396373,699000,1000000,301000,30,9,nha-cua-doi-song
277451259,Chai Xịt Đuổi Chuột RAT OFF ANTI RAT SPRAY 200ml Thái Lan,1.0,2100852098015,92820,150000,57180,38,0,nha-cua-doi-song
277448944,Chiếu Ngủ Văn Phòng Cao Cấp Cá Nhân Chiếu Cách Nhiệt Thảm Ngủ Trưa Tấm Lót Đa Năng Du Lịch Dã Ngoại - PaKaSa ( Viền màu ngẫu nhiên),7.0,8391092738394,69000,138000,69000,50,0,nha-cua-doi-song
276965213,Chảo Inox liền khối Sunhouse Healthy IN20M7E - IN24M7E - IN26M7E - Dùng cho mọi loại bếp,5.0,4569749940636,242000,320000,78000,24,0,nha-cua-doi-song
276847009,"Vỉ 10 Đôi Đũa Kháng Khuẩn 3 Sọc , Hàng Chuẩn Xuất Nhật , Thiết Kế Chống Trượt Được Sử Dụng Phổ Biến Rộng Rãi Ở Nhà Hàng , Khách Sạn , Trong Gia Đình - Hàng cao cấp",4.0,9013881099951,39000,78000,39000,50,0,nha-cua-doi-song
276504239,"Đèn Led Trang Trí Tết, Giáng Sinh, Noel Nhiều Kiểu Dáng Dài 10 Mét",9.0,4896109840228,123500,130000,6500,5,1,nha-cua-doi-song
181971817,"Nệm cao su thiên nhiên Rosi massage Thắng Lợi, Đệm cao su thiên nhiên hàng chính hãng",28.0,6527508990111,2780000,2780000,0,0,6,nha-cua-doi-song
14251502,"Lưới Võng Đại Tín Thành Phát – 2 Lớp Dày Dặn, Thoáng Mát, Êm Ái, Chắc Chắn",356.0,5779972586977,300000,300000,0,0,94,nha-cua-doi-song
276452619,Màng co bọc thực phẩm cao cấp - PE Shinsen Inochi - bảo quản thực phẩm tươi sạch nhiều size ( tặng kèm khăn lau đa năng),5.0,3728957430115,89000,145000,56000,39,0,nha-cua-doi-song
276451620,"Combo 3 Đèn LED Gắn Tủ , Trang Trí Tủ Phòng Ngủ , Phòng Khách Có Chức Năng Hẹn Giờ - Hàng Chính Hãng",24.0,6720130923186,116620,180000,63380,35,2,nha-cua-doi-song
275858428,Bộ Hộp Kim Chỉ May Vá Đa Năng 2 Tầng 20 Chi Tiết Tiện Lợi Khâu Vá Quần Áo,16.0,8213473468664,69000,95000,26000,27,1,nha-cua-doi-song
275405718,Gương Dán Tường Tai Mèo Xoay 14.5 cm PaKaSa - Hàng chính hãng,6.0,2811042143578,69000,138000,69000,50,1,nha-cua-doi-song
275079966,Đũa - Combo 30 đôi đũa khảm vàng - Đũa ăn viền vàng - đũa ăn cơm - đũa ăn đen viền vàng - Hàng chính hãng,7.0,5481994593433,81000,81000,0,0,0,nha-cua-doi-song
274962328,Xô Đựng Nước Gấp Gọn Đa Năng Có Bánh Xe Chậu Gấp Gọn Tiện Lợi Giặt Cây Lau Nhà Chùi Kính Dung Tích 12L,17.0,2246178849260,95000,145000,50000,34,0,nha-cua-doi-song
274645566,"Hộp đựng thực phẩm Hokori - Hàng nhựa Việt Nhật có khóa thoát khí, có lỗ thoát nước ",13.0,6353349758865,75000,120000,45000,38,1,nha-cua-doi-song
274597284,Hộp Nhựa Chia Thuốc 7 Ngăn - Giao Màu Ngẫu Nhiên,118.0,2879484256311,19000,38000,19000,50,14,nha-cua-doi-song
274580036,"Hộp Đựng Đũa Thìa Dán Tường HOKORI, Bốn Ngăn Tiện Dụng Có Nắp Đậy, Dán Tường Siêu Chắc Chắn - Hàng Việt Nam",28.0,8417084244980,189000,378000,189000,50,5,nha-cua-doi-song
274415047,"Đèn pin laser 303 siêu sáng gồm pin, sạc và khóa - Đèn lazer 303 tia Xanh lá - Hàng chính hãng",55.0,2715160272452,159000,159000,0,0,4,nha-cua-doi-song
273979410,Tấm Chắn Văng Dầu Mỡ Cho Nhà Bếp - Hàng chính hãng ,30.0,4771037397621,29000,58000,29000,50,2,nha-cua-doi-song
273661034,Bình giữ nhiệt inox 316 Elmich EL8316 dung tích 460ml - Hàng Chính Hãng,79.0,5656524364110,256000,490000,234000,48,13,nha-cua-doi-song
272400903,Hộp cơm giữ nhiệt inox 304 Elmich EL8303 dung tích 2L - Hàng chính hãng,62.0,7501291414840,837000,1699000,862000,51,10,nha-cua-doi-song
270462666,Ly nhựa 2 lớp Daily Essential LocknLock HAP526 - Ống hút cùng màu - Nắp đậy trong suốt - Kèm cọ vệ sinh - Dung tích 770ml,561.0,4033282911251,156000,243000,87000,36,14,nha-cua-doi-song
249694552,"Bình xịt nước tưới cây, tạo mẫu tóc FuNu cao cấp - Hàng chính hãng, giao màu ngẫu nhiên",83.0,5062405249521,42750,45000,2250,5,6,nha-cua-doi-song
207005253,Bộ 2 Dây Phơi Quần Áo Thông Minh 5M GroFa Giao màu ngẫu nhiên ,9.0,3486870474787,29000,29000,0,0,0,nha-cua-doi-song
197571724,"Khăn Tắm, Khăn Mặt, Combo 2 Khăn Lông Cừu Kích Thước 70cm x 140cm, 35cm x 75cm, Tiêu Chuẩn Hàn Quốc Sêu Mềm Mịn, An Toàn Cho Da - Chính hãng ",30.0,1011663022095,69000,138000,69000,50,1,nha-cua-doi-song
186558014,Combo 10 Móc Dán Tường Treo Đồ Đa Năng Siêu Chịu Lực,3142.0,6994053079370,19000,20000,1000,5,420,nha-cua-doi-song
186288399,Lược Bướm Thép Tập Quay CSGO Dùng Tập Luyện - Mô Hình Butterfly CSGO – Lược Butterfly,185.0,2060649115859,59000,59000,0,0,13,nha-cua-doi-song
177081696,Cây Sứ Thái Kép Hoa Tím - cây cảnh để trong nhà + tặng phân bón cho cây,186.0,3980118532556,65000,110000,45000,41,36,nha-cua-doi-song
173085730,"Pin CR2 Lithium 3V Energizer dùng cho máy ảnh , máy đo khoảng cách - hàng chính hãng",60.0,7573294233255,105000,105000,0,0,3,nha-cua-doi-song
168247093,Kéo Cắt Đa năng Hàn Quốc P300 HWA SHIN,45.0,5736291093280,193000,193000,0,0,8,nha-cua-doi-song
148810239,"Hộp Cơm Cắm Điện Đời Mới Chính Hãng MINIIN, Hâm Nóng, Giữ Nhiệt, Nấu Chín Cơm Và Thức Ăn, 2 Tầng Nhỏ Gọn, 4 Bát Innox Không Gỉ, Tặng Kèm Bộ Đũa Và Thìa, Đa Chức Năng, Dễ Dàng Vệ Sinh",284.0,2145555562193,259000,259000,0,0,55,nha-cua-doi-song
141971329,"Túi Đựng Hộp Cơm Grepaco Giữ Nhiệt Nóng Lạnh Dạng Đứng Có Ngăn Phụ Đựng Đồ Thức Ăn Văn Phòng, Du Lịch – Vải Bố Canvas, Kích Thước Size Vừa, Kiểu Giỏ Xách Thời Trang Nam Nữ - Tặng Túi Đựng Muỗng Nĩa - Hàng Chính Hãng",354.0,4913407983572,69000,69000,0,0,91,nha-cua-doi-song
134360863,"Vỉ 6 Viên Pin AA , Pin AAA Energizer Max 1,5V Alkaline - Hàng chính hãng",1240.0,2656755417428,90000,90000,0,0,139,nha-cua-doi-song
120552065,Bình giữ nhiệt inox 304 Elmich EL-8013OL dung tích 480ml,2181.0,9367707323552,143000,389000,246000,63,309,nha-cua-doi-song
89774434,"Đèn cảm ứng chuyển động, Đèn Led dán tường cảm biến thông minh không dây dán tủ quần áo, cầu thang, phòng ngủ...",335.0,2534787454543,76000,80000,4000,5,37,nha-cua-doi-song
71342375,"Áo Mưa Bít Trẻ Em Vải Dù Siêu Dày Hàng Việt Nam, Chống Thấm Nước, Phơi Mau Khô Ráo, Che Kín Người An Toàn Cho Bé, Có Lựa Chon Size, Giới Tính Cho Bé ( Giao Màu - Mẫu Ngẫu Nhiên Vì Nhiều Hoạt Tiết)",275.0,1905798381616,90000,90000,0,0,52,nha-cua-doi-song
67980198,"Phân bón hữu cơ sinh học KingCrop, dùng trồng rau, cây ăn trái sạch, an toàn",53.0,5545737514284,70000,70000,0,0,7,nha-cua-doi-song
67937873,Tấm bảo vệ nệm Everon White,561.0,6196849408474,370000,370000,0,0,121,nha-cua-doi-song
59412424,"Bộ Dụng Cụ Bếp (Đũa, Sạn, Vá) Bằng Gỗ Nhãn Tự Nhiên - VAGOO - Làm Thủ Công Chống Thấm, Chống Ẩm Mốc, An Toàn Sức Khoẻ",94.0,3949505377521,169000,169000,0,0,28,nha-cua-doi-song
54682452,Pin vuông 9V Energizer 522 ALKALINE chính hãng ( Mẫu mới ),846.0,6934304750382,75000,75000,0,0,75,nha-cua-doi-song
52301339,"Móc Dán Tường Inox SUS304 treo đồ gia đình phòng ăn, nhà bếp, nhà tắm tiện lợi",88.0,9969746509158,42750,45000,2250,5,3,nha-cua-doi-song
35912717,Cân Tiểu Ly Điện Tử Platform 1 Kg Cao Cấp ,79.0,4609356573228,135000,135000,0,0,7,nha-cua-doi-song
10829409,Cân Tiểu Ly Điện Tử Platform 1 KG,44.0,2036680270011,142000,142000,0,0,8,nha-cua-doi-song
277571452,Tranh thế giới,14.0,9080677537921,139000,139000,0,0,3,nha-cua-doi-song
277369298,"Đèn Bắt Muỗi Tự Động - Máy Bắt Muỗi Thông Minh, Hút Côn Trùng, Công Nghệ Đèn LED, Kiêm Đèn Ngủ Sạc USB - HÀNG CHÍNH HÃNG MINIIN",25.0,6497174336511,129000,129000,0,0,1,nha-cua-doi-song
276801072,Áo Mưa Royal Helmet - Áo Mưa Cánh Dơi có nón,54.0,2713964956554,99000,99000,0,0,0,nha-cua-doi-song
276285253,Túi Vải Canvas đặc biệt Đựng Ly Giữ Nhiệt Commuter 1180ml tiện lợi đi học đi làm đi chơi - ELEMENTAL,13.0,5302966441014,85000,85000,0,0,1,nha-cua-doi-song
276177979,Túi giữ mát đựng cơm hằng ngày LocknLock,96.0,8644893668314,203000,315000,112000,36,7,nha-cua-doi-song
276025122,Chảo inox nguyên khối Elmich Trimax EL 3846 LOL size 28cm,22.0,5213808772314,519000,999000,480000,48,2,nha-cua-doi-song
275936249,"Khăn Tắm Nén Du Lịch Tiện Lợi Dùng 1 Lần 70*100cm, Bao Bì Đỏ - Chính Hãng",201.0,2084899190088,19000,29000,10000,34,2,nha-cua-doi-song
275570183,Bình đựng thức ăn giữ nhiệt inox 304 Elmich EL8336 dung tích 800ml,96.0,2318990672755,309000,750000,441000,59,12,nha-cua-doi-song
275511640,Chảo chống dính Elmich EL-4718OL,127.0,6835340124141,143000,289000,146000,51,23,nha-cua-doi-song
275367488,Bình giữ nhiệt inox 304 Elmich EL8295 dung tích 500ml,379.0,8580054108041,206000,390000,184000,47,22,nha-cua-doi-song
275090381,"Gói Xi Măng Dẻo 20g Bịt Lỗ Điều Hoà, Đường Ống Nước, Keo Dán Lỗ Tường Bằng Xi Măng",497.0,4131877803067,2500,4000,1500,38,3,nha-cua-doi-song
275058873,Bình giữ nhiệt Metro Cafe Tumbler LocknLock LHC4357 - Dung tích 500ml - Phủ sứ,228.0,4276655593077,466000,628000,162000,26,37,nha-cua-doi-song
274965041,"Máy Bắt Muỗi Thông Minh HIKITECH, Diệt Côn Trùng Đa Năng, Hiệu Quả. Tặng kèm Chổi Vệ Sinh Lồng Đèn",82.0,3439927799425,279000,279000,0,0,12,nha-cua-doi-song
274798475,"[Loại 1 - có Khay ] Máy bắt muỗi diệt côn trùng thông minh, Đèn bắt muỗi kiêm đèn ngủ có cổng sạc USB  - Hãng miDoctor",35.0,7743045235836,102000,102000,0,0,1,nha-cua-doi-song
274650574,Móc Treo Thau Kiểu Vuông Dán Tường Chắc Chắn,85.0,9047676240377,18050,19000,950,5,2,nha-cua-doi-song
273661002,Bình giữ nhiệt inox 316 Elmich EL8315 dung tích 480ml - Hàng Chính Hãng,162.0,2736168377783,198000,470000,272000,58,26,nha-cua-doi-song
270102591,"Nhiệt kế đo độ ẩm, máy đo nhiệt độ phòng cho bé - Nhiệt Ẩm Kế Điện Tử 3 Trong 1 - Thương hiệu RiBi - Hàng Chính Hãng",297.0,7696758051309,149000,165000,16000,10,33,nha-cua-doi-song
263239696,Pin kiềm AAA Philips LR03P10TS/97 vỉ 10 viên,91.0,6137085053271,86000,109000,23000,21,8,nha-cua-doi-song
205291681,"Khăn Tắm 100% Cotton Cao Cấp Homemark - Siêu Mềm Mại, Thấm Hút, Dùng Cho Mặt, Gội Đầu, Gym, Thể Thao",76.0,9691325415922,75000,89000,14000,16,4,nha-cua-doi-song
199728521,Bộ lau nhà đa năng Space Saving Sunhouse KS-CL3211P,950.0,5883576265421,240000,450000,210000,47,100,nha-cua-doi-song
196362415,"Máy cắt cỏ, tỉa cành cầm tay LAPUSEN pin khủng 15000mah, động cơ mạnh 1800w",215.0,4003153317489,299000,299000,0,0,45,nha-cua-doi-song
191506484,Đèn Bàn Học LED Đọc Sách Làm Việc Chống Cận Bảo Vệ Mắt - Cảm Ứng 5 Cấp Độ Điều Chỉnh  - Điều Chỉnh Vùng Sáng - Gấp Gọn Tiện Lợi ,524.0,3028589388051,480000,550000,70000,13,89,nha-cua-doi-song
190989483,Bình giữ nhiệt Baby Inox 316 Elmich EL8017 dung tích 300ml,264.0,4528383314083,237000,319000,82000,26,46,nha-cua-doi-song
187829576,"VỎ GỐI NẰM,GỐI ÔM COTTON MỀM MỊN. THOÁNG MÁT GIÁ SIÊU RẺ,KÍCH THƯỚC 40X60.50X70.35X105.",332.0,2319676537253,34400,40000,5600,14,51,nha-cua-doi-song
155286369,Bộ Hộp Cơm Tupperware Crysral Wave Lunch Set Kèm Muỗng Nĩa & Túi Đựng,23.0,8444207726421,260000,750000,490000,65,3,nha-cua-doi-song
151462143,Sáo recorder 6 lỗ cao cấp ,95.0,5001553572845,89000,89000,0,0,10,nha-cua-doi-song
145762926,"Khăn Tắm 100% Cotton Pakistan Cao Cấp Homemark - Siêu Dày, Mềm Mại, Không Phai Màu, Thấm Hút Tốt",774.0,5042218360370,33000,39000,6000,15,41,nha-cua-doi-song
134853381,Bình giữ nhiệt LocknLock Feather Light Ring 460ml,4644.0,8905347153837,387000,601000,214000,36,339,nha-cua-doi-song
125739804,"BỘ CÂY LAU NHÀ THÔNG MINH SAGOKER, mã BLNEC",731.0,6232673402599,249999,249999,0,0,156,nha-cua-doi-song
85029640,"Ổ cắm Điện Quang ĐQ ESK 2WR 23-3U (2 lỗ 3 chấu, 3 USB, dây dài 2m, màu trắng đỏ)",114.0,5023610649952,200777,267700,66923,25,36,nha-cua-doi-song
75330721,"Then Chốt Cài Cửa, Chốt Khóa Bằng Thép Không Gỉ KUNBE An Toàn Tiện Lợi Nhiều Kích Thước",659.0,6025010879921,22900,22900,0,0,78,nha-cua-doi-song
70820849,Pin CR2032 Energizer 3V vỉ 5 viên,1450.0,1743485832108,75000,75000,0,0,261,nha-cua-doi-song
57867023,Cây Lau Nhà Xoay 360 Độ Sunhouse Ks-Mo350I,3687.0,3339191897104,127000,200000,73000,37,674,nha-cua-doi-song
56383693,Combo 300 túi lọc rác bồn rửa bát,239.0,6109669537040,82000,95000,13000,14,15,nha-cua-doi-song
54133235,Pin Sạc AA 2000mAh NH15 Power Plus RP2 Energizer NH15 RP2 (Mẫu mới),438.0,8773785239287,179000,179000,0,0,50,nha-cua-doi-song
51373821,Đèn bàn học led cảm ứng chính hãng Rạng Đông Model: RD RL 36 LED,126.0,3732739289261,225000,225000,0,0,37,nha-cua-doi-song
31672125,GIẤY THƠM BOUNCE  (160 Tờ x 1 hộp ),693.0,1292511538274,205000,205000,0,0,131,nha-cua-doi-song
14639229,Nắp Kính Cường Lực Nồi Và Chảo Fivestar,979.0,8678012183275,100000,100000,0,0,149,nha-cua-doi-song
14526627,Quánh Inox 430 Bếp Từ 3 Đáy Fivestar Nắp Kính - Tặng 5 Muỗng Ăn Inox - Bạc,84.0,3354146450494,350000,350000,0,0,24,nha-cua-doi-song
718889,Thùng rác nhựa Fitis Compact PPS1-906 - xám - 10L,641.0,4350347342773,250000,250000,0,0,91,nha-cua-doi-song
277740569,Bộ thìa 6 chiếc Elmich EL0004 - Hàng chính hãng,7.0,9746632564047,319000,319000,0,0,1,nha-cua-doi-song
277378901,Lót ly gỗ khắc logo Durex,6.0,3194453336364,100000,100000,0,0,0,nha-cua-doi-song
276409126,Giá Đựng Sách Để Bàn Deli - Kệ Chia 4 Ngăn Văn Phòng Học Sinh Sinh Viên - Chặn Sách Nhiều Ngăn Giúp Sắp Xếp Tài Liệu,46.0,5578836005698,69000,124200,55200,44,0,nha-cua-doi-song
276328451,"Màn dây có cửa Funu, vải mềm mịn, mắt lưới nhỏ, định hình ổn định giúp thông thoáng, chống muỗi an toàn, bảo vệ giấc ngủ - Hàng chính hãng",94.0,3920251184958,160000,200000,40000,20,19,nha-cua-doi-song
276296831,COMBO 4 Miếng Lót Chân Bàn Ghế Silicone Bọc Chân Bàn Ghế Vuông & Tròn Tiện Lợi,183.0,8633315964956,13000,25000,12000,48,3,nha-cua-doi-song
276025118,Chảo inox nguyên khối Elmich Trimax EL 3846SI size 20 cm,42.0,1849360907136,348000,650000,302000,46,7,nha-cua-doi-song
276018795,Hộp đựng thực phẩm bằng thép không gỉ LocknLock Color Coated STS Container nhiều dung tích,109.0,5347565910820,148000,198000,50000,25,14,nha-cua-doi-song
275493793,Màng PE Bọc Nội Thất Chống Bụi Chống Nước Khi Thi Công,274.0,1317450457039,28500,30000,1500,5,13,nha-cua-doi-song
275451443,Chảo chống dính vân đá Elmich EL-4711OL,38.0,4953008917050,139000,285000,146000,51,8,nha-cua-doi-song
275263278,"Thuốc diệt chuột, Kẹo diệt chuột tiêu diệt cả đàn chuột hàng Thái Lan",274.0,6508478072602,63000,65000,2000,3,16,nha-cua-doi-song
275261014,"Cây lau nhà tự vắt có thùng 2 ngăn Deli, Bộ chổi lau nhà 360 độ kèm 3 bông lau microfiber siêu sạch",55.0,5482797456674,45000,81000,36000,44,8,nha-cua-doi-song
275224128,Combo 200 Túi Lọc Rác Bọc Bồn Rửa Chén Tiện Lợi,114.0,5389036515487,55000,55000,0,0,4,nha-cua-doi-song
275105847,"Bầu Chiết Cành Greenhome, Dụng Cụ Làm Vườn, Tăng Khả Năng Ra Rễ, Chống Úng Cành Chiết, Độ Bền Đến 2 Năm, Dễ Sử Dụng",259.0,2833980586512,2600,4000,1400,35,0,nha-cua-doi-song
274944917,"Thanh treo rèm cửa, treo quần áo bằng inox, không cần khoan tường hay bắt vít, cực kỳ tiện dụng - hàng chính hãng",60.0,3803340685621,90000,90000,0,0,4,nha-cua-doi-song
274435840,Công tắc điều khiển từ xa HT-6220KG 40A 1000m và 3000m,125.0,6927600320098,135000,135000,0,0,16,nha-cua-doi-song
273671453,"Bàn chải vệ sinh góc chết (khe nhà tắm, nhà bếp, khe cửa...) Hàng chính hãng",172.0,6266935361466,40000,40000,0,0,1,nha-cua-doi-song
272913561,"Gel thông tắc sinh học AIKOMI vệ sinh cống, làm sạch đường ống, chậu rửa bát, nhà vệ sinh",369.0,5892747945914,75000,75000,0,0,31,nha-cua-doi-song
272484433,Đồng hồ treo tường kim trôi không ồn minimalist phong cách tối giản trang trí phòng khách Bảo hành 12 tháng Deli,198.0,9520197473152,139000,304200,165200,54,34,nha-cua-doi-song
247316420,Túi 20 Khăn Giấy Nén Hàn Quốc Cao Cấp Loại Dày 2 Lớp 20*20cm - Hàng Chính Hãng,259.0,4638127853402,29000,49000,20000,41,9,nha-cua-doi-song
243047801,Gối tựa lưng văn phòng cao su non A kích thước 34 x 34 cm x 6/10cm,452.0,8895358000896,145000,145000,0,0,63,nha-cua-doi-song
202519681,Đồng Hồ Báo Thức Để Bàn Có Đèn Đêm Deli - Thân Nhựa Kim Thiếc Cao Cấp Kiểu Dáng Tinh Tế - Có Nút Bấm Báo Lại Báo Thức,245.0,8905487050813,149000,322200,173200,54,38,nha-cua-doi-song
195109412,"Bộ nồi Inox dập nguyên khối Elmich Trimax Classic EL-2110OL Size 18, 20, 24, chảo 26cm",209.0,1520237897843,1880000,3550000,1670000,47,39,nha-cua-doi-song
194818369,"Hộp Đựng Trang Sức Mini Cho Nữ, Đựng Vòng Cổ Nhẫn Bông Tai Hộp Đựng Đồ Trang Sức Có Khóa Kéo",174.0,7138930363704,75800,75800,0,0,26,nha-cua-doi-song
190989561,Bình đựng thức ăn giữ nhiệt Inox 316 Elmich EL-8019 dung tích 600ml,164.0,8151258725112,291000,419000,128000,31,30,nha-cua-doi-song
185653590,Chăn hè cotton chần bông LIDACO Home nhiều mẫu lựa chọn khổ rộng 2mx2m3,628.0,3926774620116,155000,250000,95000,38,109,nha-cua-doi-song
180378151,Bình giữ nhiệt LocknLock Metro Drive LHC4277S 650ml - Kèm ống hút và cọ rửa,1565.0,6517783474104,410000,637000,227000,36,301,nha-cua-doi-song
174236741,Găng tay cao su tự nhiên Lock&Lock ETM830 (có móc treo),3000.0,8584642860617,36000,56000,20000,36,150,nha-cua-doi-song
169978766,"Túi Hút Chân Không Đựng Quần Áo, Chăn Ga Gối, Thú Bông Deli - Loại Dày Cao Cấp, Nhiều Hoạ Tiết, Bảo Vệ Quần Áo, Chăn Ga Khỏi Ẩm, Nấm Mốc, Chống Nước Tuyệt Đối",6218.0,5015419822189,16000,28800,12800,44,251,nha-cua-doi-song
162405563,Cọ Bồn Cầu Toilet Nhà Vệ Sinh Cao Cấp Kèm Giá Cắm Chổi  Silicon - Hàng Loại 1 - Chính Hãng MINIIN,198.0,3543110866140,75000,75000,0,0,29,nha-cua-doi-song
140953145,COMBO11 Tấm lót sàn nhà vệ sinh 3T. Vỉ nhựa lót sàn chống trơn Trải Sàn Nhà Tắm/Vệ Sinh/Nhà Bếp,420.0,5226792601133,70000,70000,0,0,50,nha-cua-doi-song
119030223,"Keo Dán Giày, Gỗ, Nhựa, Sứ Siêu Dính Chống Thấm Đa Năng Deli - 7Ml / 20Ml - 7140 / 7149 ",2472.0,6424158958424,9000,18000,9000,50,303,nha-cua-doi-song
118210422,Kê đũa thìa sứ Long Phương AA6216 dụng cụ bàn ăn cao cấp,353.0,3729341575515,17500,17500,0,0,11,nha-cua-doi-song
107713002,"Nam châm siêu trường, siêu mạnh, siêu hút dính dùng để trục vớt đồ vật, nâng vật nặng, treo đồ Dan House - DST15, Hàng chính hãng",367.0,3601509199373,92000,92000,0,0,71,nha-cua-doi-song
106563599,"Bóng đèn Philips LED Bright E27 bảo vệ mắt, ánh sáng vàng, ánh sáng trắng (01 bóng)",1598.0,6200556691392,70000,70000,0,0,154,nha-cua-doi-song
73437740,Kệ Úp Chén Bát Đĩa INOX 304 Kèm Khay Hứng Nước Giá Khô Ráo Trên Bàn Bếp,947.0,1743895710058,559000,700000,141000,20,349,nha-cua-doi-song
69240971,"Ổ khóa cao cấp Toplex, chống cắt tròn, size 40mm",100.0,2078254906872,80000,80000,0,0,20,nha-cua-doi-song
55465365,Pin Max 8 + 4 Viên Energizer E92 BP8+4 AAA - Hàng Chính Hãng Model 2020,1352.0,5441396976176,139000,139000,0,0,197,nha-cua-doi-song
3927949,"Bộ sạc Energizer Charger kèm 4 pin Ener AA 2000mAh, tự ngắt sạc (CHVCM4)",1187.0,5261973592625,460000,460000,0,0,273,nha-cua-doi-song
2119169,Bộ Cây Lau Nhà Lock&Lock Squeeze Flat Mop ETM471,10103.0,4204353763551,668000,1028000,360000,35,1247,nha-cua-doi-song
892141,Pin Max 8 + 4 Viên Energizer E92 BP8+4 AAA,758.0,9969906367307,139000,139000,0,0,103,nha-cua-doi-song
277821947,"Bộ dao, thìa, dĩa Elmich EL0002/0005  - Hàng chính hãng",5.0,6867628675403,249000,249000,0,0,1,nha-cua-doi-song
277410995,"Đệm ngồi đa năng, lót ghế nệm gối NIN House ngồi bệt kiểu dáng Nhật, tựa lưng văn phòng, chống trĩ giảm đau lưng cao cấp",7.0,4049660387912,179000,229000,50000,22,1,nha-cua-doi-song
276155089,Đệm Lót Ngồi Ghế Gỗ OFFICE CHILL Nệm Lót Ngồi Ghế Văn Phòng Dưới Sàn Nhà Chất Liệu Cao Su Non,28.0,8089218628621,220000,220000,0,0,3,nha-cua-doi-song
275967918,Rổ Úp Bát Việt Nhật Kèm Khay Hứng Nước 3535 ,9.0,1055544484132,109000,135000,26000,19,3,nha-cua-doi-song
275569536,"Bao Ngón Tay Cao Su Tăng Độ Bám, Kháng Khuẩn, Dùng Được Cảm Ứng",34.0,3519962866877,21000,21000,0,0,0,nha-cua-doi-song
275427593,Đồng Hồ Pomodoro Hẹn Giờ 60 Phút Kim Loại Nhiều Kiểu Dáng,77.0,3760780660760,114000,120000,6000,5,8,nha-cua-doi-song
275256191,Hộp cơm giữ nhiệt inox 304 Elmich dung tích 1.6L EL8344 - Hàng Chính Hãng,15.0,8385589105143,768000,1590000,822000,52,3,nha-cua-doi-song
275219406,"CỌ TOILET CAO CẤP, CỌ CONG 2 MẶT, CHỔI CỌ BỒN CẦU THƯƠNG HIỆU VIỆT NHẬT - Hàng chính hãng",38.0,9086854509232,39000,39000,0,0,2,nha-cua-doi-song
274848186,"Vỏ Áo Bọc Nệm Thun Lạnh Khóa Kéo 2 Đầu, Áo Nệm Topper, Gấp 3 Cariva Đủ Kích Thước",17.0,3887577207872,160000,160000,0,0,0,nha-cua-doi-song
274067035,Ổ cắm điện Philips CHP2452WB- 3m,210.0,2809742031916,264000,299000,35000,12,15,nha-cua-doi-song
273787401,"Nước tắm tượng phật, lau bàn thờ tinh dầu quế Peace Mass 250ml phong thủy (Thuộc nhóm Sản phẩm Lành tính / Hữu cơ/ Sinh học)",70.0,8423213011166,36000,36000,0,0,0,nha-cua-doi-song
273672038,Ly nhựa 2 lớp Bubble Tea Cold Cup LocknLock HAP529 - Kèm ống hút - Dung tích 720ml,177.0,9761747066140,140000,217000,77000,35,5,nha-cua-doi-song
263239689,Pin kiềm AA Philips LR6P4B/97 vỉ 4 viên,317.0,9635453623460,38000,48000,10000,21,14,nha-cua-doi-song
262362970,Ca giữ nhiệt Flat Table Mug LocknLock LHC4320 - Dung tích 730ml - Tay cầm thoải mái - Miệng ca rộng - Nắp trong suốt,1172.0,2681401040591,393000,567000,174000,31,165,nha-cua-doi-song
217695866,"Bóng đèn LED Bulb MPE LBD E27 - Tiết kiệm điện, Tiêu chuẩn Châu Âu, Thương hiệu Việt Nam - Hàng Chính Hãng",267.0,2444985173945,23000,38000,15000,39,14,nha-cua-doi-song
194131937,Kệ Gỗ Trang Trí Treo Tường Không Cần Khoan Kích Thước 30/40/50cm Thương Hiệu SIB Decor KT02,6.0,1647452248908,98000,119000,21000,18,0,nha-cua-doi-song
191136118,"Bóng Đèn Led Bulb, Led Edison Đui E27 Các Loại - Hàng Chính Hãng NAVIVU",890.0,1925255091916,14250,15000,750,5,53,nha-cua-doi-song
189491905,"Nhang Sen Thuần Khiết Liên Tâm 20.5cm 160 cây - Ít khói, dịu nhẹ, 100% Đài sen thiên nhiên",1768.0,8065384886699,70000,70000,0,0,226,nha-cua-doi-song
189459840,Chiếu điều hòa sợi mây tre đan tổng hợp lót vải không dệt cao cấp hàng xuất khẩu 2 mặt giá rẻ 1m2 1m6 1m8 D Danido,43.0,6643561872523,193000,196000,3000,2,8,nha-cua-doi-song
186862075,"Nắp Ngăn Mùi Thoát Sàn ECODEALS - Chặn Mùi Hôi Cống, Chống côn trùng, Chống trào ngược - MẪU MỚI CẢI TIẾN, ĐỦ KÍCH CỠ",898.0,8600700427795,23000,23000,0,0,69,nha-cua-doi-song
184591044,"Đèn Pixar, Đèn Bàn Chống Cận Thị, Đèn Đọc Sách LED, Đèn Làm Việc Bảo Vệ Mắt - Hàng Chính Hãng",213.0,3841793162308,249000,249000,0,0,24,nha-cua-doi-song
176309303,Bộ 6 hộp thực phẩm chữ nhật Inochi-Hokkaido,48.0,4484699171288,135000,339000,204000,60,4,nha-cua-doi-song
176059637,"Hộp Pin AAA 1,5V Panasonic R03NT/2S - Hàng chính hãng",68.0,6483478544443,55000,55000,0,0,14,nha-cua-doi-song
152446878,Cây mai xanh thái lan - Cây cảnh sân vườn trồng cổng rào ban công,171.0,5578328246184,45000,70000,25000,36,22,nha-cua-doi-song
142264591,Combo 10 chiếc Gác đũa Thần Tài bằng ốc biển liền khối nhập khẩu từ New Zealand và Úc (CTH747) Nổi ánh xà cừ rất đẹp - mang lại bữa cơm ngon và tài lộc cho gia chủ ,3.0,8128610908647,229000,229000,0,0,1,nha-cua-doi-song
126865171,"Vỏ gối ôm lụa cao cấp A 35 x 100 cm - mát mẻ, mềm mịn, không kích ứng da",278.0,7553919111177,150000,150000,0,0,49,nha-cua-doi-song
101858930,"Áo Mưa Khoá Kéo, Áo Mưa Măng Tô Vải Dù Cao Cấp, Hàng Việt Nam, Khổ To Rộng, Chống Thấm Hiệu Quả, Phù Hợp Nam Và Nữ, Có Túi Đựng, Có Lựa Chọn Màu Sắc",198.0,8588118741652,140000,140000,0,0,53,nha-cua-doi-song
88928025,Ổ Cắm Điện Đa Năng Kèm Cổng USB Có Công Tắc Tải 2500W Nắp Chống Giật Chống Cháy Chất Lượng Cao Deli - Dây 2M/3M/5M - ET401 411,357.0,9706934799242,119000,214200,95200,44,55,nha-cua-doi-song
73314056,Lọ xay tiêu cầm tay nắp viền inox 304 lọ thủy tinh Hobby Home Decor XT mẫu thon cao và mẫu thấp tùy chọn,930.0,9413656609144,69000,69000,0,0,208,nha-cua-doi-song
59358608,Combo 2 Ron Thanh Nẹp Xốp Chèn Chắn Cửa Chống Bụi Côn Trùng Dài 95cm Legaxi,1046.0,3851118057885,40000,40000,0,0,179,nha-cua-doi-song
57999394,Bộ Ga Gối Cotton Đũi Tici LIDACO Cao Cấp - Xanh Mint,1843.0,9466863791713,154000,229000,75000,33,456,nha-cua-doi-song
30008695,Vĩ 5 viên pin Maxell dòng cao cấp CR2032,61.0,7729336424252,17900,17900,0,0,10,nha-cua-doi-song
26334551,Mền dù cao cấp  - mỏng nhẹ - thoáng mát - Cho giấc ngủ dễ chịu [chăn ga gối đệm],2563.0,4708457970117,180000,180000,0,0,548,nha-cua-doi-song
15605817,Bộ Dao Nhà Bếp 5 Món Cookplus Lock&Lock CKK101S5BLK,5469.0,5765413945038,199000,309000,110000,36,567,nha-cua-doi-song
7957749,Cuộn cáp cho giàn phơi thông minh (2 sợi x 7m),180.0,1874571634617,60000,60000,0,0,12,nha-cua-doi-song
3341035,Thuốc kích thích ra rễ N3M,2055.0,9386561920638,139000,139000,0,0,159,nha-cua-doi-song
2395003,Khăn lau đa năng cao cấp 3M xanh dương 36cm,1345.0,8108676843258,55000,55000,0,0,78,nha-cua-doi-song
2119173,Cây Lau Nhà Dạng Xịt Nước Lock&Lock ETM472,6879.0,3784672643501,413000,642000,229000,36,1098,nha-cua-doi-song
781987,Gối Memory Foam 50D Lock & Lock HLW114 (61 x 34 x 10 cm),8698.0,3938351368883,541000,833000,292000,35,874,nha-cua-doi-song
696349,Ổ Cắm Điện 4 Lỗ 3 Chấu 3m Philips SPN1248WB/74 (2500W),2.0,3998683130749,241000,259000,18000,7,0,nha-cua-doi-song
277306388,"Bộ 4 chân đế chống rung cho máy giặt, tủ lạnh - Chân đỡ đa năng máy giặt, tủ lạnh",11.0,3460032533123,38500,38500,0,0,0,nha-cua-doi-song
276964772,CHẢO Inox Impact Sunhouse ECO IN20-24-26M5 - Đáy từ công nghệ mới Impact Bonding - Dùng được trên mọi loại bếp,11.0,1351047502605,163000,249000,86000,35,2,nha-cua-doi-song
276616101,Gói 4 Miếng Chữ Nhật Cước cọ rửa Scotch Brite 3M 7447 Mạnh hơn inox (10x15cm) ,684.0,8187084526853,9000,9000,0,0,42,nha-cua-doi-song
276285618,Hộp 6 Lõi lọc BRITA MAXTRA PRO (900L),19.0,3611741435090,1189000,2039000,850000,42,5,nha-cua-doi-song
276158720,Ga chống thấm họa tiết LIDACO đủ size nệm (màu ngẫu nhiên),17.0,2835908240162,58000,90000,32000,36,0,nha-cua-doi-song
275568737,KitchenAid - Tô gốm có nắp tre màu đen - 15cm (1L),8.0,2887689363711,367500,490000,122500,25,0,nha-cua-doi-song
275219457,"Ghế đẩu gấp gọn Hokori nhựa Việt Nhật - Ghế Đẩu,Ghế Xếp Lùn, Ghế Đẩu Gập Gọn Dễ Dàng Mang Theo Du Lịch - Hàng Việt Nam",32.0,9930858167727,49000,98000,49000,50,2,nha-cua-doi-song
275059823,Combo 100 Túi lọc trà/ túi vải không dệt có dây rút size  5 x 7 cm - Hàng chính hãng,41.0,5429786598206,29000,29000,0,0,3,nha-cua-doi-song
274764844,Đồng hồ báo thức điện tử thông minh để bàn mini DH89 - Shop Gold,41.0,3684843422063,105000,105000,0,0,2,nha-cua-doi-song
274067031,Ổ cắm điện Philips CHP1130WB - 3m,226.0,7663748875236,93000,105000,12000,11,21,nha-cua-doi-song
273901995,"Ổ Cắm Điện Loại Chuyển Đổi Đa Năng - Phích Cắm Tiêu Chuẩn US, EURO, UK, AUST - Có 2 Cổng USB (Dual USB) - Phù Hợp Cho Những Chuyến Công Tác Và Du Lịch Nước Ngoài- Chính Hãng",144.0,2039622678973,159460,236000,76540,32,11,nha-cua-doi-song
272639442,Hộp bảo quản thủy tinh LocknLock BLANC - Hộp vuông,553.0,7196474520891,67000,104000,37000,36,45,nha-cua-doi-song
272484839,"Nhiệt ẩm kế, nhiệt kế phòng Deli đồng hồ xem giờ có báo thức đo nhiệt độ phòng, độ ẩm phòng ngủ cho bé chính xác",102.0,3528182112619,149000,268200,119200,44,14,nha-cua-doi-song
272047595,Set 10 móc treo quần áo chống trượt xoay 360 đa năng ,499.0,1799806385868,85000,105000,20000,19,20,nha-cua-doi-song
271123700,Bình giữ nhiệt LocknLock Daily Macaron LHC3292 - Nắp mở một chạm - Dung tích 480ML,318.0,5338529445136,347000,540000,193000,36,39,nha-cua-doi-song
214497531,"Kệ gia vị,kệ nhà bếp HG FURNITURE",50.0,3091837033219,149000,149000,0,0,11,nha-cua-doi-song
207941719,Bộ cây lau nhà Lock&Lock Mini Spin Mop & 4 bông lau sàn ETM498MITS2 - Màu xanh mint,946.0,8945075131861,662000,1019000,357000,35,130,nha-cua-doi-song
191140221,"Dung Dịch Thủy Canh Greenhome, Lavamix, Phân Bón Cây Thuỷ Sinh, Hoa Sen, An Toàn Cho Cá, Tép Cảnh",196.0,9551037313554,29900,50000,20100,40,21,nha-cua-doi-song
190791221,"Hộp 4 pin sạc AA AAA Beston dung lượng cao, sạc lại nhiều lần - Hàng chính hãng",486.0,6038066488227,60000,60000,0,0,46,nha-cua-doi-song
181988661,Bình Bơm ga cho bật-lửa-hộp-quẹt kèm 5 đầu bơm các loại bật-lửa-gas - Blue Hàn Quốc 150 gram,43.0,1080048830167,90000,90000,0,0,3,nha-cua-doi-song
174489164,Màng bọc thực phẩm Horeca Sunhouse KS-WR30250H (30cm x 250m) - Size L,135.0,3131981401603,114000,173000,59000,34,14,nha-cua-doi-song
154157961,"Màn Dây Không Cửa FUNU Chống Muỗi Cao Cấp, Vải Màn Mềm, Mịn, Mắt Dày Dặn Chống Muỗi Tuyệt Đối - Hàng Chính Hãng",1038.0,7788314006098,137750,145000,7250,5,169,nha-cua-doi-song
152446804,Cây Kim Thanh Mai - cây cảnh bonsai để bàn,68.0,6177273952143,39000,58000,19000,33,23,nha-cua-doi-song
147265095,"Vỉ 2 Viên Pin Đại ( Pin D ) 1,5V DURACELL Siêu Bền - Hàng chính hãng",221.0,4188601961033,155000,155000,0,0,15,nha-cua-doi-song
143363686,"Băng keo chống thấm x2000 Nhật Bản chống thấm dột, dán tường, dán mái tôn, dán ống nước",468.0,3167493645868,152000,160000,8000,5,60,nha-cua-doi-song
121396300,"Dây rút nhựa 10cm ,15cm, 20cm, 25cm, 30cm ( Khoảng 80 sợi/bịch )",1932.0,9916972717714,28000,28000,0,0,201,nha-cua-doi-song
108605078,Pin kiềm Akaline AA Deli - Vỉ 2 viên/ 4 viên - 18500 / 18501,1033.0,9713609923898,20000,36000,16000,44,74,nha-cua-doi-song
107336808,Bộ chăn chần ga giường cotton Tici kẻ LIDACO cao cấp (Nhiều mẫu lựa chọn),472.0,9375890256469,469000,690000,221000,32,133,nha-cua-doi-song
85029571,Set 5 Phích cắm công suất lớn Điện Quang ECO ĐQ EPR HP 2PN ECO (Màu ngẫu nhiên),412.0,9758715391154,46008,60400,14392,24,94,nha-cua-doi-song
79948028,Đèn năng lượng mặt trời mô hình camera chống nước,79.0,9708224461414,72000,108000,36000,33,13,nha-cua-doi-song
74695680,"Hộp đựng cơm văn phòng, Hộp Cơm Cắm Điện 3 Tầng Inox ,Hộp hâm nóng thức ăn YOICE- HÀNG CHÍNH HÃNG",312.0,1763293892767,479000,479000,0,0,87,nha-cua-doi-song
73638934,Chảo chống dính đáy từ Elmich 4703OL size 20cm,2060.0,2949572708793,170000,450000,280000,62,433,nha-cua-doi-song
54122078,Pin AAAA Energizer E96 BP2,1192.0,2818757436182,75000,75000,0,0,178,nha-cua-doi-song
43896673,"Keo chà ron gạch cao cấp, keo dán mạch gạch siêu bám dính chống thấm nước dung tích 280ml - màu trắng",112.0,9552644423482,75000,95000,20000,21,9,nha-cua-doi-song
36015001,Lõi lọc nước 11 inch loại kết nối chữ I - lõi đúc,63.0,9414981993700,145000,160000,15000,9,14,nha-cua-doi-song
22081865,TÚI ÁO BÌNH GIỮ NHIỆT TIỆN LỢI,1356.0,9668027232968,38000,40000,2000,5,265,nha-cua-doi-song
20680352,Combo 5 bẫy diệt chuột thông minh,379.0,1428673336056,85000,85000,0,0,53,nha-cua-doi-song
6137123,"Phân Bón Npk 20-20-15 đa năng 3 màu  (1Kg)- bón cây, rau, cây ăn trái, hoa kiểng - bón gốc dễ sử dụng, kích thích ra lá, ra hoa, đậu trái",1426.0,1648986280048,55000,55000,0,0,165,nha-cua-doi-song
2432307,Decal dán tường đoàn tàu sở thú ZOOYOO AM7123,679.0,3855720890304,39000,70000,31000,44,33,nha-cua-doi-song
1657931,Vợt Muỗi Sunhouse SHE-E200 - Vàng,268.0,2083613875744,92000,92000,0,0,59,nha-cua-doi-song
276379807,"Đèn Học Kẹp Bàn Chống Cận Cho Học Sinh PaKaSa , Đèn Cảm Ứng Kẹp Bàn Xoay 360 Độ - Hàng chính hãng",32.0,5570248237741,111860,174000,62140,36,4,nha-cua-doi-song
276016000,"Pin sạc 4.2V 18650 đầu lồi,dung lượng 6800mAh dùng cho Sạc Dự Phòng, Đèn Pin, Micro Karaoke, Quạt Mini, Đồ Chơi, Cell Laptop, Đèn Pin, Mic, Đèn Laze và các thiết bị điện tử khác - Hàng chính hãng",23.0,7154030165416,38000,45000,7000,16,1,nha-cua-doi-song
275986366,"Hộp Quẹt Đồng Hồ, Bật Lửa Đồng Hồ tích hợp độc lạ sang trọng, Mạ Vàng 2 in 1 ",26.0,1236193097221,130000,130000,0,0,1,nha-cua-doi-song
275426511,Nhiệt Kế Đo Nhiệt Độ Sữa và Đồ Ăn Cho Bé - Hàng chính hãng,27.0,3902841630467,59000,59000,0,0,5,nha-cua-doi-song
275405659,"Miếng ngăn rác và giữ nước bồn rửa chén, lavabo, bồn rửa mặt PaKaSa (giao màu ngẫu nhiên)",29.0,1306391893425,9900,18000,8100,45,1,nha-cua-doi-song
275263106,"Ga Chống Thấm Bảo Vệ Đệm, Ga Chống Thấm Tuyệt Đối, Giao Màu Ngẫu Nhiên",35.0,6402894933098,77000,77000,0,0,0,nha-cua-doi-song
275008181,Nhang Không Tăm Trầm Hương Đặc Biệt 3 Lành 20cm 30-150gr Tự Nhiên 100% Ít Khói 7-12 Năm Trầm Thờ Cúng Thư Giãn Xông Nhà Tẩy Uế Yoga Thiền Định,9.0,4230754625229,148940,236412,87472,37,0,nha-cua-doi-song
274912542,Dây Thun Ràng Buộc Hàng Co Dãn Cao Cấp Chắc Chắn dài 3m Có 2 Móc PaKaSa - Hàng Chính Hãng ,18.0,8349167797008,39000,78000,39000,50,0,nha-cua-doi-song
274558570,"(Ngang 45-75cm) Tủ Nhựa Gấp Gọn Size Lớn, Tủ Đựng Quần Áo Đa Năng Lắp Ghép, Để Đồ Tiện Dụng, Nhựa PP, Có Bánh Xe",25.0,1889335977591,650000,1063000,413000,39,3,nha-cua-doi-song
273660990,Bình đựng thức ăn giữ nhiệt inox 304 Elmich EL8310 dung tích 1.2L - Hàng Chính Hãng,22.0,1099083301039,500000,850000,350000,41,4,nha-cua-doi-song
273546668,"Nhang cây trầm hương đốt xông nhà tẩy uế HÀ XÁ đồ thờ cúng phong thủy, xua đuổi vận xui, thu hút nguồn năng lượng tích cực, thanh lọc không khí, an toàn cho sức khỏe",75.0,6240991062174,99000,198000,99000,50,45,nha-cua-doi-song
273400802,"Bộ Bình Trà Tử Sa Mini Có Túi Đựng Đi Du Lịch Tiện Lợi Thích Hợp 2 - 4 Người Dùng Gồm 1 Ấm Trà, 4 Tách, 1 Bình Đựng Trà",55.0,6243584568303,135000,195000,60000,31,7,nha-cua-doi-song
271978704,"Miếng Nam Châm Siêu Hút Dán Tủ Lạnh, Bảng Đen Kèm Keo 2 Mặt",261.0,3832433027353,6650,7000,350,5,4,nha-cua-doi-song
253176290,Bình pha cà phê Cold Brew Hario 650ml FIC-70,236.0,9588759581653,645000,750000,105000,14,47,nha-cua-doi-song
252053150,"Đèn Bắt Muỗi Rạng Đông Công Suất 5W Không Mùi, Không Tiếng Ồn",33.0,4535457009161,299000,299000,0,0,2,nha-cua-doi-song
215891498,"Keo Acrylic B7000 / T7000 Dán Kính Điện Thoại, Dán Giày, Dán Nhựa, Kim Loại, Gỗ, Đá, Thủy Tinh, Da",367.0,8114777751474,27075,28500,1425,5,52,nha-cua-doi-song
205920877,"Bộ Nam Châm Dán Cửa Giúp Giữ Cửa Tủ Chắc Chắn, Không Cần Khoan Vít",1057.0,5834491688482,15000,15000,0,0,47,nha-cua-doi-song
203457589,"Kèn Melodion Swan 32 Phím, Tặng Kèm Túi Đựng - Hàng Nhập Khẩu",45.0,7144225403384,169000,169000,0,0,7,nha-cua-doi-song
199945017,"Bọc Nệm,Aó Nệm Topper 2 Mặt Có Khóa Khéo Vải Cotton Tici Thoáng Mát Kích Thước 1m/1m2/1m4/1m6/1m8 x 2m dày 5-9cm.",102.0,5285779272439,155000,250000,95000,38,20,nha-cua-doi-song
199572344,Ghế Gác Chân Văn Phòng Công Thái Học Ergonomic Footrest KUNBE Điều Chỉnh 6 Mức Chiều Cao Massage Chân Bản Cao Cấp,143.0,3983768322538,286000,286000,0,0,12,nha-cua-doi-song
193213443,"Phích Đựng Nước Nóng Rạng Đông, Có Cần Gạt 2,5 lít/ 2 lít/ 1 lít",20.0,6792154904670,217400,217400,0,0,3,nha-cua-doi-song
191140204,"Phân bò Lavamix, bao 3dm3, đã qua xử lý, không mùi hôi, hữu cơ tiện lợi ",154.0,8410369132844,17900,32220,14320,44,7,nha-cua-doi-song
189885572,"Lưới Chống Muỗi Vải Mỏng, Rèm Chống Côn Trùng Tự Lắp",102.0,2489354448724,19000,20000,1000,5,8,nha-cua-doi-song
186142362,Ô Dù Chống Nắng Che Mưa Cản UV Tự Động Đóng Mở Khung 12 Xương,744.0,8528513543872,171000,180000,9000,5,118,nha-cua-doi-song
184689674,"Khăn giấy nén rửa mặt dạng viên kẹo hàn quốc, khăn nén ướt dạng viên HBH",293.0,4614913644119,1500,1500,0,0,13,nha-cua-doi-song
177679445,"Chuông Cửa Không Dây Thông Minh Besti YBT01 (1 Nút Bấm, 1 Chuông ), Chống Nước, Khoảng Cách Sử Dụng Hiệu Quả 300M, 60 Loại Nhạc Chuông, 4 Mức Điều Chỉnh Âm Lượng - Hàng Chính Hãng",185.0,2982473268971,200000,200000,0,0,36,nha-cua-doi-song
176309253,Túi rác tiện dụng Inochi -Soji 50L x 19 túi (Size L) Hương Lavender có quai,55.0,6147269211412,26000,39000,13000,33,4,nha-cua-doi-song
164158123,Vỉ 2 Viên Pin Duracell CR2032 / CR2025 / CR2016 Lithium 3V - Hàng chính hãng,457.0,2671399673477,79000,79000,0,0,56,nha-cua-doi-song
119111659,"Bể bơi cho bé- Bể bơi gia đình - Bể bơi các loại, Bể bơi Phao Cho bé - Bể bơi Bằng Phao Trẻ em Kích Thước Lớn",107.0,4631393864640,182000,209000,27000,13,7,nha-cua-doi-song
118898224,Trung Nguyên Legend - Phin nhôm hoa văn màu đen Vĩ Nhân - có hộp giấy (giao mẫu ngẫu nhiên),915.0,4791154451286,79000,79000,0,0,111,nha-cua-doi-song
96470903,"Sáp đậu nành (Soy wax) cao cấp dùng làm nến thơm, tealight, tặng mẫu thử tinh dầu Kobi",15.0,6460592183760,78000,78000,0,0,4,nha-cua-doi-song
85908084,Nhang Sạch Phòng Máy Lạnh - Ít khói - Hương trầm dịu nhẹ - Chân tăm mộc - Nhang Xanh - 300g - 20cm,811.0,9145154133102,120000,120000,0,0,79,nha-cua-doi-song
74986804,"Túi đựng hộp cơm cao cấp. Túi giữ nhiệt đa năng nhiều lớp. Túi đựng đồ ăn trưa. Túi chống toả nhiệt, dày dặn, phong cách Hàn Quốc thời trang, hiện đại KORESTAB8001",569.0,4134890756078,125000,125000,0,0,175,nha-cua-doi-song
62469165,Ga Chống Thấm Cotton LIDACO Cao Cấp,914.0,9592935431123,136000,250000,114000,46,179,nha-cua-doi-song
37929600,Đèn bắt muỗi Đại Sinh D6 tặng kèm 1 bóng thay thế,707.0,4070511882507,676200,676200,0,0,149,nha-cua-doi-song
28079716,Hộp đựng xà phòng dầu gội sữa tắm Xinda ZYQ138 White,340.0,5608349928051,135000,135000,0,0,18,nha-cua-doi-song
19920919,Bật Lửa Mồi Lửa Bếp Gas Bếp Cồn An Toàn (Màu Sắc Ngẫu Nhiên),139.0,7226090211031,29000,29000,0,0,1,nha-cua-doi-song
14605513,Nắp Kính Cường Lực Fivestar Nồi Và Chảo,1368.0,6467906155960,100000,100000,0,0,224,nha-cua-doi-song
13729970,"Ruột Gối Khách Sạn 5 Sao DADA - Gòn  Microfiber Polyester 
- Êm Ái, Mềm Mại, Dễ Chịu",527.0,8677424997593,290000,290000,0,0,113,nha-cua-doi-song
2127549,Bình Đựng Dầu Với Nắp Mở Tự Động Lock&Lock CKO101BLK (550ml),18865.0,5961235979774,166000,258000,92000,36,1676,nha-cua-doi-song
277263939,"Rèm Cuộn Che Nắng Cách Nhiệt Tự Động Thu Gọn Kèm Móc Hút Dùng Cho Cửa Sổ, Cửa Kính Ôtô - Giao Màu Ngẫu Nhiên",9.0,7197905313414,65000,65000,0,0,1,nha-cua-doi-song
276652837,"Cây lăn bụi giường 24cm, cây lăn bụi cán dài kèm lõi lăn bụi, hút bụi giường nệm, dính lông mèo, quần áo sàn thảm.",30.0,8773844581653,35000,35000,0,0,5,nha-cua-doi-song
276314483,Giá Đỡ Vòi Hoa Sen Dán Tường Đế Góc Nghiêng 120º Móc Treo Vòi Xịt Nhà Tắm Siêu Dính Hamart,39.0,1195617857234,49000,90000,41000,46,5,nha-cua-doi-song
276274801,"Hộp đựng xà phòng, khay xà phòng tiện lợi phong cách Nhật Bản , Nhựa Việt Nhật - Hàng Việt Nam",11.0,5657008765877,29000,58000,29000,50,1,nha-cua-doi-song
275929238,Bình nước thủy tinh Elmich EL-8350T052 dung tích 520ml,21.0,1998581789670,264000,310000,46000,15,2,nha-cua-doi-song
275925720,"Chuông Cửa Không Dây Không Dùng Pin, Chống Nước Thông Minh, Chuông Bấm Vĩnh Cửu Báo Động Người Già, 38 Loại Nhạc - Hàng Chính Hãng Besti",13.0,7914190761761,180000,180000,0,0,1,nha-cua-doi-song
275524596,"Thau, Chậu Nhựa Gấp Gọn Đa Năng Dùng Trong Bệnh Viện , Trường Học , Công Sở - Hàng chính hãng (Giao màu ngẫu nhiên)",16.0,1350410942239,59000,59000,0,0,1,nha-cua-doi-song
275496608,"Móc Dán Tường Siêu Dính Chịu Lực Inox 304, Móc Dính Tường Treo Đồ Quần Áo Đồ Dùng Đa Năng Tiện Ích",52.0,3527470990486,2000,3000,1000,33,0,nha-cua-doi-song
275422569,"Kệ Sách Gỗ Đẹp Để Bàn FIVO FB26 Cao Cấp Màu Gỗ Và Walnut, Có Hộc, Tiết Kiệm Diện Tích, Bo Góc Thẩm Mĩ",5.0,6560512545724,104000,104000,0,0,3,nha-cua-doi-song
275224132,Bộ 5 Tấm Xốp Dán Tường 3D Giả Gạch Màu 70cmx77cm,68.0,1408441819372,65000,65000,0,0,3,nha-cua-doi-song
275072447,"Chân, giá đỡ đàn guitar chắc chắn VInes",39.0,6885310931765,150000,150000,0,0,4,nha-cua-doi-song
273714788,"Thanh Dán Silicon Chặn Nước Tràn Cho Phòng Tắm, Nhà Vệ Sinh",60.0,1772283451395,40565,42700,2135,5,1,nha-cua-doi-song
273554998,Trung Nguyên Legend - Phin nhôm hoa văn Trung Nguyên - Màu nâu,53.0,6900646642132,99000,99000,0,0,3,nha-cua-doi-song
270660646,Bình giữ nhiệt Daily Essential LocknLock LHC4325- kèm ống hút và cọ vệ sinh - 870ml -,251.0,2746919664681,407000,633000,226000,36,17,nha-cua-doi-song
247385766,"Đệm Lót Lưng Ghế Văn Phòng Deli - Thiết Kế 3D Lưới Thoáng, Chống Mỏi Lưng, Đau Xương Cụt, Thoát Vị Đĩa Đệm, Dành Cho Người Bị Trĩ - VS750 / VS751",9.0,8913589004725,169000,304200,135200,44,1,nha-cua-doi-song
247305229,"Cọ Rửa Cán Gỗ Cỡ Lớn Rửa Bình Sữa, Bình Nước, Ly Tách",150.0,3977813420529,15000,15000,0,0,12,nha-cua-doi-song
206314531,"Đèn Học Để Bàn 2 Thanh 3 Chế Độ Sáng , Ánh Sáng Trắng Hoặc Vàng Tùy Chọn Giúp Bảo Vệ Mắt - Chính hãng  ",54.0,2204808159105,161840,240000,78160,33,2,nha-cua-doi-song
196563202,Bát Ăn Amori Sản Xuất Theo Tiêu Chuẩn Xuất Nhật Chất Liệu Nhựa Nguyên Sinh Đảm Bảo An Toàn Tuyệt Đối Cho Người Sử Dụng- Chính Hãng inochi ( Tặng kèm khăn lau pakasa),49.0,4654359405433,25000,38800,13800,36,5,nha-cua-doi-song
195656054,"Hạt Giống Bầu Lai Greenhome, Gói 1gr, Dễ Trồng Quanh Năm, Nảy Mầm Cao, Thu Hoạch Nhanh, Năng Suất Cao T09",35.0,8227068015702,9900,16000,6100,38,1,nha-cua-doi-song
193733810,"[MyJae x Toyal] Giấy Nến 2 Mặt Lót Nồi Chiên, Nướng Bánh, Giấy Lót Chống Dính 30cm x 30cm (50 Tờ/Hộp)",49.0,2484556967627,269000,269000,0,0,5,nha-cua-doi-song
191918105,Bộ Bàn Chải Vệ Sinh Các Khe LocknLock ETM415 - 2 cái/bộ,549.0,2998456365011,25000,39000,14000,36,44,nha-cua-doi-song
190553620,Khăn Vải Đa Năng Tẩy Trang Lau Mặt Dùng Khô/Dùng Ướt,410.0,1320482508795,66500,70000,3500,5,25,nha-cua-doi-song
189208326,"Thảm nhà tắm, nhà bếp siêu thấm nước, chống trơn trượt tối giản, hiện đại NAVIVU",1053.0,6461901702576,94050,99000,4950,5,89,nha-cua-doi-song
183029245,Mền lông cừu Caro cao cấp A kích thước 1m8 x 2m,267.0,7407368536121,195000,195000,0,0,59,nha-cua-doi-song
173820044,Trầu Bà Đế Vương Xanh - cây cảnh để bàn + tặng phân bón cho cây,43.0,5124219670714,45000,70000,25000,36,9,nha-cua-doi-song
169650796,"Màn chụp, mùng chụp đỉnh vuông Không chân viền cao cấp Một Cửa - Hàng chính hãng",426.0,6274397297396,285000,300000,15000,5,66,nha-cua-doi-song
155253236,HỘP PIN MAXELL 40 VIÊN  AAA TEM BẠC - HÀNG CHÍNH HÃNG,78.0,1893567486329,52700,52700,0,0,2,nha-cua-doi-song
130978265,"Ổ cắm Xoay 90° Điện Quang ĐQ ESK RT 6GW (6 lỗ, màu xanh lá trắng)",1085.0,6899674495281,66971,103300,36329,35,82,nha-cua-doi-song
127031393,Ca nước giữ nhiệt LocknLock Metro Mug LHC4219 475ml,4587.0,9115457631995,358000,557000,199000,36,784,nha-cua-doi-song
102050886,Bàn để ủi quần áo Nakagami tư thế ngồi có giá đỡ chất lượng Công nghệ Nhật Bản - Màu ngẫu nhiên - Hàng chính hãng,220.0,1749680442502,155000,155000,0,0,39,nha-cua-doi-song
75356087,Túi Đựng Hộp Cơm Giữ Nhiệt Đa Lớp Cỡ Lớn 34cm*25cm*15cm,857.0,4382460868823,57000,60000,3000,5,170,nha-cua-doi-song
75340681,"Hộp Đựng Đồ Đa Năng TD1 – Túi Vải Đựng Quần Áo Chăn Màn Phong Cách Thụy Điển Sang Trọng, Lịch Sự – Hàng Chính Hãng",5329.0,9492807829235,84000,160000,76000,48,736,nha-cua-doi-song
69929041,"Móc Treo Quần Áo, Móc Phơi Đồ Trẻ Em Inox Kẹp Chống Rơi, Móc Treo Tất, Vớ, Đồ Lót Nhiều Kiểu Dáng",1363.0,5034345959445,47500,50000,2500,5,235,nha-cua-doi-song
68716601,Dao Gọt Hoa Quả Sunhouse KS-KN100PS,1.0,2072553546654,44000,44000,0,0,0,nha-cua-doi-song
56737206,Túi Rác Tự Hủy Có Quai Tiện Dụng SOJI INOCHI Nhật Bản - Màu Đen Dạng Cuộn - Nhiều Size - Đa dạng công năng sử dụng,391.0,9354635833603,19000,20000,1000,5,14,nha-cua-doi-song
50241058,"Kệ sách gỗ để bàn - Tủ,kệ sách mini - Giao màu sắc ngẫu nhiên ",661.0,9214810645318,82000,99000,17000,17,139,nha-cua-doi-song
46207255,Combo 2 túi lưới giặt đồ 2 lớp Polyester dạng lưới mịn giặt đồ chống biến dạng quần áo cho máy giặt dạng hộp khóa kéo phù hợp giặt đồ nhỏ đồ lót,654.0,9489174355047,64600,68000,3400,5,116,nha-cua-doi-song
19638219,"Kéo Nhà Bếp Cắt Gà, Mổ Cá Đa Năng Thép Không Gỉ",175.0,2196864920894,59000,59000,0,0,42,nha-cua-doi-song
6710595,Bộ 10 móc treo dán tường chịu lực 10kg,730.0,2996798484642,5835,5894,59,1,122,nha-cua-doi-song
696457,Ổ Cắm Điện 4 Lỗ 3 Chấu 5m Philips SPN1248WC/74 (2500W),240.0,3990849803306,326000,369000,43000,12,14,nha-cua-doi-song
276232739,Chai Xịt Bọt Làm Sạch Vệ Sinh Bồn Cầu Toilet Dung Tích 500 Ml Tẩy Rửa Mọi Vết Bẩn Hương Chanh Thơm Mát,19.0,9287169750914,29000,32000,3000,9,0,nha-cua-doi-song
275894840,Vòi Lọc Nước Ra Bát Tăng Áp Xoay 360 Có Thể Kéo Dài Chống Bắn Nước Giao Màu Ngẫu Nhiên,74.0,9729142764917,7000,8000,1000,13,4,nha-cua-doi-song
275869696,Ổ cắm đa năng chống giật OC04 4C/10A,36.0,5542282750332,149000,446000,297000,67,2,nha-cua-doi-song
275479540,Kệ kê chậu cây Dài 80-90 cm. Rộng 20-25-30cm. Cao 10-15-20-25-30cm. Hộp thép 2*2cm. 2 nan phụ ( Hàng Chính Hãng ),21.0,2976001412534,220000,220000,0,0,2,nha-cua-doi-song
275428359,"Bộ Ga Thun Lạnh 4 Món Ga Thun Hàn Quốc Đủ Kích Thước Ga Nệm 1m2, 1m6, 1m8 Chưa Gồm Chăn",35.0,6275509021432,178000,220000,42000,19,2,nha-cua-doi-song
275428127,Lọ chiết nước hoa du lịch 5ml GROFA ( Giao màu ngẫu nhiên),58.0,6085071107324,29000,29000,0,0,2,nha-cua-doi-song
275349409,Băng Dán Viền Bếp Bồn Chậu Rửa Trong Suốt Keo Siêu Dính Dán Mép Tường Chống Bẩn Dầu Mỡ Nấm Mốc,10.0,5915152253058,33000,65000,32000,49,1,nha-cua-doi-song
275198071,Ngăn kéo gắn bàn HyperWork Steel Drawer HPW DR-01 - Thép không gỉ - Tải trọng 8kg - Hàng Chính Hãng,8.0,5736807582831,429000,429000,0,0,1,nha-cua-doi-song
275073568,"Cây lăn bụi quần áo kiểu mới dành cho nhân viên văn phòng rất tiện lợi,gọn nhẹ dễ sử dụng - Hàng chính hãng ",4.0,6728340215172,39000,39000,0,0,0,nha-cua-doi-song
274974855,"Lưới Lọc Tóc Dán Nắp Cống, Chặn Côn Trùng, Chống Tắc Nghẽn",88.0,4766361531605,16150,17000,850,5,3,nha-cua-doi-song
274414442,"Găng tay cao su rửa bát, lau dọn, vệ sinh Dài Tay Cổ Chun",14.0,1625239703797,29000,29000,0,0,0,nha-cua-doi-song
273902288,Cuộn túi hút chân không đựng thực phẩm 1 mặt nhám ( chiều dài mỗi cuộn 500cm) - Henrysa,66.0,1455692681255,63800,120000,56200,47,9,nha-cua-doi-song
273660960,Dụng cụ đánh trứng tự xoay inox Elmich EL8414 - Hàng Chính Hãng,24.0,3913666502298,62200,95000,32800,35,6,nha-cua-doi-song
272318899,Ổ cắm chuyển đổi 3 chấu sang 2 chấu - Hàng chính hãng,227.0,5985712364484,23750,25000,1250,5,15,nha-cua-doi-song
262512971,Bình ga Blue Hàn Quốc 150 gram cho bật-lửa-hộp-quẹt kèm 5 đầu bơm,3.0,3284089326493,90000,90000,0,0,0,nha-cua-doi-song
260040913,"Phân Gà Greenhome, Aki Sfarm, Bao 1kg, Nhập Khẩu Nhật, Viên Nén, Hữu Cơ Sinh Học Bón Rau Sạch, Cây Ăn Quả, Hoa Hồng",227.0,4995322554994,24900,49800,24900,50,7,nha-cua-doi-song
253390079,Hộp cơm Lock&Lock TOGO bằng nhựa chia ngăn kèm dao muỗng hộp sốt đi kèm HPL817 HPL979,3.0,8256007378377,149000,239000,90000,38,0,nha-cua-doi-song
249829748,Ly Giữ Nhiệt Inox 304 Iced Americano 600ml Kèm Ống Hút,93.0,1320383621069,79000,79000,0,0,14,nha-cua-doi-song
248420700,"Ổ Cắm Điện Đa Năng Có Công Tắc Nguồn 3/4/6 Ổ , 3M/5M Dây Chống Giật Chống Cháy Chất Lượng Cao Deli - Hàng Chính Hãng - ET401 - 406",182.0,8960825234074,99000,214200,115200,54,17,nha-cua-doi-song
204986883,"Hộp Đựng Bông Tẩy Trang, Cột Tóc, Tăm Bông Treo Tường Thông Minh - Hàng Loại 1 - Chính Hãng MINIIN",34.0,5554276211153,69000,69000,0,0,4,nha-cua-doi-song
197157654,"Màng Bọc Thực Phẩm , Đồ Ăn PE Shinsen Đạt Tiêu Chuẩn Tiêu Dùng Nhật Bản Đảm Bảo An Toàn Cho Người Sử Dụng - Chính Hãng inochi ( Tặng kèm khăn lau pakasa)",44.0,3663167254105,79000,157400,78400,50,5,nha-cua-doi-song
193433927,Đèn Bàn Học Led Đọc Sách Làm Việc Học Tập Bảo Vệ Mắt Chống Cận - 2 Trục Đèn Chiếu Sáng - Gấp Gọn Tiện Lợi ,307.0,1515320388174,529000,529000,0,0,92,nha-cua-doi-song
193223161,Đèn bắt muỗi Rạng Đông DBM01 5W - Chính Hãng,38.0,9377537196188,299000,299000,0,0,3,nha-cua-doi-song
191918103,Dụng cụ rửa chai và ly LocknLock ETM143DGRY - Màu xám đen,705.0,7987552670587,53000,83000,30000,36,53,nha-cua-doi-song
191140193,"Đất Trồng Cây Greenhome, Bao 6.5dm3 (3kg), Đầy Đủ Dinh Dưỡng, Tiện Lợi, Dễ Sử Dụng, Chuyên Trồng Rau, Hoa, Kiểng",84.0,7738513705777,19900,36000,16100,45,5,nha-cua-doi-song
181223608,Bộ vòi xịt vệ sinh rửa toilet inox 304 tăng áp Hobby home decor VSR1,522.0,5312192347217,149000,199000,50000,25,64,nha-cua-doi-song
174489160,Găng tay thực phẩm phân hủy sinh học Sunhouse KS-PG290M,222.0,7728578834824,18100,21000,2900,14,27,nha-cua-doi-song
155022095,"Pin SẠC 3V7 18650 hãng DP- Li01 dung lượng 2000mAh dùng cho đèn pin, quạt mini,",75.0,3658899548457,28600,28600,0,0,5,nha-cua-doi-song
152446763,Cây Linh Sam Bonsai - cây cảnh bonsai + tặng phân bón cho cây,161.0,1745704675255,55000,110000,55000,50,30,nha-cua-doi-song
141349418,Cốc ly sứ có nắp Bát Tràng cao cấp - Cốc sứ uống trà - Cốc sứ uống nước đẹp có nắp giá rẻ,189.0,2197318022630,70000,70000,0,0,35,nha-cua-doi-song
138456818,Màng bọc thực phẩm Laspalm chính hãng MBTP00006163 - 30cmx150m,41.0,1402207779538,120000,174900,54900,31,2,nha-cua-doi-song
109090764,1 Mét Ron Chân Cửa Thanh Chắn Chân Cửa Nhôm Kèm Chổi Sẵn Keo Dán 50mm 60mm Ngăn Bụi Côn Trùng Gián Chuột Legaxi,160.0,1711199486883,103000,103000,0,0,9,nha-cua-doi-song
107793784,Bộ ga giường cotton Tici kẻ LIDACO cao cấp (Nhiều mẫu lựa chọn),109.0,6292887933093,156000,249000,93000,37,13,nha-cua-doi-song
74972494,"Hộp Đựng Thực Phẩm Nhựa Nhật Bản GAGI Mã GH01 Bảo Quản Thực Phẩm Dạng Lỏng Và Khô, Đựng Sữa Cho Bé, Dùng Được Cho Lò Vi Sóng Và Tủ Lạnh - Hàng Chính Hãng",1075.0,8135756533686,42000,69000,27000,39,144,nha-cua-doi-song
71206737,Đèn Pin Laser 303 - Hàng Chính Hãng,1641.0,2301703637561,128250,135000,6750,5,271,nha-cua-doi-song
57867024,Bộ Lau Nhà Xoay 360 Độ Sunhouse Ks-Cl350PO,26.0,5400823422204,310000,310000,0,0,1,nha-cua-doi-song
53583472,"Bộ Hộp Cơm Giữ Nhiệt Lock&Lock Easy Carry 2L LHC8039 Có Túi (1 Hộp 720ml, 2 Hộp 420ml Kèm 1 Bộ Muỗng Và Nĩa)",11873.0,4451468802389,1122000,1887000,765000,41,2708,nha-cua-doi-song
45597601,"Ron Dán Che Khe Cửa ,Chân Cửa Chống Gió Lùa , Chống Ồn , Bụi Bẩn, Ngăn Côn Trùng Chính Hãng 3M - Cuộn Dài 5m",1989.0,9231284263541,89000,89000,0,0,335,nha-cua-doi-song
32926026,2 Vỉ Pin Panasonic CR2032 ( CR 2032/1PT x 2 Vỉ ) Lithium 3V Chính Hãng,591.0,1418772143402,100000,100000,0,0,140,nha-cua-doi-song
10768545,Ổ Cắm Điện Quang ĐQ 002A-02 (3 Lỗ) dây 2m,24.0,6571342276216,85000,85000,0,0,6,nha-cua-doi-song
277776275,Điện Thoại Samsung Galaxy A06 - Đã kích hoạt bảo hành điện tử - Hàng Chính Hãng,167.0,4569730869206,1990000,3190000,1200000,38,30,dien-thoai-may-tinh-bang
277617509,Điện thoại Samsung Galaxy A05s - Hàng chính hãng,1099.0,7696247339634,3250000,4490000,1240000,28,5,dien-thoai-may-tinh-bang
275618846,Điện thoại Samsung Galaxy A34 5G (8GB/256GB) - Đã kích hoạt bảo hành điện tử  Hàng chính hãng,2999.0,2577976732413,5490000,6290000,800000,13,79,dien-thoai-may-tinh-bang
273947792,"Điện thoại AI Samsung Galaxy S24 Ultra, Camera 200MP Zoom 100x, S Pen - Hàng Chính Hãng",2076.0,1790024126641,21990000,31090000,9100000,29,19,dien-thoai-may-tinh-bang
276250848,Điện Thoại Samsung Galaxy A06 (4GB/128GB) - Hàng Chính Hãng,107.0,9229325045790,2250000,2390000,140000,6,14,dien-thoai-may-tinh-bang
277619147,Máy tính bảng iPad Gen 11 (A16) WiFi ,49.0,5159274775892,8490000,9990000,1500000,15,5,dien-thoai-may-tinh-bang
277007015,Điện thoại Xiaomi Redmi Note 14 6GB/128GB - Hàng Chính Hãng,1711.0,4591311330923,3790000,4990000,1200000,24,13,dien-thoai-may-tinh-bang
276976267,Tai nghe Bluetooth True Wireless Samsung Galaxy Buds FE R400N - Hàng chính hãng,600.0,4060416641163,1450000,1990000,540000,27,2,dien-thoai-may-tinh-bang
274101262,Máy Tính Bảng Samsung Galaxy Tab A9 Plus Wifi 4GB/64GB - Hàng Chính Hãng,366.0,6477332696485,3750000,5990000,2240000,37,85,dien-thoai-may-tinh-bang
274101255,Máy Tính Bảng Samsung Galaxy Tab A9 Wifi 4GB/64GB - Hàng Chính Hãng,662.0,7027695045511,2490000,3490000,1000000,29,136,dien-thoai-may-tinh-bang
276614493,Điện Thoại Samsung Galaxy A16 LTE (4GB/128GB) - Đã kích hoạt bảo hành điện tử - Hàng Chính Hãng,197.0,8837015340131,3170000,5090000,1920000,38,17,dien-thoai-may-tinh-bang
277465334,Điện Thoại Samsung Galaxy A56 5G - Hàng Chính Hãng,4.0,3136524411129,8990000,9490000,500000,5,1,dien-thoai-may-tinh-bang
276639232,Điện Thoại Samsung A16 5G 8GB/128GB - Hàng Chính Hãng,1.0,9449521560395,5049000,6090000,1041000,17,0,dien-thoai-may-tinh-bang
276559198,Điện thoại POCO C75 (8GB/256GB) - Hàng Chính Hãng,1303.0,5048296012582,2890000,3290000,400000,12,11,dien-thoai-may-tinh-bang
276515327,Điện thoại POCO C75 (6GB/128GB) - Hàng Chính Hãng,3665.0,7774039598529,2490000,3390000,900000,27,24,dien-thoai-may-tinh-bang
276448920,"Máy đọc sách Amazon Kindle Paperwhite 6 (Gen 12th), Mới nguyên Seal - Hàng chính hãng",15.0,1368275822110,4890000,5150000,260000,5,2,dien-thoai-may-tinh-bang
277777809,"Điện thoại Samsung Galaxy A26 5G (8/128GB), Mặt lưng kính, AI-Circle to Search, Camera HDR chụp đêm sáng rõ - Hàng chính hãng",1.0,9577984103187,6590000,6990000,400000,6,1,dien-thoai-may-tinh-bang
277068413,"Điện thoại Samsung Galaxy S25 Ultra, Điện thoại AI, Tìm kiếm thông minh, Video camera đêm Nightography, S Pen đa nhiệm - Hàng Chính Hãng",4.0,4153561492439,28990000,33990000,5000000,15,0,dien-thoai-may-tinh-bang
275307093,Điện Thoại Samsung Galaxy A25 5G (6GB/128GB) - Đã kích hoạt bảo hành điện tử - Hàng Chính Hãng,180.0,1609672686825,5520000,5990000,470000,8,26,dien-thoai-may-tinh-bang
277065642,"Điện thoại Samsung Galaxy S25+, Điện thoại AI, Tìm kiếm thông minh, Video camera đêm Nightography, Chip Snapdragon - Hàng Chính Hãng",1.0,8882299945728,22990000,26990000,4000000,15,1,dien-thoai-may-tinh-bang
277812880,Máy Tính Bảng Galaxy Tab S10 FE Wifi (8GB/128GB) - Hàng Chính Hãng,0.0,6004540384406,10450000,11990000,1540000,13,0,dien-thoai-may-tinh-bang
276411458,"Điện thoại OPPO A79 5G (4GB/128GB) Màn hình 6.7"", Sạc nhanh 33W , Rom tiếng việt - Bản nội địa Nhật - Hàng nhập khẩu",5.0,9153107602584,3199000,3999000,800000,20,1,dien-thoai-may-tinh-bang
276166741,Điện thoại Tecno SPARK GO 1 ( 4GB - 64GB) - Hàng Chính Hãng,55.0,9492121721906,1890000,2490000,600000,24,15,dien-thoai-may-tinh-bang
276162093,Máy đọc sách Boox Go 6 - Hàng chính hãng,24.0,4455362822083,4790000,5390000,600000,11,4,dien-thoai-may-tinh-bang
276110349,Apple iPhone 16,235.0,1869189483085,18990000,22990000,4000000,17,30,dien-thoai-may-tinh-bang
276110276,Apple iPhone 16 Plus,95.0,1108005232466,21990000,25990000,4000000,15,15,dien-thoai-may-tinh-bang
276110023,Apple iPhone 16 Pro,200.0,3053239573653,24990000,28990000,4000000,14,31,dien-thoai-may-tinh-bang
276109904,Apple iPhone 16 Pro Max,771.0,8692128795448,30450000,34990000,4540000,13,115,dien-thoai-may-tinh-bang
274639765,"Điện thoại OPPO A2M 5G 6GB/128GB , Dimensity 6020 , Màn 90Hz , Rom tiếng việt - Hàng chính hãng",13.0,5151458968009,3690000,3690000,0,0,3,dien-thoai-may-tinh-bang
274542808,Điện Thoại Samsung A55 5G 8GB/128GB - Hàng Chính Hãng,9.0,3113814707504,7739000,9990000,2251000,23,0,dien-thoai-may-tinh-bang
274171148,Điện thoại Oppo A38 (4GB/128GB) - Hàng Chính Hãng,4608.0,1748057101215,2990000,3990000,1000000,25,22,dien-thoai-may-tinh-bang
273942001,Điện thoại Xiaomi Redmi Note 13 (6GB/128GB) - Hàng chính hãng,726.0,9188045788921,3390000,4590000,1200000,26,154,dien-thoai-may-tinh-bang
273252926,Điện Thoại Oppo A18 (4GB/128GB) - Hàng Chính Hãng,11681.0,8029011002543,2950000,3990000,1040000,26,45,dien-thoai-may-tinh-bang
271966786,Apple iPhone 15,559.0,3577192583861,18890000,21490000,2600000,12,109,dien-thoai-may-tinh-bang
270975124,Điện Thoại Oppo A58 6GB/128GB - Hàng Chính Hãng ,18549.0,7692669431564,4090000,4990000,900000,18,131,dien-thoai-may-tinh-bang
230155305,Điện thoại Xiaomi Redmi Note 10 JE 5G 4GB/64GB - Màn 90HZ - Chống Nước IP68 - Hàng Nhập Khẩu - Bản quốc tế,162.0,1901131422256,2659000,3990000,1331000,33,62,dien-thoai-may-tinh-bang
226946394,Máy đọc sách New Kindle Kids 11th 2022 Kèm bao da - 16Gb - Hàng nhập khẩu,13.0,1992674110320,3090000,3990000,900000,23,2,dien-thoai-may-tinh-bang
217706932,Combo Máy đọc sách All New Kindle Paperwhite 5 (11th Gen) và Bao da - Hàng nhập khẩu,508.0,8671886696124,3850000,3890000,40000,1,128,dien-thoai-may-tinh-bang
205815576,"Apple iPad 10.9-inch (10th Gen) Wi-Fi, 2022",479.0,7521531234052,8550000,12990000,4440000,34,126,dien-thoai-may-tinh-bang
203661802,Adapter Sạc Anker 313 / 311 Charger Gen 2 30W 1 Cổng Type-C A2639  - Hàng Chính Hãng,613.0,7288090154485,278000,499000,221000,44,4,dien-thoai-may-tinh-bang
201067649,Combo máy đọc sách Kindle Paperwhite 5 (11th gen) tặng kèm bao da ( Cover ) - Hàng nhập khẩu,574.0,6927586640656,3590000,3590000,0,0,116,dien-thoai-may-tinh-bang
197214029,Apple iPhone 14,654.0,1840508024491,12750000,24990000,12240000,49,158,dien-thoai-may-tinh-bang
184059211,Apple iPhone 13,7959.0,3643515408223,11590000,25990000,14400000,55,2047,dien-thoai-may-tinh-bang
183330021,"Apple iPad 10.2-inch (9th Gen) Wi-Fi, 2021",3626.0,7453477983299,6950000,10990000,4040000,37,1037,dien-thoai-may-tinh-bang
170165701,Điện thoại bàn Ktel 645 hàng chính hãng,65.0,1155942000611,450000,450000,0,0,12,dien-thoai-may-tinh-bang
163914808,Điện thoại bàn Panasonic  KX-TS500MX-hàng chính hãng,967.0,3951612829798,300000,300000,0,0,137,dien-thoai-may-tinh-bang
277466537,Điện Thoại Samsung Galaxy A36 5G - Hàng Chính Hãng,3.0,1329797038676,7490000,7890000,400000,5,0,dien-thoai-may-tinh-bang
277499293,Điện thoại Samsung Galaxy A56 5G (8GB/128GB) - Hàng chính hãng,1.0,3673153546258,8679000,9990000,1311000,13,1,dien-thoai-may-tinh-bang
277360579,Điện Thoại Xiaomi Redmi 13 8GB/128GB - Hàng Chính Hãng,1.0,8482964308721,3279000,4690000,1411000,30,0,dien-thoai-may-tinh-bang
277326226,"Điện thoại Itel it9310 4G, Màn 3 inch , kết nối - WIFI - FB - Youtube - Hàng chính hãng",1.0,9440660330824,645000,645000,0,0,1,dien-thoai-may-tinh-bang
277311630,Điện Thoại Xiaomi Redmi 14C 6GB/128GB - Hàng Chính Hãng,9.0,4530225504340,2979000,3690000,711000,19,0,dien-thoai-may-tinh-bang
277175913,Điện Thoại Xiaomi Redmi Note 14 6GB/128GB - Hàng Chính Hãng,8.0,3315830123037,4094000,4990000,896000,18,5,dien-thoai-may-tinh-bang
277164932,Ốp Lưng Samsung Galaxy S25 Trong Suốt - Hàng chính hãng,3.0,9009073125928,590000,590000,0,0,0,dien-thoai-may-tinh-bang
277039291,Điện Thoại Samsung Galaxy A55 5G - Hàng Chính Hãng,1.0,2039926997391,8790000,8790000,0,0,1,dien-thoai-may-tinh-bang
277014407,"Điện thoại ZTE Blade A34 (4GB/64GB) Màn hình 6.6"", Pin 5000mAh - Hàng chính hãng",4.0,2809297850842,1750000,2190000,440000,20,0,dien-thoai-may-tinh-bang
277005367,Điện Thoại Oppo Reno13 F 5G 12GB/256GB - Hàng Chính Hãng,1.0,5808224082938,10129000,10990000,861000,8,0,dien-thoai-may-tinh-bang
276925932,Điện thoại Samsung Galaxy A16 LTE - Hàng chính hãng,2.0,5130374704780,3699000,5090000,1391000,27,1,dien-thoai-may-tinh-bang
276523733,Máy tính bảng 10.1 inch TEKKIN TI-8020 cpu 4 nhân 2.0ghz ram 6GB 128GB tặng bao da - hàng nhập khẩu,7.0,1722625231913,1750000,1750000,0,0,4,dien-thoai-may-tinh-bang
276369646,Điện thoại Xiaomi Redmi 14C - Hàng chính hãng,1.0,2839559106979,2889000,3290000,401000,12,0,dien-thoai-may-tinh-bang
275621450,Điện Thoại Xiaomi Redmi 13C 4GB/128GB - Hàng Chính Hãng,2.0,6871053576906,2699000,3090000,391000,13,0,dien-thoai-may-tinh-bang
275621214,Điện Thoại Oppo Reno12 F 5G 8GB/256GB - Hàng Chính Hãng,3.0,6415302369859,7479000,9490000,2011000,21,0,dien-thoai-may-tinh-bang
275589387,Điện thoại Nokia 220 4G - Hàng chính hãng,0.0,6134901362734,1299000,1299000,0,0,4,dien-thoai-may-tinh-bang
275510579,Điện thoại OPPO Reno12F 5G (8GB/256GB) - Hàng Chính Hãng,52.0,6679889211688,6990000,9490000,2500000,26,5,dien-thoai-may-tinh-bang
275362333,Điện thoại Samsung Galaxy M15 5G - Hàng chính hãng,3.0,9214377550846,3949000,4690000,741000,16,0,dien-thoai-may-tinh-bang
274638430,"Điện thoại Xiaomi Redmi 13R 5G 6GB/128GB Dimensity 6100+ , Màn 90Hz , Rom quốc tế có sẳn Tiếng việt - Hàng nhập khẩu",24.0,5299031872576,2629000,3590000,961000,27,6,dien-thoai-may-tinh-bang
274544634,"Điện thoại Redmi Note 12R 5G 6/128GB Snapdragon 4 Gen 2, Rom Quốc tế có sẳn Tiếng việt - Hàng nhập khẩu",27.0,4313143055173,3099000,3590000,491000,14,9,dien-thoai-may-tinh-bang
274542883,Điện Thoại Samsung A35 5G 8GB/128GB - Hàng Chính Hãng,11.0,9038724765213,6775000,8290000,1515000,18,1,dien-thoai-may-tinh-bang
274524050,"Điện thoại Masstel izi T2 4G(LTE), Màn hình 2.4 inch, Đèn pin siêu sáng, Loa to - Hàng chính hãng",8.0,9452928257606,499000,559000,60000,11,3,dien-thoai-may-tinh-bang
274415640,Điện Thoại Xiaomi Redmi Note 13 Pro 8GB/128GB - Hàng Chính Hãng,6.0,2758565003586,7290000,7290000,0,0,1,dien-thoai-may-tinh-bang
274191773,"Điện thoại ZTE Libero 5G IV - 4GB/128GB Dimensity 700 , Kháng nước IP67 , Sạc nhanh 22,5W - Mới nguyên seal - Hàng nhập khẩu",11.0,4124844928679,2399000,2990000,591000,20,3,dien-thoai-may-tinh-bang
273668660,Điện Thoại Oppo A18 4GB/64GB - Hàng Chính Hãng,6.0,6108608732345,2539000,3690000,1151000,31,4,dien-thoai-may-tinh-bang
273664463,Điện Thoại Oppo A18 4GB/128GB - Hàng Chính Hãng,10.0,5991700830577,2799000,3990000,1191000,30,2,dien-thoai-may-tinh-bang
273653444,Máy tính bảng Kindle Fire HD 10 2023 13th - Hàng nhập khẩu,1.0,6444530342740,2590000,2590000,0,0,1,dien-thoai-may-tinh-bang
273440662,"Điện thoại Xiaomi Redmi 12 (4GB/128GB) , Helio G88 , Màn 90HZ - Hàng nhập khẩu nhật",11.0,3498866127593,2899000,3599000,700000,19,3,dien-thoai-may-tinh-bang
272348047,Điện Thoại Samsung A05s 4GB/128GB - Hàng Chính Hãng,53.0,3434612499156,3099000,3990000,891000,22,21,dien-thoai-may-tinh-bang
271362153,"Combo Máy đọc sách All New Kindle Paperwhite 5 (11th Gen) và Bao da FOR KIDS (Bản KIDS, Không Quảng Cáo) - Hàng chính hãng",15.0,1176146850399,3850000,4290000,440000,10,1,dien-thoai-may-tinh-bang
271234313,Điện Thoại Nokia 110 4G Pro - Hàng Chính Hãng,12.0,2077602494115,849000,949000,100000,11,4,dien-thoai-may-tinh-bang
270504848,Điện thoại Nokia 110 4G Pro - Hàng chính hãng,6.0,8446533326959,790000,899000,109000,12,1,dien-thoai-may-tinh-bang
217505430,"Máy tính bảng Kindle Fire HD8 2022 (Fire HD 8 12th) - Màn hình 8inch HD, RAM 2GB, CPU Hexa-core 2.0 GHz, CÀI ĐƯỢC CH PLAY- Hàng nhập khẩu",8.0,9371698901528,1890000,1890000,0,0,3,dien-thoai-may-tinh-bang
204237269,Điện Thoại Bàn Panasonic KX-TSC11 - Hàng Chính Hãng,291.0,7051314090435,600000,600000,0,0,49,dien-thoai-may-tinh-bang
181928619,Điện thoại bàn Panasonic KX-TGC210 hàng chính hãng,84.0,6795214532367,1080000,1080000,0,0,15,dien-thoai-may-tinh-bang
181927736,Điện thoại bàn Panasonix KX-TGD312 hàng chính hãng,27.0,5799675453563,1850000,1850000,0,0,6,dien-thoai-may-tinh-bang
181452535,"Điện thoại Itel Magic X Pro 4G ,Kết nối WIFI,Chia sẻ WIFI cho máy khác - Hàng chính hãng",151.0,9308072782108,599000,790000,191000,24,31,dien-thoai-may-tinh-bang
125182567,Máy đọc sách All New Kindle Paperwhite 5 (11th Gen) - Hàng nhập khẩu,1576.0,4604296397887,3850000,4990000,1140000,23,407,dien-thoai-may-tinh-bang
277737629,Điện Thoại Xiaomi Redmi 13 6GB/128GB - Hàng Chính Hãng,1.0,5758973772062,3039000,4290000,1251000,29,0,dien-thoai-may-tinh-bang
277616873,Apple iPad Air M3 11-Inch Wi-Fi +Cellular,0.0,3547635254924,19990000,20990000,1000000,5,0,dien-thoai-may-tinh-bang
277607297,Điện thoại Smartphone Vivo Y19s siêu bền - RAM 4GB ROM 128GB - Màu đen và xanh - 5500mAh - Hàng chính hãng,0.0,1305275968678,3050000,3050000,0,0,0,dien-thoai-may-tinh-bang
277512620,Điện Thoại Samsung A36 5G 8GB/128GB - Hàng Chính Hãng,0.0,8254747076815,6979000,8290000,1311000,16,0,dien-thoai-may-tinh-bang
277512611,Điện Thoại Samsung A56 5G 8GB/128GB - Hàng Chính Hãng,1.0,5183767309218,8419000,9990000,1571000,16,0,dien-thoai-may-tinh-bang
277409699,Apple iPhone 16e,4.0,2851926928911,16490000,16990000,500000,3,0,dien-thoai-may-tinh-bang
277360976,Điện Thoại Xiaomi Redmi 13C 8GB/256GB - Hàng Chính Hãng,0.0,3846418738942,3379000,3990000,611000,15,0,dien-thoai-may-tinh-bang
277356193,Điện thoại Xiaomi Redmi Note 14 Pro+ 5G (8GB/256GB) - Hàng chính hãng,0.0,2878718532286,10990000,10990000,0,0,0,dien-thoai-may-tinh-bang
277184973,Điện Thoại Realme C65s 8GB/256GB - Hàng Chính Hãng,2.0,5784316854676,3825000,5290000,1465000,28,0,dien-thoai-may-tinh-bang
277175955,Điện Thoại Xiaomi Redmi A3 3GB/64GB - Hàng Chính Hãng,2.0,5672461364938,1849000,2490000,641000,26,0,dien-thoai-may-tinh-bang
277174952,Điện Thoại Xiaomi Redmi Note 14 Pro 8GB/256GB - Hàng Chính Hãng,0.0,5938235557018,6459000,7990000,1531000,19,0,dien-thoai-may-tinh-bang
277063012,"Điện thoại Samsung Galaxy S25, Điện thoại AI, Tìm kiếm thông minh, Video camera đêm Nightography, Chip Snapdragon - Hàng Chính Hãng",5.0,5671147042438,19490000,22990000,3500000,15,1,dien-thoai-may-tinh-bang
277030799,"Điện thoại Realme Note 50 , Màn 90HZ (3GB/64GB) Rom quốc tế - Hàng chính hãng",1.0,7617104005155,2099000,2690000,591000,22,0,dien-thoai-may-tinh-bang
277005407,Điện Thoại Oppo Reno13 F 8GB/256GB - Hàng Chính Hãng,0.0,4838509377527,8099000,8990000,891000,10,0,dien-thoai-may-tinh-bang
276944892,Điện Thoại Samsung A06 4GB/64GB - Hàng Chính Hãng,1.0,7171980622198,2339000,3190000,851000,27,1,dien-thoai-may-tinh-bang
276536922,"Điện thoại ZTE Libero Flip (6GB/128GB) Snapdragon 7 Gen 1 Màn Oled ,120Hz , Rom quốc tế - Hàng nhập khẩu",12.0,6703391074991,4899000,5990000,1091000,18,4,dien-thoai-may-tinh-bang
276274790,Điện Thoại Samsung A06 4GB/128GB - Hàng Chính Hãng,8.0,3785717075900,2449000,3490000,1041000,30,1,dien-thoai-may-tinh-bang
276099688,"Xiaomi Redmi Note 12 5G 8GB/128GB ,Màn AMOLED 120Hz , Snapdragon 4 Gen 1 ,Sạc 33W ,Rom tiếng việt - Hàng nhập khẩu",9.0,9889121084899,3349000,3999000,650000,16,3,dien-thoai-may-tinh-bang
274904904,Máy tính bảng Samsung Galaxy Tab A9 Wifi / LTE (4GB/64GB) - Hàng chính hãng,7.0,2155552545751,2539000,3990000,1451000,36,1,dien-thoai-may-tinh-bang
274507025,"Điện thoại Realme V60S (6GB/128GB) 5G , Chíp Dimensity 6300, Rom tiếng việt - Hàng nhập khẩu",23.0,3714019405863,2999000,3990000,991000,25,8,dien-thoai-may-tinh-bang
274099409,Điện Thoại Xiaomi Redmi Note 13 8GB/128GB - Hàng Chính Hãng,5.0,1392882970251,4039000,5290000,1251000,24,1,dien-thoai-may-tinh-bang
273990229,Điện Thoại Xiaomi Redmi Note 13 6GB/128GB - Hàng Chính Hãng,17.0,5271788065407,3699000,4890000,1191000,24,6,dien-thoai-may-tinh-bang
273872197,Máy Tính Bảng Samsung Galaxy Tab A9 Wifi 4GB/64GB - Hàng Chính Hãng,18.0,7682058635833,2559000,3990000,1431000,36,6,dien-thoai-may-tinh-bang
272222033,Máy đọc sách Boox Palma - Hàng Chính Hãng,53.0,1009596276042,7200000,8590000,1390000,16,14,dien-thoai-may-tinh-bang
271967379,Apple iPhone 15 Plus,287.0,6750971196270,18950000,25990000,7040000,27,47,dien-thoai-may-tinh-bang
271128271,Điện Thoại Oppo A58 6GB/128GB - Hàng Chính Hãng,17.0,5675887651728,3789000,4990000,1201000,24,7,dien-thoai-may-tinh-bang
263675862,Điện thoại OPPO A77 4GB+4GB/128GB - Sạc siêu nhanh 33W - Hàng nhập khẩu nhật - Bản quốc tế,9.0,7010304085979,3299000,4990000,1691000,34,4,dien-thoai-may-tinh-bang
262516014,Điện Thoại Samsung Galaxy A34 5G - Hàng Chính Hãng,1.0,3681856640082,7164000,7164000,0,0,1,dien-thoai-may-tinh-bang
252586291,Máy đọc sách All New Kindle Paperwhite 5 (11th Gen) - Hàng chính hãng,519.0,8259108068504,3650000,3650000,0,0,105,dien-thoai-may-tinh-bang
217640502,Máy đọc sách Kindle Scribe - Hàng chính hãng,7.0,8360230896751,13250000,13990000,740000,5,0,dien-thoai-may-tinh-bang
209872337,"Máy đọc sách Kindle 2022 (11th) - All new kindle 2022 11th màn hình 6inch 300PPI gấp 2 lần độ sắc nét, 16GB bộ nhớ trong với cổng kết nối USB-C - Hàng nhập khẩu",2.0,9544010779799,2990000,2990000,0,0,0,dien-thoai-may-tinh-bang
164213695,Điện thoại bàn Panasonic KX-TGB110 hàng chính hãng,71.0,3591297968151,830000,830000,0,0,17,dien-thoai-may-tinh-bang
147969070,"Điện thoại thông minh itel A26  2 Sim 2 Sóng 4G LTE - Màn hình IPS 5.7"" - RAM 2GB + ROM 32 GB - Mở khoá bằng Gương Mặt -  Hàng chính hãng ",7.0,6793153411247,2390000,2390000,0,0,1,dien-thoai-may-tinh-bang
118486668,Máy đọc sách Kobo Elipsa - Hàng nhập khẩu,2.0,1255690953268,12000000,12000000,0,0,1,dien-thoai-may-tinh-bang
23142193,Điện thoại bàn không dây Panasonic KX-TGC313 - Hàng Chính Hãng,6.0,3807251029548,2350000,2350000,0,0,3,dien-thoai-may-tinh-bang
11251770,Điện thoại bàn không dây Panasonic KX-TGD310 - Hàng Chính Hãng,4.0,7631504098021,1430000,1430000,0,0,0,dien-thoai-may-tinh-bang
277738691,Điện Thoại Oppo A58 8GB/128GB - Hàng Chính Hãng,0.0,8504867018397,4039000,5490000,1451000,26,0,dien-thoai-may-tinh-bang
277651890,Điện thoại Samsung Galaxy A06 5G (4GB/128GB) - Hàng chính hãng,0.0,2008319679126,3229000,3990000,761000,19,0,dien-thoai-may-tinh-bang
277484785,Điện thoại Samsung Galaxy S25 Ultra (12GB/256GB) - Hàng chính hãng,0.0,7242433225786,27990000,33990000,6000000,18,0,dien-thoai-may-tinh-bang
277360298,Điện Thoại Realme Note 60x 3GB/64GB - Hàng Chính Hãng,0.0,7356789589247,2179000,2690000,511000,19,0,dien-thoai-may-tinh-bang
277356260,Điện thoại Xiaomi Redmi Note 14 (6GB/128GB) - Hàng chính hãng,0.0,3658945071526,4990000,4990000,0,0,0,dien-thoai-may-tinh-bang
277356031,Điện thoại Xiaomi Redmi A3 - Hàng chính hãng,0.0,5061328031197,2699000,3290000,591000,18,0,dien-thoai-may-tinh-bang
277041303,Điện Thoại Xiaomi 14T 5G 12GB/512GB - Hàng Chính Hãng,0.0,2853162001832,11339000,13990000,2651000,19,0,dien-thoai-may-tinh-bang
277041250,Điện Thoại Xiaomi 14T Pro 5G 12GB/512GB - Hàng Chính Hãng,1.0,9860628491209,14535000,17990000,3455000,19,0,dien-thoai-may-tinh-bang
276944868,Điện Thoại Samsung A16 4GB/128GB - Hàng Chính Hãng,0.0,2234760955939,3535000,5090000,1555000,31,0,dien-thoai-may-tinh-bang
276802409,Điện thoại Samsung Galaxy A16 5G - Hàng chính hãng,0.0,6962137023984,5299000,6090000,791000,13,0,dien-thoai-may-tinh-bang
276745570,Điện thoại Xiaomi Poco C75 - Hàng chính hãng,0.0,5266898792928,2899000,3390000,491000,14,0,dien-thoai-may-tinh-bang
276500230,"Máy đọc sách Kindle Colorsoft Signature Edition 32Gb, Màn hình màu 7 inch - Hàng chính hãng",0.0,1878498067579,9390000,9990000,600000,6,0,dien-thoai-may-tinh-bang
276465090,"Combo Máy đọc sách Amazon Kindle Paperwhite 6 (Gen 12th) Kèm Bao Da, Mới nguyên Seal - Hàng chính hãng ",4.0,9251475608553,4890000,8990000,4100000,46,0,dien-thoai-may-tinh-bang
276410628,"Điện thoại Realme V60 (6GB/128GB) 5G , Chíp Dimensity 6300, Rom tiếng việt - Hàng nhập khẩu",4.0,2176266770804,2999000,3999000,1000000,25,1,dien-thoai-may-tinh-bang
275695395,Điện thoại Samsung Galaxy Z Flip6 (12GB/256GB) - Hàng chính hãng,0.0,8887952962132,20990000,28990000,8000000,28,0,dien-thoai-may-tinh-bang
275588494,Máy tính bảng 10.1 inch TEKKIN TI-8020 cpu 4 nhân 2.0ghz ram 4gb 64gb tặng bao da - hàng nhập khẩu,6.0,9634983157012,1750000,1750000,0,0,1,dien-thoai-may-tinh-bang
275407523,Máy đọc sách Pocketbook Era Color- Hàng chính hãng,6.0,8593720988073,7090000,7500000,410000,5,2,dien-thoai-may-tinh-bang
274638556,BÚT MÁY ĐỌC SÁCH KINDLE SCRIBE - HÀNG CHÍNH HÃNG,2.0,8955620358825,2000000,2000000,0,0,0,dien-thoai-may-tinh-bang
274456687,Điện thoại Samsung Galaxy A55 5G (8GB/128GB) - Hàng chính hãng,3.0,7231239057337,7999000,9990000,1991000,20,1,dien-thoai-may-tinh-bang
274456447,Điện thoại Samsung Galaxy A35 5G (8GB/128GB) - Hàng chính hãng,0.0,1717468942067,6699000,8290000,1591000,19,0,dien-thoai-may-tinh-bang
274392442,Điện thoại Oppo A38 - Hàng chính hãng,0.0,1669746107535,3699000,4990000,1291000,26,0,dien-thoai-may-tinh-bang
274065023,Điện thoại Xiaomi Redmi Note 13 (8GB/128GB) - Hàng chính hãng,1.0,1628259102821,4349000,5290000,941000,18,0,dien-thoai-may-tinh-bang
273610105,Điện Thoại Samsung Galaxy A05 - Hàng Chính Hãng,0.0,2832990576017,2875000,2875000,0,0,0,dien-thoai-may-tinh-bang
273559306,Máy tính bảng Kindle Fire Max 11 inch - 13th - 2023 - Ram 4Gb - Hàng chính hãng,2.0,7948776540125,5290000,5590000,300000,5,0,dien-thoai-may-tinh-bang
273559020,Máy tính bảng Kindle Fire HD10 2023 13th - 32Gb - Hàng chính hãng,9.0,7947353971950,3350000,3990000,640000,16,2,dien-thoai-may-tinh-bang
273438724,"Điện Thoại Samsung A05s 4GB/128GB , Snapdragon 680 , Sạc nhanh 25W - Hàng Chính Hãng",2.0,1205013920101,2990000,3990000,1000000,25,0,dien-thoai-may-tinh-bang
273412211,"Điện thoại Xiaomi Redmi 13C (4+128GB) | 6.74"" 90Hz| Media Tek Helio G85| 5000mAh - Hàng chính hãng",9.0,6228995747765,2799000,3290000,491000,15,0,dien-thoai-may-tinh-bang
273388474,Điện thoại chắc chắn Ulefone Power Armor 18T Ultra (chụp ảnh nhiệt Camera FLIR5G 512GB ROM +24GB RAM)- hàng chính hãng,0.0,4115164048915,15990000,15990000,0,0,0,dien-thoai-may-tinh-bang
273373420,Điện thoại Xiaomi Redmi 13C (4GB/128GB) - Hàng chính hãng - Bảo hành 18 tháng,7.0,7050742350481,2799000,3090000,291000,9,2,dien-thoai-may-tinh-bang
272850971,"Điện thoại Libero 5G III - 4/64GB Dimensity 700 ,Màn OLED ,Kháng nước IP57 - Hàng nhập khẩu nhật ",11.0,1863617947680,2990000,2990000,0,0,4,dien-thoai-may-tinh-bang
272394241,Điện thoại Samsung Galaxy A05s (4Gb/128Gb) - Hàng chính hãng - Đã kích hoạt bảo hành điện tử,1.0,7607552121077,3625000,3625000,0,0,0,dien-thoai-may-tinh-bang
271798615,"Điện thoại thông minh siêu bền Oukitel WP28 (màn hình 6.52‘' ,HD+ ,pin 10600mAh ,Ram 15Gb(8GB+7Gb),Rom 256GB ,Android13, camera 48MP)-hàng chính hãng",8.0,6213116662198,5940000,5940000,0,0,3,dien-thoai-may-tinh-bang
271467653,Điện thoại Realme C51 (4GB/128GB) - Hàng chính hãng ,3.0,2446167505131,2990000,3990000,1000000,25,1,dien-thoai-may-tinh-bang
271235147,Điện thoại Oppo A58 (6GB/128GB) - Hàng chính hãng,0.0,2540743512447,3829000,4990000,1161000,23,0,dien-thoai-may-tinh-bang
263798932,Máy đọc sách Boox Page - Hàng Chính Hãng,54.0,8783986936143,6790000,7990000,1200000,15,11,dien-thoai-may-tinh-bang
248005118,Điện Thoại Samsung Galaxy A34 5G (8GB/128GB) - Hàng Chính Hãng,1.0,9958323284837,7164000,7164000,0,0,1,dien-thoai-may-tinh-bang
247427990,Máy đọc sách Kindle 2022 (11th) Kids Edition kèm bao da chính hãng - Hàng nhập khẩu,13.0,7661452681923,3100000,3100000,0,0,3,dien-thoai-may-tinh-bang
230203067,Điện thoại OPPO A55s 5G 4GB/64GB - Màn 90hz - Chống nước IP68 - Hàng nhập khẩu - Bản quốc tế ,31.0,2026695524996,2799000,3699000,900000,24,14,dien-thoai-may-tinh-bang
217645692,Combo Máy đọc sách All New Kindle Paperwhite 5 (11th Gen) - 16Gb và Bao da - Hàng nhập khẩu,19.0,6487670580863,4050000,4490000,440000,10,5,dien-thoai-may-tinh-bang
193366048,Điện thoại OnePlus 10T 5G - Hàng Chính Hãng,0.0,2244198484504,15990000,15990000,0,0,0,dien-thoai-may-tinh-bang
277751466,[MỚI] Điện thoại vivo V50 Lite (12GB/256GB) - Hàng chính hãng - Bảo hành 12 tháng - 1 Đổi 1 trong tháng đầu tiên,0.0,4496263798188,10990000,10990000,0,0,0,dien-thoai-may-tinh-bang
277553639,"Điện thoại Samsung Galaxy A06 5G (4/128GB), Màn Hình Cực Đại HD+ 6.7”, 5G Kết nối cực nhanh - Hàng chính hãng",0.0,5896455061625,3990000,3990000,0,0,0,dien-thoai-may-tinh-bang
277497325,Điện thoại Samsung Galaxy S25 Ultra (12GB/512GB) - Hàng chính hãng,0.0,8596061327423,31490000,37490000,6000000,16,0,dien-thoai-may-tinh-bang
277490201,Điện thoại Samsung Galaxy A36 5G (8GB/128GB) - Hàng chính hãng,0.0,5532238284079,7399000,8290000,891000,11,0,dien-thoai-may-tinh-bang
277360329,Điện Thoại Realme Note 50 3GB/64GB - Hàng Chính Hãng,0.0,6700330216675,2189000,2490000,301000,12,0,dien-thoai-may-tinh-bang
277356569,Điện thoại Realme Note 60 (4GB/128GB) - Hàng chính hãng,0.0,2795033057678,2709000,3390000,681000,20,0,dien-thoai-may-tinh-bang
277315433,"Điện thoại Xiaomi Redmi Note 9T 4GB/128GB 5G Dimensity 800U 5G, Có NFC , Rom tiếng việt - Hàng nhập khẩu Nhật",0.0,8057321800304,2669000,3900000,1231000,32,0,dien-thoai-may-tinh-bang
277185786,Điện Thoại Realme C65s 8GB/128GB - Hàng Chính Hãng,0.0,7250923993652,3645000,4790000,1145000,24,0,dien-thoai-may-tinh-bang
277164944,Ốp Lưng Samsung Galaxy S25 Plus Trong Suốt - Hàng chính hãng,0.0,1857103218204,590000,590000,0,0,0,dien-thoai-may-tinh-bang
277049062,Điện Thoại Xiaomi Redmi Note 14 Pro+ 5G 8GB/256GB - Hàng Chính Hãng,0.0,4344561367291,9489000,10990000,1501000,14,0,dien-thoai-may-tinh-bang
276529979,Máy đọc sách Kindle Scribe 2024 Kèm bút Premium - Hàng chính hãng,1.0,7428800081158,13290000,15590000,2300000,15,0,dien-thoai-may-tinh-bang
276281988,Điện thoại Samsung Galaxy A06 - Hàng chính hãng,2.0,3707984577804,2599000,3490000,891000,26,1,dien-thoai-may-tinh-bang
276074109,Điện thoại Xiaomi Redmi 13 - Hàng chính hãng,1.0,4815981168946,3379000,4690000,1311000,28,0,dien-thoai-may-tinh-bang
276062770,Điện Thoại Xiaomi Redmi 14C 4GB/128GB - Hàng Chính Hãng,2.0,5271042371517,2679000,3290000,611000,19,0,dien-thoai-may-tinh-bang
275627388,Điện Thoại Oppo A79 5G 8GB/256GB - Hàng Chính Hãng,1.0,1039410643603,6069000,7490000,1421000,19,0,dien-thoai-may-tinh-bang
275386982,Điện Thoại Nokia 220 4G - Hàng Chính Hãng,13.0,7002651042330,1089000,1190000,101000,8,2,dien-thoai-may-tinh-bang
275338696,Máy tính bảng Samsung Galaxy Tab A9+ 5G - Hàng chính hãng,0.0,4462209745642,5990000,7490000,1500000,20,0,dien-thoai-may-tinh-bang
275295006,Máy tính bảng cho trẻ chống sốc 10.1 inch TEKKIN TI-8010 cpu 4 nhân 4gb 64gb - hàng nhập khẩu,5.0,8860825626725,1599000,1599000,0,0,2,dien-thoai-may-tinh-bang
275108186,Điện thoại vivo Y18s (6GB+128GB) - Hàng chính hãng - Bảo hành 1 đổi 1 trong tháng đầu tiên,0.0,6574077983253,4190000,4190000,0,0,0,dien-thoai-may-tinh-bang
274516245,"Điện thoại Masstel Fami 60S 4G(LTE) ,Bàn phím lớn, Khung viền kim loại - Hàng chính hãng",2.0,2886394643668,692000,699000,7000,1,0,dien-thoai-may-tinh-bang
274405521,Điện Thoại Samsung A05 4GB/64GB - Hàng Chính Hãng,31.0,2764410293207,2299000,2990000,691000,23,4,dien-thoai-may-tinh-bang
274378214,"Điện thoại Ulefone Note 17 Pro(Ram 12Gb,Rom 256Gb,Android 13,camera 108MP, MediaTek Helio G99,sạc nhanh 33W,Màn hình AMOLED 6.78 inch,pin 5.050mAh)- hàng chính hãng",0.0,1111857372584,8970000,8970000,0,0,0,dien-thoai-may-tinh-bang
274019962,"Điện thoại Masstel Fami 8 4G(LTE) Gọi HD call , Bàn phím chữ số lớn,Loa to - Hàng chính hãng",11.0,9414723020213,539000,669000,130000,19,2,dien-thoai-may-tinh-bang
273553649,Điện thoại Oppo A18 - Hàng chính hãng,1.0,6210921483673,2909000,3990000,1081000,27,0,dien-thoai-may-tinh-bang
273258825,Điện thoại Samsung Galaxy A05s (4GB/128GB) - Đã kích hoạt bảo hành điện tử - Hàng chính hãng,1.0,9616299554457,3625000,3625000,0,0,0,dien-thoai-may-tinh-bang
272328188,Điện Thoại Samsung A05 4GB/128GB - Hàng Chính Hãng,3.0,5461245831364,3037000,3037000,0,0,0,dien-thoai-may-tinh-bang
272273680,Điện thoại Samsung Galaxy A05s (4GB/128GB) - Hàng chính hãng ,0.0,7151197509141,2990000,3990000,1000000,25,0,dien-thoai-may-tinh-bang
271954384,"Điện thoại OPPO A58 6GB/128GB , Sạc nhanh 33W - Hàng Chính Hãng",2.0,7889951910758,3999000,4990000,991000,20,1,dien-thoai-may-tinh-bang
271730109,"Điện thoại chắc chắn Ulefone Armor X13, (Ram 12GB(6Gb+6Gb),Rom 64GB,chống nước,chống va đập IP68/IP69K, Android 13,CPU MediaTek Helio G36 Octa Core,Màn hình 6,52 inch, Mạng: 4G, NFC,OTG)-hàng chính hãng",7.0,5704199107752,4390000,4390000,0,0,2,dien-thoai-may-tinh-bang
262908601,"Máy tính bảng chắc chắn oukitel RT3 (chống nước,chống va đập,Ram 4Gb,Rom 64 Gb,màn hình 8 inch,pin 5150 mAh)- hÀng chính hãng",1.0,5149165813197,4990000,4990000,0,0,0,dien-thoai-may-tinh-bang
251448280,Samsung Galaxy A34 5G A346E (8+128G) Silver Bạc - Hàng Chính Hãng (chỉ giao HN và một số khu vực),0.0,9745613581547,7164000,7164000,0,0,0,dien-thoai-may-tinh-bang
251407092,Điện Thoại Samsung Galaxy A34 5G (8GB/128GB) ĐKH -  Hàng Chính Hãng,0.0,2083780370205,7164000,7164000,0,0,0,dien-thoai-may-tinh-bang
249178196,Điện thoại Samsung Galaxy A34 5G 8GB/128GB Xanh - Hàng chính hãng,0.0,8349530145579,7164000,7164000,0,0,0,dien-thoai-may-tinh-bang
249143473,Điện thoại Samsung Galaxy A34 5G (8GB/128GB) - Hàng chính hãng - ĐÃ KÍCH HOẠT BẢO HÀNH ĐIỆN TỬ,0.0,3233628661722,7164000,7164000,0,0,0,dien-thoai-may-tinh-bang
248766283,Máy đọc sách New Kindle 11th 2022 (Kids) kèm bao da - Hàng Chính Hãng,0.0,1917685670467,3100000,3100000,0,0,0,dien-thoai-may-tinh-bang
221518066,Máy đọc sách Kindle Oasis 3 10th - Hàng nhập khẩu,1.0,3989665564397,6300000,6300000,0,0,0,dien-thoai-may-tinh-bang
217548686,"Máy đọc sách Kindle Scribe – thế hệ đầu tiên có thể đọc và viết, màn hình 10,2” 300PPI, đèn vàng warmlight, bộ nhớ 16-64GB, đồng bộ dữ liệu qua Microsoft Word - hàng nhập khẩu",4.0,7798540500930,9800000,9800000,0,0,1,dien-thoai-may-tinh-bang
196197701,Điện thoại Samsung Galaxy Z Fold4 5G (12GB/256GB) - Hàng chính hãng,0.0,5331215465766,40990000,40990000,0,0,0,dien-thoai-may-tinh-bang
139632023,"Máy đọc sách Kobo Libra (Libra Colour, Libra 2) - hàng nhập khẩu",209.0,5335316283985,7299000,8600000,1301000,15,56,dien-thoai-may-tinh-bang
91281318,Máy Đọc Sách Likebook P10 - Hàng chính hãng,6.0,1417706155548,9090000,9090000,0,0,2,dien-thoai-may-tinh-bang
277857552,Điện thoại Xiaomi Redmi Note 14 Pro 4G (8GB/256GB) - Hàng chính hãng,0.0,4732691817740,6749000,7990000,1241000,16,0,dien-thoai-may-tinh-bang
277728993,[MỚI] Điện thoại vivo Y04 (6GB+128GB) - Hàng chính hãng - 1 Đổi 1 trong tháng đầu tiên - Bảo hành 12 tháng,0.0,9670238842743,2990000,2990000,0,0,0,dien-thoai-may-tinh-bang
277357126,Điện Thoại Realme Note 50 4GB/128GB - Hàng Chính Hãng,0.0,3285840244245,2469000,2890000,421000,15,0,dien-thoai-may-tinh-bang
277356914,Điện Thoại Realme Note 60 4GB/128GB - Hàng Chính Hãng,0.0,8936603762380,2619000,3390000,771000,23,0,dien-thoai-may-tinh-bang
277185947,Điện Thoại Realme C65s 6GB/128GB - Hàng Chính Hãng,1.0,7910732380675,3135000,4290000,1155000,27,0,dien-thoai-may-tinh-bang
277175972,Điện Thoại Oppo A3x 4GB/64GB - Hàng Chính Hãng,0.0,4876174046034,2979000,3490000,511000,15,0,dien-thoai-may-tinh-bang
277170595,Điện thoại Xiaomi 14T 5G (12GB/256GB) - Hàng chính hãng,0.0,7441901785201,12990000,12990000,0,0,0,dien-thoai-may-tinh-bang
277164948,Ốp Lưng Samsung Galaxy S25 Ultra Trong Suốt - Hàng chính hãng,3.0,3246467584625,590000,590000,0,0,0,dien-thoai-may-tinh-bang
276945332,Điện Thoại Xiaomi POCO C75 6GB/128GB - Hàng Chính Hãng,0.0,1495554426736,2699000,3390000,691000,20,0,dien-thoai-may-tinh-bang
276305472,[MỚI] Điện thoại vivo Y100 (8GB+256GB) - Hàng chính hãng - 1 Đổi 1 trong tháng đầu tiên - Bảo hành 12 tháng,0.0,1439501211951,7690000,7690000,0,0,0,dien-thoai-may-tinh-bang
276046675,Điện Thoại Oppo A3 6GB/128GB - Hàng Chính Hãng,0.0,8930195366205,4079000,4990000,911000,18,0,dien-thoai-may-tinh-bang
275919759,Máy tính bảng 10.1 inch TEKKIN A3 2 SIM 2 sóng nghe gọi cpu 8 nhân ram 12gb 128gb - hàng nhập khẩu,4.0,3561008284374,2599000,2599000,0,0,0,dien-thoai-may-tinh-bang
275913708,Điện thoại Itel it8010 4G - Hàng Chính Hãng,11.0,5862587157601,299000,299000,0,0,2,dien-thoai-may-tinh-bang
275746497,Điện thoại Realme Note 50 (3GB/64GB) - Hàng chính hãng,0.0,3316807704338,2299000,2490000,191000,8,0,dien-thoai-may-tinh-bang
275589968,Điện thoại Nokia 3210 4G - Hàng chính hãng,8.0,3901081293354,1599000,1690000,91000,5,1,dien-thoai-may-tinh-bang
275386649,Điện Thoại Nokia 3210 4G - Hàng Chính Hãng,2.0,5330776819892,1679000,1790000,111000,6,1,dien-thoai-may-tinh-bang
274524033,"Điện thoại người già Masstel Fami 12S 4G(LTE) , Bàn phím chữ số to, Loa lớn , Máy viền thép chắc chắn - Hàng chính hãng",1.0,2213120533733,650000,650000,0,0,0,dien-thoai-may-tinh-bang
274516951,"Điện thoại Masstel izi 16 4G(LTE) , Bàn phím nổi, FM không dây - Hàng chính hãng",10.0,4325086861682,459000,569000,110000,19,1,dien-thoai-may-tinh-bang
274375122,Điện thoại Xiaomi Redmi Note 13 Pro 4G (8GB/128GB) - Hàng chính hãng,0.0,1728231541744,5999000,7290000,1291000,18,0,dien-thoai-may-tinh-bang
274364026,Máy tính bảng học tập thông minh Nexta Edutab Pro cho trẻ 9-12 tuổi - giải pháp học tập - quản lý thời gian cho trẻ - bảo hảnh 12 tháng,0.0,5201193783658,3990000,3990000,0,0,0,dien-thoai-may-tinh-bang
274257669,Điện thoại Masstel Izi S1 4G (LTE) Gọi HD Call - Hàng chính hãng,1.0,4483255580669,459000,569000,110000,19,1,dien-thoai-may-tinh-bang
273636845,Điện Thoại Samsung Galaxy A05 (4GB/64GB) - Hàng Chính Hãng,2.0,8050596986979,2875000,2875000,0,0,0,dien-thoai-may-tinh-bang
273430216,"Điện thoại Ulefone Armor 13 (pin khủng,pin 13.200mAh, Ram 8Gb,Rom 256Gb,chống sốc,chống va đập,nội soi,tia hồng ngoại,tia lade,loa to,học online)- hàng chính hãng",0.0,8591348994256,8980000,8980000,0,0,0,dien-thoai-may-tinh-bang
273360836,"Điện thoại Ulefone armor 22(chống nước,chống va đập, Màn hình giọt nước 6,58 inch, RAM:8GB,Rom 128GB/256GB,Thẻ nhớ microSD Lên đến 512GB, Camera kép 64MP + 64MP)- hàng chính hãng",2.0,1149314297665,5990000,5990000,0,0,0,dien-thoai-may-tinh-bang
273227290,"Combo Máy đọc sách Kindle Scribe kèm bút – thế hệ đầu tiên có thể đọc và viết, màn hình 10,2” 300PPI, đèn vàng warmlight, bộ nhớ 16-64GB, đồng bộ dữ liệu qua Microsoft Word - hàng nhập khẩu",0.0,8004137347297,9500000,9500000,0,0,0,dien-thoai-may-tinh-bang
273186334,Điện thoại Samsung Galaxy A05s 4GB/128GB- Hàng Chính hãng,0.0,1786317839145,3625000,3625000,0,0,0,dien-thoai-may-tinh-bang
271530789,Combo Máy đọc sách All New Kindle Paperwhite 6 - Hàng chính hãng,13.0,9122177442751,4990000,4990000,0,0,3,dien-thoai-may-tinh-bang
271234577,Điện Thoại Nokia 105 4G Pro - Hàng Chính Hãng,14.0,4130306384991,749000,849000,100000,12,1,dien-thoai-may-tinh-bang
270794184,"Máy đọc sách Kobo Clara (Clara Colour, Clara BW, Clara 2e, Clara HD) - 6inch, 16gb - Hàng Chính Hãng",47.0,4699121670755,4299000,5500000,1201000,22,20,dien-thoai-may-tinh-bang
249782771,Máy tính bảng Xelex Gama Tab X8 EDU (Hàng chính hãng),0.0,9173713949009,2890000,2890000,0,0,0,dien-thoai-may-tinh-bang
249169833,Điện thoại Samsung Galaxy A34 5G 8GB/128GB Đen - Hàng chính hãng,0.0,9420216321004,7164000,7164000,0,0,0,dien-thoai-may-tinh-bang
248762051,Điện Thoại Samsung A34 5G 8GB/128GB - Hàng Chính Hãng,1.0,4989180093114,7164000,7164000,0,0,0,dien-thoai-may-tinh-bang
226552005,Điện thoại bàn Panasonic KX-TSC11 hàng chính hãng,161.0,5087831143894,600000,600000,0,0,23,dien-thoai-may-tinh-bang
217276360,"Điện thoại Mobell F209 4G ,Loa to, Phím lớn - Hàng chính hãng",7.0,7421693315981,649000,769000,120000,16,3,dien-thoai-may-tinh-bang
209927605,Combo máy đọc sách Kindle 2022 (11th) tặng kèm bao da ( Cover ) - Hàng nhập khẩu,136.0,2345506770936,3090000,3090000,0,0,28,dien-thoai-may-tinh-bang
181927774,Điện thoại bàn Panasonic KX-TGD310 hàng chính hãng,25.0,6559785733866,1190000,1190000,0,0,8,dien-thoai-may-tinh-bang
173387789,Máy đọc sách All New Kindle Oasis 3 - Hàng nhập khẩu,26.0,3214054442334,6300000,6300000,0,0,4,dien-thoai-may-tinh-bang
118100164,Điện thoại Panasonic KX-TGB110CX -Hàng chính hãng,71.0,9990919849152,815000,815000,0,0,21,dien-thoai-may-tinh-bang
117929342,Điện thoại Panasonic KX-TSC11MX -Hàng chính hãng,44.0,6989032463968,639000,639000,0,0,5,dien-thoai-may-tinh-bang
43924153,Máy đọc sách Kindle Oasis 3 (2019) - Amazon - Hàng nhập khẩu,0.0,1096925155627,6690000,6690000,0,0,0,dien-thoai-may-tinh-bang
277775803,Điện thoại Realme Note 60 (4GB/64GB) - Hàng chính hãng,0.0,8731431067571,2419000,3090000,671000,22,0,dien-thoai-may-tinh-bang
277360073,Điện Thoại Realme C60 4GB/64GB - Hàng Chính Hãng,0.0,8903043784570,2489000,2790000,301000,11,0,dien-thoai-may-tinh-bang
277348490,Điện Thoại Realme C61 4GB/128GB - Hàng Chính Hãng,0.0,3902621163278,2779000,3590000,811000,23,0,dien-thoai-may-tinh-bang
277315392,"Điện thoại Xiaomi Redmi A3 (4GB/128GB) Màn hình 6.71inch,pin 5000mAh - Hàng chính hãng",0.0,5706322028470,2290000,2690000,400000,15,0,dien-thoai-may-tinh-bang
276314708,Điện thoại Masstel izi 16 4G - Hàng chính hãng,0.0,9520215797424,519000,629000,110000,17,0,dien-thoai-may-tinh-bang
276104423,Điện thoại Masstel izi S1 4G - Hàng chính hãng,2.0,3964859500738,519000,629000,110000,17,0,dien-thoai-may-tinh-bang
274869053,"Điện thoại cố định Panasonic KX-TS 500 (Đen, trắng, xanh, đỏ, xám) -Hàng Chính Hãng",14.0,9779649671848,326900,326900,0,0,0,dien-thoai-may-tinh-bang
274560616,"Máy tính bảng học tập thông minh Nexta Edutab Kid cho bé từ 5-8 tuổi - quản lý thời gian cho trẻ - 1 đổi 1 trong vòng 30 ngày, bảo hành 12 tháng",6.0,7387921232466,2990000,2990000,0,0,3,dien-thoai-may-tinh-bang
274361820,"Máy Tính Bảng Học Tập Smart Study 1, Hàng Chính Hãng, Cho Trẻ Từ 5-12 Tuổi, 64GB, Tích Hợp Chương Trình Học Tập Toàn Diện",0.0,6721203344981,7900000,7900000,0,0,0,dien-thoai-may-tinh-bang
273438458,Điện thoại Samsung Galaxy A05 (4GB/128GB)- Helio G85 - Sạc nhanh 25W - Hàng chính hãng,0.0,3020549962309,3037000,3037000,0,0,0,dien-thoai-may-tinh-bang
273185467,Điện thoại Samsung A05 4GB - hàng chính hãng,0.0,5127435436206,3037000,3037000,0,0,0,dien-thoai-may-tinh-bang
272392928,Điện thoại Samsung Galaxy A05 (4GB/128GB) - Hàng chính hãng - ĐÃ KÍCH HOẠT BẢO HÀNH ĐIỆN TỬ,0.0,3724062273847,3037000,3037000,0,0,0,dien-thoai-may-tinh-bang
252884859,Tay con điện thoại bàn Panasonic TGDA30-hàng chính hãng,1.0,4144563980985,990000,990000,0,0,1,dien-thoai-may-tinh-bang
248929458,Điện thoại Samsung Galaxy A34 5G (8GB/128GB) - Hàng chính hãng,0.0,1049694298922,7164000,7164000,0,0,0,dien-thoai-may-tinh-bang
247730209,Điện thoại Samsung Galaxy A34 5G (8GB/128GB) - Hàng chính hãng,3.0,4248112816958,7164000,7164000,0,0,0,dien-thoai-may-tinh-bang
217505504,"Máy tính bảng Kindle Fire HD8 PLUS 2022 (Fire HD 8 12th) - Màn hình 8inch HD, RAM 3GB, CPU Hexa-core 2.0 GHz, CÀI ĐƯỢC CH PLAY- Hàng nhập khẩu",3.0,6842181537864,2490000,2490000,0,0,1,dien-thoai-may-tinh-bang
198868735,Điện thoại IP Grandstream GRP 2601 hàng chính hãng,2.0,2440196291396,880000,880000,0,0,0,dien-thoai-may-tinh-bang
188030974,"Máy tính bảng Oukitel RT1 - hàng chính hãng  (chống nước,chống va đập , pin khủng,pin 10.000mAh,màn hình 10,1 inch,Ram 4Gb,Rom 64Gb,tám nhân,học online)",0.0,6509906931474,6990000,6990000,0,0,0,dien-thoai-may-tinh-bang
181928208,Điện thoại bàn Panasonic KX-TGC310 hàng chính hãng,52.0,9218732089500,1050000,1050000,0,0,7,dien-thoai-may-tinh-bang
181927801,Điện thoại bàn Panasonic KX-TGC212 hàng chính hãng,50.0,5355086404171,1650000,1650000,0,0,13,dien-thoai-may-tinh-bang
178311123,Điện thoại Panasonic KX-TGD310CX - Hàng chính hãng,12.0,3750676744541,1199000,1199000,0,0,1,dien-thoai-may-tinh-bang
173789184,Điện thoại bàn treo tường TC990,51.0,3981361426341,250000,250000,0,0,7,dien-thoai-may-tinh-bang
172537996,"(Hàng chính hãng) Điện thoại bàn hữu tuyến H2P, hiệu Alcatel - Lucent",0.0,9753773128928,2220000,2220000,0,0,0,dien-thoai-may-tinh-bang
170727305,Điện thoại bàn Panasonic KX-TS580 hàng chính hãng,1.0,1631118990384,1059000,1059000,0,0,0,dien-thoai-may-tinh-bang
170727266,Điện thoại bàn Panasonic KX-TS560 hàng chính hãng,52.0,8530250420588,688000,688000,0,0,14,dien-thoai-may-tinh-bang
170165658,Điện thoại bàn Ktel 303 hàng chính hãng,24.0,3359919261431,450000,450000,0,0,5,dien-thoai-may-tinh-bang
118146255,Điện thoại Panasonic KX-TGF320CX -Hàng chính hãng,8.0,5825075730079,2499000,2499000,0,0,0,dien-thoai-may-tinh-bang
118139108,Điện thoại Panasonic KX-TGF310CX -Hàng chính hãng,29.0,9811332894604,2299000,2299000,0,0,5,dien-thoai-may-tinh-bang
118136229,Điện thoại Panasonic KX-TGD312CX -Hàng chính hãng,3.0,6764385221038,1929000,1929000,0,0,1,dien-thoai-may-tinh-bang
118130919,Điện thoại Panasonic KX-TGD310CX -Hàng chính hãng,21.0,1661827612017,1199000,1199000,0,0,6,dien-thoai-may-tinh-bang
118124199,Điện thoại Panasonic KX-TGC313CX -Hàng chính hãng,1.0,8721611995975,2159000,2159000,0,0,0,dien-thoai-may-tinh-bang
118100268,Điện thoại Panasonic KX-TGB112CX -Hàng chính hãng,1.0,4525952187534,1235000,1235000,0,0,0,dien-thoai-may-tinh-bang
117929538,Điện thoại Panasonic KX-TS560MX -Hàng chính hãng,6.0,4799782004097,723000,723000,0,0,0,dien-thoai-may-tinh-bang
117347869,ĐIỆN THOẠI HỘI NGHỊ YEALINK CP960 -HÀNG CHÍNH HÃNG,0.0,2376905437980,15230000,15230000,0,0,0,dien-thoai-may-tinh-bang
94453667,Điện thoại VoIP Yealink SIP-T30,0.0,4756172867236,1050000,1050000,0,0,0,dien-thoai-may-tinh-bang
53380152,Điện Thoại IP Phone Fanvil X1S - Hàng Chính Hãng,0.0,1033646664991,950000,950000,0,0,0,dien-thoai-may-tinh-bang
11802138,Điện thoại bàn Không Dây Lắp Sim Homephone Hp1002c,99.0,6658117286400,1299000,1299000,0,0,12,dien-thoai-may-tinh-bang
11251951,Điện thoại bàn không dây Panasonic KX-TGB110-Hàng Chính Hãng,16.0,4190116240875,850000,850000,0,0,1,dien-thoai-may-tinh-bang
4048581,Điện Thoại Bàn Panasonic KX-TSC11 - Hàng Chính Hãng,65.0,5786167456410,729000,759000,30000,4,9,dien-thoai-may-tinh-bang
4048043,Điện Thoại Bàn Panasonic KX-TS500 - Hàng Chính Hãng,315.0,5352269298151,359000,379000,20000,5,25,dien-thoai-may-tinh-bang
277930460,Điện thoại Vivo Y19s (4GB/128GB) - Hàng Chính Hãng,0.0,9717622099677,3990000,3990000,0,0,0,dien-thoai-may-tinh-bang
277930407,Điện thoại Tecno Spark GO 1 (3GB/64GB) - Hàng Chính Hãng,0.0,9777834138766,2190000,2190000,0,0,0,dien-thoai-may-tinh-bang
277877804,Điện thoại Xiaomi Redmi A5 (3GB/64GB) - Hàng chính hãng,0.0,3624597076827,2549000,2790000,241000,9,0,dien-thoai-may-tinh-bang
277811118,Điện Thoại Xiaomi Redmi Note 14 5G 8GB/256GB - Hàng Chính Hãng,0.0,4306488847618,6339000,7290000,951000,13,0,dien-thoai-may-tinh-bang
277776768,Điện thoại Oppo A3 (8GB/256GB) - Hàng chính hãng,0.0,4928693409634,5729000,6490000,761000,12,0,dien-thoai-may-tinh-bang
277737595,Điện Thoại Samsung A06 5G 4GB/128GB - Hàng Chính Hãng,2.0,9442022017695,3059000,4490000,1431000,32,0,dien-thoai-may-tinh-bang
277707642,Điện thoại Samsung Galaxy A26 5G (8GB/128GB) - Hàng chính hãng,0.0,4803172041251,6149000,6990000,841000,12,0,dien-thoai-may-tinh-bang
277704510,Điện Thoại Samsung A26 5G 8GB/128GB - Hàng Chính Hãng,0.0,5101949170441,6129000,6990000,861000,12,0,dien-thoai-may-tinh-bang
277614315,Apple iPad Air M3 13-Inch Wi-Fi,0.0,6853474541706,21990000,22490000,500000,2,0,dien-thoai-may-tinh-bang
277614251,Apple iPad Air M3 11-Inch Wi-Fi ,4.0,2804301844850,16450000,16990000,540000,3,0,dien-thoai-may-tinh-bang
277437876,Điện Thoại Samsung M15 5G 4GB/128GB - Hàng Chính Hãng,0.0,1378664018314,3679000,4390000,711000,16,0,dien-thoai-may-tinh-bang
277311651,Điện Thoại Realme C65 6GB/128GB - Hàng Chính Hãng,0.0,2046481952349,3299000,3690000,391000,11,0,dien-thoai-may-tinh-bang
277185998,Điện Thoại Realme C65 8GB/128GB - Hàng Chính Hãng,0.0,5670230236162,3599000,4290000,691000,16,0,dien-thoai-may-tinh-bang
277004858,Điện thoại Xiaomi Redmi 14C (4GB/128GB) - Hàng chính hãng,0.0,9806090534646,2799000,3290000,491000,15,0,dien-thoai-may-tinh-bang
276539826,"Máy đọc sách New Kindle 2024, 16Gb Mới nguyên Seal - Hàng chính hãng",6.0,5275035218388,3690000,3690000,0,0,0,dien-thoai-may-tinh-bang
275206906,Điện thoại Tecno Camon 30 (8GB/256GB) - Hàng Chính Hãng,26.0,8439226697088,5350000,6490000,1140000,18,11,dien-thoai-may-tinh-bang
275044287,"Máy tính bảng siêu bền Ulefone Armor Pad 3 Pro (Pin 33280 mAh,chống nước,chống va đập,RAM 16GB (8+8), ROM 256GB ,camera 50MP,Màn hình 10.36 Inch)-hàng chính hãng",0.0,6819841250426,9990000,9990000,0,0,0,dien-thoai-may-tinh-bang
274065746,"Điện thoại siêu bền Oukitel WP33 Pro 5G (Loa to 136 dB (5W) ,Pin 22000mAh,màn hình 6,6 inch FHD+,Ram 24GB(8+16),Rom 256GB, Camera 64MP,sạc nhanh 33W)- hàng chính hãng",1.0,3169573257325,8990000,8990000,0,0,1,dien-thoai-may-tinh-bang
273398391,"Điện thoại Ulefone Armor 18T (Ram 12Gb,Rom 256Gb,Camera 108MP,camera nhiệt FLIR,Pin 9600 mAh,5G,chống nước,chống va đập)-hàng chính hãng",0.0,5388654888994,14990000,14990000,0,0,0,dien-thoai-may-tinh-bang
273389282,"Điện Thoại ulefone armor 21(Loa to 122dB Speaker ,pin 9600mAh,sạc nhanh 33W,Màn hình 6.58 in,camera chính 64MP,ban đêm 24MP,Ram 16Gb(8+8),rom 256Gb, điều khiển từ xa đa năng)- hàng chính hãng",0.0,7259121627245,6990000,6990000,0,0,0,dien-thoai-may-tinh-bang
273258830,Điện thoại Samsung Galaxy A05 (4GB/128GB) - Đã kích hoạt bảo hành điện tử - Hàng chính hãng,4.0,9898804509755,3037000,3037000,0,0,1,dien-thoai-may-tinh-bang
272270730,Điện thoại Samsung Galaxy A05 (4GB/128GB) - Hàng chính hãng ,0.0,7044203760003,3037000,3037000,0,0,0,dien-thoai-may-tinh-bang
272241346,Điện thoại Samsung Galaxy A05s (4GB/128GB) - Hàng chính hãng,0.0,7438421065151,3625000,3625000,0,0,0,dien-thoai-may-tinh-bang
271727840,"Điện thoại chắc chắn Ulefone Armor X12 Pro(Ram 4GB, Rom 64GB, chống nước,chống va đập,IP68/IP69K, Android 13,CPU  MediaTek Helio G36 Octa Core,MÀN HÌNH  5,45 inch, Mạng: 4G, NFC)-hàng chính hãng",0.0,7717145384795,3590000,3590000,0,0,0,dien-thoai-may-tinh-bang
270791102,Điện Thoại Sony XPERIA 10 MARK V  | ROM 128GB - Pin khủng 5000mAh - Hệ điều hành Snapdragon 695 - Màn hình OLED | HÀNG CHÍNH HÃNG,0.0,5231740624225,12490000,12490000,0,0,0,dien-thoai-may-tinh-bang
254125720,"Điện thoại oukitel WP22 (Loa to,Chống nước ,chống sốc IP68/IP69K,Ram 13Gb(8GB+5Gb mở rộng),Rom 256Gb,Màn hình 6.58 FHD,tầm nhìn ban đêm,Pin 10.000mAh)- Hàng chính hãng",4.0,4115203421324,5990000,5990000,0,0,0,dien-thoai-may-tinh-bang
252884932,Tay con điện thoại bàn Panasonic TGCA30- Hàng chính hãng-Chỉ xài được khi đã có máy mẹ,6.0,8218561199857,750000,750000,0,0,1,dien-thoai-may-tinh-bang
249168949,Điện thoại Samsung Galaxy A34 5G 8GB/128GB Bạc - Hàng chính hãng,0.0,4419043364630,7164000,7164000,0,0,0,dien-thoai-may-tinh-bang
230157205,Điện thoại Xiaomi Redmi Note 10T 5G 4GB/64GB - Màn 90HZ - Chống Nước IP68 - Hàng Nhập Khẩu - Bản quốc tế,78.0,3684006639942,2699000,4190000,1491000,36,30,dien-thoai-may-tinh-bang
198868573,Điện thoại IP Grandstream GRP 2601P hàng chính hãng,2.0,6603338992478,1050000,1050000,0,0,0,dien-thoai-may-tinh-bang
181928189,Điện thoại bàn Panasonic KX-TGC312 hàng chính hãng,31.0,6462111366048,1550000,1550000,0,0,6,dien-thoai-may-tinh-bang
181927718,Điện thoại bàn Panasonic KX-TGC313 hàng chính hãng,15.0,8652193937082,2150000,2150000,0,0,3,dien-thoai-may-tinh-bang
179547641,Máy đọc sách Kindle Paperwhite 5 (8GB) - Hàng chính hãng,2.0,3301286969393,3850000,3950000,100000,3,0,dien-thoai-may-tinh-bang
164318603,Điện thoại bàn Panasonic KX-TGF310 hàng chính hãng,35.0,7892537752849,2350000,2350000,0,0,6,dien-thoai-may-tinh-bang
164318521,Điện thoại bàn Panasonic KX-TGF320 hàng chính hãng,24.0,3057890145380,2500000,2500000,0,0,6,dien-thoai-may-tinh-bang
118103703,Điện thoại Panasonic KX-TGC312CX -Hàng chính hãng,0.0,6244886744687,1669000,1669000,0,0,0,dien-thoai-may-tinh-bang
102620086,Điện thoại VoIP Yealink SIP-T30 - Hàng Chính Hãng,0.0,4597720295577,1200000,1200000,0,0,0,dien-thoai-may-tinh-bang
29440849,điện thoại  IP622C - hàng chính hãng,0.0,8139855205437,1650000,1650000,0,0,0,dien-thoai-may-tinh-bang
25949745,Máy Đọc Sách Kindle Oasis (10th Gen) 2019- 8GB - Hàng Chính Hãng,1.0,4301494001686,6700000,6700000,0,0,0,dien-thoai-may-tinh-bang
11251711,Điện thoại bàn không dây Panasonic KX-TGD312 - Hàng Chính Hãng,11.0,6819082887706,2150000,2150000,0,0,2,dien-thoai-may-tinh-bang
277721774,Điện thoại Samsung Galaxy A26 5G (6GB/128GB) - Hàng chính hãng,0.0,7201681780646,6149000,6590000,441000,7,0,dien-thoai-may-tinh-bang
277646748,Điện thoại Samsung Galaxy A06 5G (4GB/64GB) - Hàng chính hãng,0.0,1238287657714,2999000,3490000,491000,14,0,dien-thoai-may-tinh-bang
277574339,Củ Sạc Samsung Không Kèm Cáp 25W - Hàng Chính Hãng,69.0,2018136311966,160000,190000,30000,16,5,dien-thoai-may-tinh-bang
277034393,Điện Thoại Samsung Galaxy A05s - Hàng Chính Hãng,0.0,9447137949159,3625000,3625000,0,0,0,dien-thoai-may-tinh-bang
273029857,Điện Thoại Samsung Galaxy A05s (4GB/128GB) - Hàng Chính Hãng ,3.0,9473653790591,3625000,3625000,0,0,1,dien-thoai-may-tinh-bang
272238679,Điện thoại Samsung Galaxy A05 (4GB/128GB) - Hàng chính hãng,1.0,3016056579526,3037000,3037000,0,0,0,dien-thoai-may-tinh-bang
271329051,"Máy tính bảng Kindle Fire MAX 11, màn hình 11 inch, RAM 4GB, CPU Octa-core 2.2Ghz, bộ nhớ 64/128GB - Hàng chính hãng",4.0,5332952571919,4900000,4900000,0,0,2,dien-thoai-may-tinh-bang
214756058,Máy đọc sách New Kindle 11th 2022 (16GB) - Hàng chính hãng,3.0,5239906950205,3200000,3200000,0,0,0,dien-thoai-may-tinh-bang
118102328,Điện thoại Panasonic KX-TGC310CX -Hàng chính hãng,8.0,1068789388299,1139000,1139000,0,0,1,dien-thoai-may-tinh-bang
21317020,Điện thoại bàn không dây Panasonic KX-TGF310 - Hàng Chính Hãng,7.0,1707684225376,2590000,2590000,0,0,0,dien-thoai-may-tinh-bang
277400995,Bộ 2 lon Sữa bột NAN OPTIPRO PLUS 4 Nestle Bé 2-6 tuổi 1500g/lon Giúp tiêu hóa tốt,398.0,8161167895891,1610000,2028000,418000,21,10,do-choi-me-be
274391518,Sữa bột Nestlé NAN OPTIPRO PLUS 4 800g/lon với 5HMO Giúp tiêu hóa tốt + Tăng cường đề kháng  - Bé 2-6 tuổi,1224.0,9850169183808,432000,577000,145000,25,8,do-choi-me-be
277400812,Bộ 2 lon Sữa bột Nestlé NAN OPTIPRO PLUS 4 800g/lon với 5HMO Giúp tiêu hóa tốt,380.0,5903251248896,950000,1154000,204000,18,3,do-choi-me-be
277400837,Bộ 3 lon Sữa bột NAN OPTIPRO PLUS 4 Nestle Bé 2-6 tuổi 800g/lon Giúp tiêu hóa tốt,866.0,8810661494003,1370000,1731000,361000,21,3,do-choi-me-be
59143355,Combo Tiết Kiệm: 6 Gói Khăn Ướt Bobby Care Bổ Sung 80 Miếng/Gói,8426.0,9389478281236,159000,235200,76200,32,1401,do-choi-me-be
277588125,Bộ 3 lon Sữa bột NAN OPTIPRO PLUS 4 Nestle Bé 2-6 tuổi 1500g/lon Giúp tiêu hóa tốt,248.0,6930667900052,3042000,3042000,0,0,2,do-choi-me-be
277484051,[Gift] Máy đuổi muỗi,44.0,3328401427609,200000,200000,0,0,0,do-choi-me-be
277398494,Sữa bột Nestlé NAN OPTIPRO PLUS 4 1500g/lon với 5HMO Giúp tiêu hóa tốt,324.0,6613179132143,732000,1014000,282000,28,7,do-choi-me-be
969623,Sữa Bột Friso mum Gold Hương Cam (900g),3529.0,8283028082094,466000,616000,150000,24,227,do-choi-me-be
276488279,[Tặng Gấu bông cánh cụt] Combo 2 lon Sữa bột NAN OPTIPRO PLUS 4 Nestle Bé 2-6 tuổi 800g/lon Giúp tiêu hóa tốt,29.0,4424726630234,1154000,1154000,0,0,1,do-choi-me-be
277543204,Tã/bỉm quần Molfix Thiên nhiên Jumbo XL (12kg - 17kg) - Gói 32+6 miếng,0.0,4017531494693,179000,224900,45900,20,0,do-choi-me-be
276488291,[Lẩu nướng 2 in 1] Bộ 3 lon Sữa bột NAN OPTIPRO PLUS 4 Nestle Bé 2-6 tuổi 1500g/lon Giúp tiêu hóa tốt,205.0,3947383457922,2230000,3042000,812000,27,7,do-choi-me-be
277327322,[Gift] Quạt mini cầm tay nan,190.0,8431175086308,200000,200000,0,0,0,do-choi-me-be
276950638,[Gift] Tã quần Huggies Skin Perfect XL Super Jumbo 52+6 miếng với 2 vùng thấm giảm kích ứng da - Mẫu ngẫu nhiên,1666.0,6803410727325,100000,100000,0,0,0,do-choi-me-be
276950510,Thùng 6 lon sữa bột Nestlé NAN INFINIPRO A2 1 cho trẻ từ 0-12 tháng tuổi hộp 800g nhập khẩu nguyên lon từ Thụy Sỹ,0.0,7730129225975,3750000,3750000,0,0,4,do-choi-me-be
276622682,Thùng 6 lon sữa bột Nestlé NAN SUPREMEPRO 1 800g nhập khẩu Đức với 5HMO & đạm Gentle Optipro,418.0,8800237325033,3450000,3450000,0,0,7,do-choi-me-be
276621514,Thùng 6 lon Sản Phẩm Dinh Dưỡng Nestlé NAN OPTIPRO PLUS 1 800g/lon,670.0,2379315681292,3120000,3120000,0,0,15,do-choi-me-be
274756681,Tã dán em bé Siêu khô thoáng gói Jumbo Unidry G6X size M-46 miếng,307.0,4959492205247,159000,197934,38934,20,1,do-choi-me-be
277543161,Tã/bỉm dán sơ sinh Molfix Thiên nhiên Jumbo Newborn (dưới 5kg) - Gói 70 miếng,0.0,9679284106716,180000,196400,16400,8,0,do-choi-me-be
273818338,Tã quần UniDry Siêu khô thoáng gói Jumbo mới size M,64.0,2595969758460,250000,377312,127312,34,1,do-choi-me-be
274756686,Tã dán em bé Siêu khô thoáng gói Super Jumbo Unidry G6X size L-68 miếng,5.0,5537945189820,220000,319581,99581,31,1,do-choi-me-be
274756690,Tã dán em bé Siêu khô thoáng gói Super Jumbo Unidry G6X size M-76 miếng,4.0,6594804328626,220000,319581,99581,31,1,do-choi-me-be
276621506,Thùng 6 lon Sản Phẩm Dinh Dưỡng Nestlé NAN OPTIPRO PLUS 2 800g/lon,627.0,5037950743888,3060000,3060000,0,0,11,do-choi-me-be
276568601,Tã/bỉm quần Huggies Skin Care Mega Jumbo M102+4 miếng với tràm trà dịu da,8800.0,6746246589068,380000,645750,265750,41,8,do-choi-me-be
276109346,Tã quần Huggies Skin Care Mega Jumbo L100+4 miếng với tràm trà dịu da,3.0,9973638890528,382000,382000,0,0,0,do-choi-me-be
275597414,Sữa bột Nestlé NAN SUPREMEPRO 2 800g nhập khẩu Đức với 5HMO & đạm Gentle Optipro ( Dành cho trẻ từ 12 - 24 tháng tuổi),9740.0,6732659372595,575000,575000,0,0,39,do-choi-me-be
275597411,Sữa bột Nestlé NAN SUPREMEPRO 1 800g nhập khẩu Đức với 5HMO & đạm Gentle Optipro ( Dành cho trẻ từ 0 - 12 tháng tuổi),9127.0,3311812833838,575000,575000,0,0,61,do-choi-me-be
275220818,Tã/bỉm quần Huggies Skin Care Mega Jumbo XXL76+4 miếng với tràm trà dịu da,17942.0,2617797911201,380000,645750,265750,41,63,do-choi-me-be
275220816,Tã/bỉm quần Huggies Skin Care Mega Jumbo XL84+4 miếng với tràm trà dịu da,23284.0,9769782073893,380000,645750,265750,41,52,do-choi-me-be
274593234,"Sữa bột NAN INFINIPRO A2 Thụy Sĩ 2 400g, công thức đầu tiên kết hợp đạm A2 và 5HMO",739.0,6345362673757,310000,310000,0,0,21,do-choi-me-be
274541375,Thùng 24 chai Ensure Gold 237ml (Mẫu mới),450.0,1860824108218,1400000,1600000,200000,13,29,do-choi-me-be
274091856,Combo 3 gói Tã/bỉm dán sơ sinh Huggies Skin Perfect NB 70+6 miếng với 2 vùng thấm giảm kích ứng da,876.0,5875193097720,541000,680100,139100,20,7,do-choi-me-be
274091852,Combo 3 gói Tã/bỉm dán sơ sinh Huggies Skin Perfect S 54+4 miếng với 2 vùng thấm giảm kích ứng da,1910.0,5043330561197,541000,680100,139100,20,43,do-choi-me-be
274032614,Thực phẩm dinh dưỡng y học Ensure Gold 800g,33298.0,7172734639737,929000,1004000,75000,7,1089,do-choi-me-be
273923928,Sữa bột NAN INFINIPRO A2 Thụy Sĩ 1 400g với sự kết hợp độc đáo giữa đạm quý A2 và 5HMO (0 - 12 tháng),997.0,4815374074660,320000,320000,0,0,24,do-choi-me-be
247427699,Sữa bột Nestlé NAN OPTIPRO PLUS 1 800g/lon với 5HMO Sản Xuất Tại Thụy Sĩ (0 - 6 tháng),82628.0,9784909917108,515000,515000,0,0,381,do-choi-me-be
247427686,Sữa bột Nestlé NAN OPTIPRO PLUS 2 800g/lon với 5HMO Sản Xuất Tại Thụy Sĩ (6 - 12 tháng),118361.0,8308330822879,510000,510000,0,0,418,do-choi-me-be
247425212,Sữa bột Nestlé NAN OPTIPRO PLUS 2 400g/lon với 5HMO Sản Xuất Tại Thụy Sĩ (6-12 tháng),3893.0,5941028436228,260000,260000,0,0,41,do-choi-me-be
198573055,Sữa bột Nutramigen A+ LGG - Sữa cho trẻ dị ứng đạm sữa bò cho trẻ 0-12 tháng (400g),2612.0,6783481123427,620000,620000,0,0,46,do-choi-me-be
168663291,Sữa bột Nestlé NAN INFINIPRO A2 1 cho trẻ từ 0-12 tháng tuổi hộp 800g nhập khẩu nguyên lon từ Thụy Sỹ,7570.0,1229156404257,630000,630000,0,0,160,do-choi-me-be
168662079,Sữa bột NAN INFINIPRO A2 Thụy Sĩ 2 800g với sự kết hợp độc đáo giữa đạm quý A2 và 5HMO (12 - 24 tháng),4369.0,1606927418757,630000,630000,0,0,100,do-choi-me-be
95082968,Sữa bột Enfamil A2 Neuropro 2 cho trẻ từ 6 - 12 tháng tuổi – 800g,2061.0,6200534820999,695000,695000,0,0,109,do-choi-me-be
95072928,Sữa bột Enfamil A2 Neuropro 1 cho trẻ từ 0 - 6 tháng tuổi – 800g,1150.0,1719612794873,709000,709000,0,0,81,do-choi-me-be
88949156,Sữa Bột Friso Gold 4 850g (Dành Cho Trẻ Từ 2 - 6 Tuổi),8721.0,9575574244631,410000,461000,51000,11,198,do-choi-me-be
88949154,Sữa Bột Friso Gold 4 1400g (Dành Cho Trẻ Từ 2 - 6 Tuổi),10276.0,7095080489283,630000,885000,255000,29,411,do-choi-me-be
88949152,Sữa Bột Frisolac Gold 3 1400g (Dành Cho Trẻ Từ 1 - 2 Tuổi),30779.0,9590539492305,689000,689000,0,0,525,do-choi-me-be
88949150,Sữa Bột Frisolac Gold 3 850g (Dành Cho Trẻ Từ 1 - 2 Tuổi),49657.0,3700121989187,459000,459000,0,0,305,do-choi-me-be
88924594,Sữa Bột Frisolac Gold 1 850g Dành Cho Trẻ Từ 0 - 6 Tháng Tuổi,35584.0,5139529604174,499000,499000,0,0,334,do-choi-me-be
24028050,Sữa bột Abbott Pediasure 1.6kg cho trẻ từ 1-10 tuổi,893.0,9863682487009,1209000,1209000,0,0,171,do-choi-me-be
685882,Thùng 24 Chai Sữa Nước Abbott Ensure 237ml,9.0,3708650981980,1079000,1079000,0,0,2,do-choi-me-be
573673,Thùng 48 Hộp Sữa Nước Abbott Grow Gold 180ml cho trẻ 1 tuổi trở lên,112.0,8005882405884,839000,839000,0,0,33,do-choi-me-be
271329980,Thùng sữa bột pha sẵn Thực phẩm bổ sung Nestlé NANGROW 9(4x110ml) sữa mát công thức từ Thụy Sĩ với 100% Canxi giúp bé cao lớn vượt trội dành cho bé từ 1 tuổi,221.0,4529668452326,386000,458100,72100,16,13,do-choi-me-be
275597413,Sữa bột Nestlé NAN SUPREMEPRO 3 800g nhập khẩu Đức đạm Gentle Optipro ngừa mẫn cảm ( Dành cho trẻ từ 2 - 6 tuổi),102.0,1962382652378,500000,703000,203000,29,1,do-choi-me-be
277445829,[Phiên bản Rắn vàng giới hạn] Tã quần Huggies Skin Perfect Super Jumbo XXL48+6 với 2 vùng thấm giảm kích ứng da,334.0,3905466656623,329000,330000,1000,0,0,do-choi-me-be
276963436,"Combo 4 Sữa Abbott Grow 2+ 1,6kg cho trẻ 2 tuổi trở lên",15.0,8962822406224,2300000,3245000,945000,29,0,do-choi-me-be
276959994,Combo 6 sữa Bột Frisolac Gold 2 850g Dành Cho Trẻ Từ 6 - 12 Tháng Tuổi,75.0,5904550654128,2970000,2970000,0,0,2,do-choi-me-be
276959990,Combo 6 sữa Bột Frisolac Gold 1 850g Dành Cho Trẻ Từ 0 - 6 Tháng Tuổi,73.0,2429235154344,3000000,3000000,0,0,4,do-choi-me-be
213586941,Combo 3 Tấm lót SunMate cải tiến mới 20 miếng/gói size M (45 x 70cm),1877.0,5673578671350,240000,350511,110511,32,59,do-choi-me-be
276950448,Thùng 6 lon sữa bột NAN INFINIPRO A2 Thụy Sĩ 2 800g với sự kết hợp độc đáo giữa đạm quý A2 và 5HMO (12 - 24 tháng),145.0,2483796558236,3750000,3750000,0,0,2,do-choi-me-be
276938648,Combo 2 lon Sữa Morinaga số 2 (Chilmil) 800g,84.0,4840950749306,869000,869000,0,0,2,do-choi-me-be
276450736,"Combor 100 Túi Mù Phát Sáng Đủ Size Dùng Test Nhân Phẩm, Túi May Mắn Nhật Bản, Bất Ngờ Giao Ngẫu Nhiên - Hàng Nhập Khẩu",81.0,8089244008349,60000,60000,0,0,2,do-choi-me-be
276364177,Combo 2 lon Sữa Morinaga số 3 Hương vani (Kodomil),243.0,7218126526473,915000,1102000,187000,17,31,do-choi-me-be
275732098,Brauer Kids Liquid Zinc - hỗ trợ cho trẻ biếng ăn từ 1 tuổi (200m),6.0,5279129898239,199500,665000,465500,70,0,do-choi-me-be
275695310,Khăn tắm bông san hô 70x140 cm Loại Xịn Dầy Siêu Thấm Hút PaKaSa - Hàng chính hãng,7.0,9928039948609,98770,160000,61230,38,0,do-choi-me-be
275657939,"Nature's Way Kids Smart Vita Gummies Omega-3 DHA Fish Oil - Bổ sung Omega-3 (DHA, EPA) cho trẻ (60 viên/ Lọ)",12.0,5042308999003,119400,398000,278600,70,2,do-choi-me-be
275657931,Nature’s Way Kids Smart Bursts Calcium - Bổ sung Vitamin D3 giúp hấp thụ Canxi cho bé từ 6 tháng tuổi nhập khẩu từ Úc (50 viên/ lọ),29.0,5201366438452,110000,608000,498000,82,1,do-choi-me-be
275657916,Nature's Way Kids Smart VITA GUMMIES( VITAMIN C+ Zn) - Bổ sung kẽm và vitamin C cho trẻ (60 viên/ lọ),25.0,2051487826393,119400,398000,278600,70,1,do-choi-me-be
275645069,Combo 6 Món Đồ Chơi Gỗ Phát Triển Trí Tuệ Cho Bé Vừa Chơi Vừa Học,6.0,3585222116946,190000,190000,0,0,0,do-choi-me-be
275597417,Sữa bột Nestlé NAN SUPREMEPRO 1 400g nhập khẩu Đức với 5HMO & đạm Gentle Optipro ( Dành cho trẻ từ 0 - 12 tháng tuổi),438.0,6973097033043,283000,283000,0,0,12,do-choi-me-be
275428267,Chiếu Bạc Ngủ Trưa Văn Phòng Tấm Thảm Trải Lót Bạc Gấp Gọn Cách Nhiệt Du Lịch 1mx2m,135.0,9350184151350,75000,95000,20000,21,3,do-choi-me-be
274986606,Combo 2 gói - Tã dán người lớn SunMate mới size M18/L18/XL18 + 2 miếng,300.0,9771438922898,259000,314750,55750,18,15,do-choi-me-be
274533823,Sản phẩm dinh dưỡng công thức Aptamil Profutura Cesarbiotik 1 Infant Formula (Dành cho trẻ từ 0 - 12 tháng tuổi) - 800g,752.0,6617121582054,725000,725000,0,0,34,do-choi-me-be
274504809,Sản phẩm dinh dưỡng Enfagrow Enspire 2 850G - Dành cho trẻ 1 -3 Tuổi,298.0,8305859731728,815000,815000,0,0,10,do-choi-me-be
274402446,Tã quần Huggies Skin Perfect L Super Jumbo 60+6 miếng với 2 vùng thấm giảm kích ứng da,1403.0,3961419922788,329000,473130,144130,30,1,do-choi-me-be
273270900,Combo 12 Khăn Ướt Dịu Nhẹ Cho Trẻ Sơ Sinh Huggies (80 Tờ/Gói),540.0,6929677705983,329000,408000,79000,19,35,do-choi-me-be
271329982,Sữa bột công thức S-26 ULTIMA 1 750G với hợp chất NUTRILEARN CONNECT cho bé 0 - 12 tháng tuổi,633.0,3097058716729,759000,759000,0,0,28,do-choi-me-be
271329978,Sữa bột công thức S-26 ULTIMA 2 750G với hợp chất NUTRILEARN CONNECT cho bé 12 - 24 tháng tuổi,408.0,9294473836422,759000,759000,0,0,20,do-choi-me-be
270875863,Combo 2 Sữa Bột Anlene Gold 3X vị Cà phê (Hộp giấy 280g),196.0,1746763850961,236000,236000,0,0,9,do-choi-me-be
263062457,Đồ Chơi Ghép Hình Duka - Lực Lượng Đặc Nhiệm_ Xuồng Tuần Tra DK81175,1.0,1691553841518,89250,105000,15750,15,0,do-choi-me-be
206622901,Miếng Lót Bổ Sung Caryn Dành Cho Người Lớn 20M (20 Miếng),9197.0,3056234741843,90000,95000,5000,5,114,do-choi-me-be
191621159,"Đồ Chơi Cát Ma Thuật Mideer Magic Sand Play Set Dành Cho Bé 3 Tuổi, Đồ Chơi Cảm Giác Cho Bé",42.0,4182267181894,150000,250000,100000,40,5,do-choi-me-be
168779219,Bàn Chải Đánh Răng Silicon Hình Chữ U Cho Trẻ Em MINIIN - Cho Bé Từ 2 - 6 Tuổi,193.0,3030394979706,5000,5000,0,0,25,do-choi-me-be
115483204,Sữa bột Enfagrow A+ NeuroPro 3 với 2’-FL HMO cho trẻ từ 1 – 3 tuổi– 1.7kg,7179.0,1691761979809,959000,959000,0,0,113,do-choi-me-be
88924596,Sữa Bột Frisolac Gold 2 850g Dành Cho Trẻ Từ 6 - 12 Tháng Tuổi,55032.0,1375013932125,495000,495000,0,0,590,do-choi-me-be
79672168,Sữa Bột Enfagrow Premium Toddler Hương Sữa Tự Nhiên cho trẻ trên 1 tuổi (907g),2113.0,2968754713907,669000,669000,0,0,177,do-choi-me-be
35043551,Thùng 48 Hộp Sữa Nước Abbott Grow Gold 110ml,3155.0,5637833718144,608000,804000,196000,24,209,do-choi-me-be
34537694,Tã Dán Siêu Thấm Caryn Gói Siêu Tiết Kiệm M40 (40 Miếng),33.0,2110891655086,378000,378000,0,0,4,do-choi-me-be
1745009,Tấm Đệm Lót Siêu Thấm Caryn (20 Miếng),37177.0,9085800833530,105000,128700,23700,18,1189,do-choi-me-be
544209,Dung Dịch Tắm Gội Toàn Thân Cho Bé Dưới 3 Tuổi D-nee - Chai 800ml (Xanh),15.0,7909748203830,148000,148000,0,0,8,do-choi-me-be
544092,Nước rửa bình sữa D-nee Mild & Care chai 500ml,0.0,7907044427776,86000,86000,0,0,0,do-choi-me-be
276963432,Combo 4 Thực Phẩm Dinh Dưỡng Y Học Ensure Gold 800g,11.0,2123028011425,3440000,4016000,576000,14,0,do-choi-me-be
276963424,"Combo 4 Sữa Bột Abbott Pediasure 1,6kg cho trẻ 1-10 tuổi",14.0,4555712338206,4280000,6162000,1882000,31,0,do-choi-me-be
276950469,Thùng 4 hộp sữa bột Enfagrow A+ NeuroPro 3 với 2’-FL HMO cho trẻ từ 1 – 3 Tuổi - Vị Nhạt Dễ Uống (2.2kg),11.0,3899535327394,4100000,4100000,0,0,1,do-choi-me-be
276950458,Thùng 6 lon sữa bột Enfamil A2 Neuropro 1 cho trẻ từ 0 - 6 tháng tuổi – 800g,18.0,9204006627790,4170000,4170000,0,0,1,do-choi-me-be
276938650,Combo 3 lon Sữa Morinaga số 2 Chilmil 800g + 1 lon sữa Morinaga số 2 320gr,108.0,7215317628715,1440000,1440000,0,0,3,do-choi-me-be
276621518,Combo 6 lon sữa bột Enfamil A2 Neuropro 2 cho trẻ từ 6 - 12 tháng tuổi – 800g,52.0,8634004099541,4200000,4200000,0,0,0,do-choi-me-be
276621508,Thùng 6 lon sữa bột Nestlé NAN SUPREMEPRO 2 800g nhập khẩu Đức với 5HMO & đạm Gentle Optipro,75.0,5696462810957,3450000,3450000,0,0,4,do-choi-me-be
276471367,[TẶNG THÊM 4 MIẾNG] Tã quần Bobby Siêu Khô Thoáng - 100% Thoáng Khí  Super Jumbo,15.0,5165781130162,250000,320000,70000,22,3,do-choi-me-be
275821666,Tã quần Huggies Skin Perfect Mega Jumbo XL72+4 miếng với 2 vùng thấm giảm kích ứng da,285.0,4048665478311,370000,645750,275750,43,3,do-choi-me-be
275821664,Tã quần Huggies Skin Perfect Mega Jumbo M98+4 miếng với 2 vùng thấm giảm kích ứng da,216.0,5881563612417,370000,645750,275750,43,1,do-choi-me-be
275358865,Sữa Meiji lon số 0 800g Nội Địa Nhật (cho trẻ từ 0-1 tuổi),298.0,6941411485407,470000,470000,0,0,15,do-choi-me-be
275156025,Tắm Gội 2 Trong 1 Chiết Xuất Jojoba/Hoa Hướng Dương 50ml - Bao Bì Mới,180.0,3248779258593,50000,50000,0,0,0,do-choi-me-be
274694353,Tã Quần Caryn Loại Mỏng Nhẹ L28,5025.0,1292288657905,316000,391200,75200,19,339,do-choi-me-be
274556204,Sữa Bột Friso Gold 4 Hộp Giấy 3.2KG (Dành cho trẻ 2 - 6 tuổi),70.0,8068681581518,1200000,2027000,827000,41,3,do-choi-me-be
274556202,Sữa Bột Friso Gold 3 Hộp Giấy 3.2KG (Dành cho trẻ 1 - 2 tuổi),138.0,6437256442571,1289000,1289000,0,0,16,do-choi-me-be
274106804,Thực phẩm dinh dưỡng y học Glucerna hương vani 800g/850g,19653.0,7270356736054,939000,996930,57930,6,583,do-choi-me-be
274058672,Tã/bỉm dán sơ sinh Huggies Skin Perfect S 80+2 miếng với 2 vùng thấm giảm kích ứng da,1018.0,5127069181642,260000,339600,79600,23,3,do-choi-me-be
274058666,Tã/bỉm dán sơ sinh Huggies Skin Perfect NB 70+6 miếng với 2 vùng thấm giảm kích ứng da,1793.0,2113190848012,180000,226700,46700,21,24,do-choi-me-be
274032919,Thực phẩm dinh dưỡng y học Ensure Gold hương lúa mạch 800g/850g,5896.0,3248135380019,935000,1004000,69000,7,457,do-choi-me-be
274032910,Thực phẩm dinh dưỡng y học Ensure Gold hương vani ít ngọt 800g/850g,10193.0,4789355348624,943000,1004000,61000,6,527,do-choi-me-be
271452044,"Nước Rửa Bình Sữa Gốc Thực Vật Peace Mass Với Thiết Kế Chai Tạo Bọt Tiết Kiệm Hơn Không Mùi và Công Nghệ Enzyme Giúp Làm Sạch Nhanh Bình Sữa, Dụng Cụ Ăn Uống, Đồ Chơi Nhựa Của Trẻ  (Thuộc nhóm Sản phẩm Lành tính / Hữu cơ/ Sinh học) 250ml",110.0,3108030671172,54000,54000,0,0,2,do-choi-me-be
229714887,Tã dán Caryn siêu thấm XL20,4.0,3010175353824,280000,280000,0,0,0,do-choi-me-be
206861808,Rùa Bơi Vặn Cót - Đồ Chơi Nhà Tắm - đồ chơi Dưới Nước thả bồn tắm Cho Bé,92.0,3563724390192,15000,15000,0,0,0,do-choi-me-be
168662602,Sữa bột NAN INFINIPRO A2 Thụy Sĩ 3 800g với đạm quý A2 tiêu hóa tốt sau 7 ngày và 5HMO tăng cường đề kháng (2 - 6 tuổi),342.0,5484282632747,569000,600000,31000,5,29,do-choi-me-be
164075724,Tả quần Kitin Natural size XL38 (12-15kg),253.0,5836944935089,225000,225000,0,0,47,do-choi-me-be
117836946,[Mới] Hộp giấy 2 Kg Frisolac Gold 3,3023.0,6796262149905,859000,859000,0,0,307,do-choi-me-be
115483434,Sữa bột Enfamil A+ NeuroPro 2 với 2’-FL HMO cho trẻ từ 6 –12  tháng tuổi– 1.7kg,2100.0,5945805992204,979000,979000,0,0,69,do-choi-me-be
115483206, Sữa bột Enfagrow A+ NeuroPro 3 với 2’-FL HMO cho trẻ từ 1 – 3 Tuổi - Vị Nhạt Dễ Uống (2.2kg),3304.0,7779547757743,1079000,1079000,0,0,385,do-choi-me-be
95082970,Sữa bột Enfagrow A2 Neuropro 3 dành cho trẻ từ 1 - 6 tuổi – 350g,978.0,9322449028133,275000,275000,0,0,97,do-choi-me-be
87483010,Miếng Lót Sơ Sinh Bobby Fresh Newborn 2 - 60 (60 Miếng),1744.0,8145244903519,115000,140300,25300,18,174,do-choi-me-be
57044932,Thùng 48 Hộp Sữa Nước Abbott Pediasure Vani 180ml cho trẻ từ 1 - 10 tuổi,2.0,7346116124562,1609000,1609000,0,0,0,do-choi-me-be
57044926,Thùng 48 Hộp Sữa Nước Abbott Pediasure Vani 110ml cho trẻ từ 1 - 10 tuổi,3930.0,3629907238049,1070000,1436000,366000,25,353,do-choi-me-be
43191091,Thùng 48 Hộp Sữa Anlene Đậm Đặc 4X Ít Béo Hương Vani (12 x 4 x 125 ml),132.0,3907956387070,485000,485000,0,0,23,do-choi-me-be
32030382,Combo 12 Gói Khăn Ướt Huggies Cacao và Bơ Hạt Mỡ (72 Miếng/ Gói),2.0,8595248887879,450000,450000,0,0,0,do-choi-me-be
19944401,Tã Quần Moony Natural Bông Organic XL32 (32 Miếng),192.0,4646156000608,289000,289000,0,0,11,do-choi-me-be
19944385,Tấm Đệm Lót Caryn Mỏng Nhẹ (14 Miếng),13.0,8233722124835,165000,165000,0,0,0,do-choi-me-be
10054502,Thùng 48 Hộp Sữa Bột Pha Sẵn Friso Gold Rtd Vani (48 x 180Ml),4156.0,1445195614561,599000,807000,208000,26,361,do-choi-me-be
10054452,Thùng 48 Hộp Sữa Bột Pha Sẵn Friso Gold Rtd Vani (48 Hộp X 110ml),3234.0,1066540392745,379000,505000,126000,25,373,do-choi-me-be
276959989,Combo 6 sữa Bột Frisolac Gold 3 850g (Dành Cho Trẻ Từ 1 - 2 Tuổi),61.0,9893818488088,2850000,2850000,0,0,2,do-choi-me-be
276078585,Tã quần Huggies Naturemade ban đêm XL 38 miếng,74.0,4062153908166,250000,483000,233000,48,4,do-choi-me-be
275821676,Tã quần Huggies Skin Perfect Mega Jumbo XXL64+4 miếng với 2 vùng thấm giảm kích ứng da,132.0,8006457504558,370000,645750,275750,43,0,do-choi-me-be
275358859,Sữa Meiji dạng thanh số 0 Nội Địa Nhật ( mẫu mới 30 thanh),0.0,4637161043399,549000,549000,0,0,1,do-choi-me-be
275123509,Tã Dán Moony Natural Bông Organic S58 +2,33.0,2465914229832,331000,569400,238400,42,2,do-choi-me-be
275009683,Miếng lót sơ sinh Bobby Newborn 1 - 108 miếng,654.0,9804212771246,130000,170100,40100,24,61,do-choi-me-be
274993765,Tã dán người lớn SunMate mới size M18/L18/XL18 + 2 miếng,285.0,6143881451408,150000,177709,27709,16,15,do-choi-me-be
274986677,Tã quần người lớn SunMate siêu mềm mại mới size M18/L16/XL14 + 2 miếng,263.0,1359390043049,146000,188509,42509,23,9,do-choi-me-be
274855365,Sữa bột Abbott Pediasure hương vani ít ngọt cho trẻ từ 1 - 10 tuổi (380g),37.0,7027920427046,322000,431000,109000,25,2,do-choi-me-be
274533821,Thực phẩm bổ sung Aptamil Profutura Kid Cesarbiotik 3 Growing Up Milk Formula (Dành cho trẻ từ 24 tháng tuổi trở lên) - 800g,157.0,3557046675262,560000,681000,121000,18,2,do-choi-me-be
274504808,Sản phẩm dinh dưỡng công thức Enfagrow Enspire 2 350G - Dành cho trẻ 1 -3 Tuổi,107.0,2057940841865,339000,339000,0,0,5,do-choi-me-be
274504806,Sản phẩm dinh dưỡng công thức Enfamil Enspire 1 350G - Dành cho trẻ 0 - 12 Tháng,245.0,9774182352359,449000,449000,0,0,13,do-choi-me-be
274402452,Tã quần Huggies Skin Perfect XXL Super Jumbo 48+6 miếng với 2 vùng thấm giảm kích ứng da,718.0,3680037450219,329000,473130,144130,30,3,do-choi-me-be
274402450,Tã quần Huggies Skin Perfect M Super Jumbo 70+6 miếng với 2 vùng thấm giảm kích ứng da,0.0,6427295925936,298000,298000,0,0,0,do-choi-me-be
274373474,Sữa công thức MetaCare Opti 1+ lon 850g,18.0,2615341185595,318000,318000,0,0,0,do-choi-me-be
274032594,Thực phẩm dinh dưỡng y học Ensure Gold 380g/400g,22742.0,9608521855899,459000,499000,40000,8,638,do-choi-me-be
271329974,Thùng sữa bột pha sẵn Nestlé NANGROW 6(4x180ml) sữa mát công thức từ Thụy Sĩ với 100% Canxi giúp bé cao lớn vượt trội dành cho bé từ 1 tuổi,176.0,3287601062570,368000,430200,62200,14,9,do-choi-me-be
271134199,Tranh kích thích thị giác cho trẻ sơ sinh từ 0-2 tuổi Đồ chơi cho trẻ sơ sinh giúp bé phát triển giác quan và não bộ - Đồ chơi trẻ em HT SYS,33.0,9849385662187,88000,88000,0,0,2,do-choi-me-be
229714894,Tã Quần Mỏng Nhẹ Caryn XL24 (24 miếng),255.0,5164726255358,315000,391200,76200,19,5,do-choi-me-be
212329625,"Xe tròn tập đi cao cấp cho bé, khung xe kim loại chắc chắn - có kèm nhạc, đèn",54.0,1941994986797,328000,517000,189000,37,3,do-choi-me-be
206073387,Con Lăn Tạo Phép Tính Toán Học Cộng Trừ Nhân Chia Cho Bé Học Toán Tiểu Học GroFa ( Tặng kèm 1 hủ mực dự phòng)- Màu họa tiết ngẫu nhiên,37.0,3060211964529,49000,49000,0,0,2,do-choi-me-be
202045905,Combo 03 Sữa Bột Anlene Gold 3X Hương Vanilla (Hộp giấy 1200g) - Tặng nồi inox,614.0,6947146452101,1480000,1578000,98000,6,59,do-choi-me-be
199903945,Combo 2 Tấm lót SunMate cải tiến mới 10 miếng (45 x 70cm),2650.0,5270934258123,95000,130680,35680,27,98,do-choi-me-be
197497015,"Khóa Tủ An Toàn Cho Bé Xoay 360 Độ, Khóa Tủ Lạnh, Bếp, Hộc Bàn Chống Kẹt - Chính Hãng NAVIVU",393.0,9469252430887,25000,25000,0,0,21,do-choi-me-be
197329427,Cuộn 2m Mút Xốp NAVIVU Bọc Cạnh Bàn Ghế Giường Tủ Bảo Vệ An Toàn Cho Bé,941.0,1470690055804,50000,50000,0,0,43,do-choi-me-be
173164596,Combo 03 Sữa Bột Anlene Gold 3X Hương Vanilla (Hộp thiếc 800g) - Tặng nồi inox cao cấp,207.0,9255860854151,1219000,1400000,181000,13,28,do-choi-me-be
164375665,Tã dán sơ sinh êm mềm khô thoáng Bobby,1187.0,5137572527916,170000,222600,52600,24,154,do-choi-me-be
115483441,Sữa bột Enfamil A+ NeuroPro 1 với 2’-FL HMO cho trẻ từ 0 – 6 tháng tuổi– 400g,1856.0,4232873402715,255000,255000,0,0,99,do-choi-me-be
95072930,Sữa bột Enfamil A2 Neuropro 1 cho trẻ từ 0 - 6 tháng tuổi – 350g,435.0,5965114539917,315000,315000,0,0,58,do-choi-me-be
94728826,"Áo yếm máng dài tay Cotton chống thấm nước cho bé tập ăn dặm, tập vẽ Mastela Dành cho bé từ 0-4 tuổi - Có chọn màu và size",100.0,6103390783950,95000,95000,0,0,19,do-choi-me-be
55461311,Tinh dầu tràm Huế Kim Vui 125ml - Tinh dầu dùng cho trẻ sơ sinh,452.0,8177231073393,190000,190000,0,0,74,do-choi-me-be
52588247,Combo 2 lon Sữa Morinaga số 2 (Chilmil) 320g (6 - 36 tháng),96.0,1478306141137,420000,420000,0,0,18,do-choi-me-be
27657637,Khăn vải khô đa năng Mama 240 tờ,23.0,4850911310998,49989,49989,0,0,0,do-choi-me-be
24030105,Sữa bột Abbott Pediasure 850g cho trẻ từ 1 - 10 tuổi,451.0,5781211572139,729000,729000,0,0,95,do-choi-me-be
24026125,Thùng 30 Chai Sữa Nước Abbott Glucerna Vani 220ml,3692.0,2973805606440,1580000,1661550,81550,5,318,do-choi-me-be
19944395,Tã Quần Moony Natural Bông Organic L36 (36 Miếng),93.0,3091250540474,279000,279000,0,0,6,do-choi-me-be
6840059,Combo 2 Tã Dán Người Lớn SunMate G2 Size M10 (10 Miếng),16.0,7921289041887,169600,169600,0,0,0,do-choi-me-be
3005389,Nước Giặt Quần Áo Cho Bé D-nee - Chai 3000ml (Xanh lá),7.0,5988055997221,194500,194500,0,0,1,do-choi-me-be
277401710,Sữa bột NAN INFINIPRO A2 800g Thụy Sĩ 3 với đạm quý A2 tiêu hóa tốt sau 7 ngày và 5HMO tăng cường đề kháng​ (2 - 6 tuổi),30.0,7057161231178,600000,644600,44600,7,5,do-choi-me-be
276950462,Thùng 8 lon sữa Morinaga Số 2 - Chilmil (800g),2.0,2946621011840,3320000,3320000,0,0,0,do-choi-me-be
276328342,Nước rửa bình thảo mộc cho bé Arau Baby - Túi 450ml,34.0,1591903389392,112000,129000,17000,13,2,do-choi-me-be
276288019,Tã bỉm QUẦN Bobby Mega Jumbo gói lớn tiết kiệm M96/ L88/ XL76/ XXL70 miếng,30.0,8762670051550,350000,350000,0,0,3,do-choi-me-be
276003991,Con Quay Spinner 7 Màu Handicraft ,3.0,7616889006176,49000,49000,0,0,0,do-choi-me-be
275498144,Thực Phẩm Bổ Sung Bánh Ăn Dặm Gerber Puffs vị Dâu Táo 42g dành cho trẻ trên 8 tháng tuổi,47.0,5571184166857,101000,108300,7300,7,4,do-choi-me-be
275498141,Thực Phẩm Bổ Sung Bánh Ăn Dặm Gerber Puffs vị Chuối 42g dành cho trẻ trên 8 tháng tuổi,90.0,1459488089242,89100,108300,19200,18,6,do-choi-me-be
275481905,Miếng lót thấm sữa Moony (108 miếng/hộp) - Nhập khẩu từ Nhật Bản,16.0,8327119478628,250000,350000,100000,29,0,do-choi-me-be
275428263,"Chiếu Bạc Ngủ Trưa Văn Phòng, Tấm Thảm Trải Lót Bạc Gấp Gọn Cách Nhiệt Du Lịch 1mx2m",126.0,7693782590521,75000,95000,20000,21,6,do-choi-me-be
275418099,Bộ đồ chơi rút gỗ mini 54 thanh - Hàng chính hãng,23.0,2461976971840,39000,78000,39000,50,1,do-choi-me-be
275281606,"Đồ Chơi Gỗ Cho Bé, Bảng Gỗ Nổi Vuông 20x20cm, Bảng Chữ Cái, Số Và Hình, Đồ Chơi Giáo Dục Sớm",16.0,5727010939746,25000,25000,0,0,0,do-choi-me-be
274855363,Sữa bột Abbott Pediasure 800g cho trẻ từ 1 - 10 tuổi,570.0,7699317322554,703000,894400,191400,21,17,do-choi-me-be
273204107,"Đồ chơi thông minh cho bé trai gái sơ sinh 1 2 3 tuổi phát triển tư duy, kích thích trí tuệ não, tập cầm nắm",10.0,8746341020567,115000,145000,30000,21,4,do-choi-me-be
270125040,Tã quần người lớn Caryn bỉm quần gói lớn size M16 M32 L5 L14 L28 XL12 XL24 Mỏng Nhẹ Chống Tràn,10.0,9471365383359,70000,70000,0,0,1,do-choi-me-be
208189011,Set 5 Bịt Góc Bàn Ghế Silicon Trong Suốt (Kèm Keo 2 Mặt) - Bo Góc Chống Va Chạm An Toàn Cho Trẻ Em,856.0,2635099073235,20000,20000,0,0,41,do-choi-me-be
204464247,"Khăn xô, Khăn Sữa UNMEI cho bé - Set 10 Khăn sữa xuất nhật 3 lớp ( 10 cái / bich) - Có bán lẻ 2 chiếc",22.0,8982682346628,7500,7500,0,0,0,do-choi-me-be
199245568,Bộ đồ chơi lắp ráp ghép mô hình xe đồ ăn thông minh cho bé MySun,25.0,9177339946477,59000,83000,24000,29,7,do-choi-me-be
197601216,"Màn mùng lưới chụp chống muỗi gấp gấp gọn thông minh che chắn cho bé sơ sinh, trẻ em ngủ MySun",69.0,8958886541048,129000,175000,46000,26,13,do-choi-me-be
197328898,"Set 4 Miếng Xốp Bọc Cạnh Bàn, Bịt Góc Tủ Bảo Vệ An Toàn Cho Bé NAVIVU",240.0,8229422664222,25000,25000,0,0,19,do-choi-me-be
196150470,Nước Rửa Bình Sữa Pigeon Hương Tự Nhiên (New 2022),157.0,1473990023435,90000,104000,14000,13,13,do-choi-me-be
192712334,Sữa bột Vinamilk Dielac Alpha Gold 3 1400g (cho trẻ từ 1- 2 tuổi),47.0,9746318984898,470000,470000,0,0,5,do-choi-me-be
192339768,Đầu bàn chải điện cho bé LocknLock ENR226WHT-RB- 4pcs- Màu Trắng,163.0,8058463917090,115000,190000,75000,39,25,do-choi-me-be
191620753,"Máy in con lăn tạo phép tính cộng trừ,máy tạo phép tính đơn giản ra bài tập cho bé học toán",16.0,6289304764801,35000,35000,0,0,1,do-choi-me-be
189063704,Hộp giấy 2 Kg Friso Gold 4 (2-6 tuổi),241.0,9719257148996,840000,1176000,336000,29,37,do-choi-me-be
185920974,"Sữa Vinamilk Sure Diecerna 900gr - Dinh dưỡng dành cho người đái tháo đường, tiền đái tháo đường và đái tháo đường thai kỳ",51.0,6656659171473,585000,585000,0,0,7,do-choi-me-be
178739627,TẤM LÓT NGƯỜI GIÀ CARYN GÓI 10 MIẾNG,100.0,8142032249491,73000,73000,0,0,2,do-choi-me-be
153407418,"Lợi sữa Himom dạng cao lỏng cao cấp hỗ trợ tăng tiết sữa, giảm nguy cơ tắc tuyến sữa (hộp 30 gói)",13.0,8547469345950,380000,380000,0,0,11,do-choi-me-be
130461479,Sữa Bột Similac 2+ (Dành cho trẻ từ 2 - 6 tuổi),1463.0,6282049426859,508000,602000,94000,16,107,do-choi-me-be
127364356,"Thanh chắn cửa, chắn cầu thang chính hãng Mastela D04 bảo vệ an toàn cho bé, Không cần khoan tường, có thể thanh mở rộng",60.0,1369139525281,239000,239000,0,0,5,do-choi-me-be
95082972,Sữa bột Enfamil A2 Neuropro 2 cho trẻ từ 6 - 12 tháng tuổi – 350g,468.0,3786747099174,303000,303000,0,0,60,do-choi-me-be
95035819,Bột ăn dặm dinh dưỡng Sữa - Ăn dặm khởi đầu HiPP Organic 250g,1040.0,9135465993641,155000,155000,0,0,177,do-choi-me-be
68554792,"Tấm lót chống thấm cho bé dùng được 2 mặt. Miếng lót chống thấm xuống nệm, thoáng khí, hàng chính hãng - EUROSTANIBO20",998.0,9656187295466,129000,129000,0,0,239,do-choi-me-be
56705783,Bài Tarot Kèm Túi Đựng Bài Và Khăn Trải – Bài Bói Tarot Chính Hãng miDoctor,336.0,7727136950049,109000,109000,0,0,97,do-choi-me-be
54028965,Bộ 5 đồ chơi lúc lắc cho trẻ - Màu ngẫu nhiên,16.0,3280824878666,123200,160000,36800,23,2,do-choi-me-be
25597768,"Sữa bột Nutricare Gastro dinh dưỡng y học cho người viêm dạ dày, rối loạn tiêu hoá 2 Hộp (900g)",45.0,6137187440764,985000,985000,0,0,5,do-choi-me-be
22984922,HỘP SỮA BỘT  VINAMILK DIELAC GROW PLUS 1+ 900G (CHO TRẺ TỪ 1 - 2 TUỔI),10.0,6674038968843,385000,385000,0,0,1,do-choi-me-be
16326038,Sữa non COLOSBABY GOLD 1+ (800G),11.0,6716527149415,459000,459000,0,0,3,do-choi-me-be
9730316,Bộ 4 tấm (4 màu trơn khác nhau) Thảm xốp lót sàn an toàn Thoại Tân Thành (60x60cm),347.0,7437849818207,175370,175370,0,0,5,do-choi-me-be
4696281,Tã Quần Bobby Ultra Jumbo XXL56 Siêu Siêu Lớn (Size XXL) - 56 Miếng,106.0,7455600938964,325000,325000,0,0,24,do-choi-me-be
2147119,Sữa bột nguyên kem của NutiFood 900 Gr,304.0,4540907578425,185000,185000,0,0,63,do-choi-me-be
277938153,Sữa Bột Anlene Gold 5X Hương Vanilla (Hộp Thiếc 800g),1533.0,2674383936939,499000,525000,26000,5,144,do-choi-me-be
277938048,"Combo 2 Sữa Bột Anlene Gold 5X Hương Vanilla (Hộp Giấy 1,2kg)",11.0,9819587530494,1299000,1372000,73000,5,0,do-choi-me-be
277938038,Sữa Bột Anlene Gold 5X Hương Vanilla (Hộp giấy 1200g),403.0,9992012595944,629000,686000,57000,8,36,do-choi-me-be
277457003,Tã/Bỉm dán người lớn siêu thấm Caryn dành cho người hạn chế khả năng đi lại  Size XL16 miếng,5.0,4783084181497,150000,208800,58800,28,1,do-choi-me-be
277445926,[Phiên bản Rắn vàng giới hạn] Tã quần Huggies Skin Perfect Mega Jumbo L88+4 với 2 vùng thấm giảm kích ứng da,169.0,3881451100391,370000,645750,275750,43,0,do-choi-me-be
277445534,[Phiên bản Rắn vàng giới hạn] Tã quần Huggies Skin Perfect Super Jumbo M70+6 với 2 vùng thấm giảm kích ứng da,370.0,8506949740034,299000,329000,30000,9,0,do-choi-me-be
277400861,"Sữa Bột Nestlé S-26 ULTIMA 3 (S26) 750G tăng tốc độ kết nối não bộ 2,5 lần với NUTRILEARN CONNECT",19.0,9469095387295,699000,931000,232000,25,1,do-choi-me-be
276938646,Sữa Morinaga Số 2 - Chilmil (800g),25.0,2166526589539,485000,485000,0,0,0,do-choi-me-be
276611872,Combo 4 Lon sữa Meiji Infant Formula 800g (Cho trẻ từ 0-1 tuổi),12.0,8814750792086,1820000,1820000,0,0,0,do-choi-me-be
276611170,Sách Vải Song Ngữ Việt Anh Phát Triển Tư Duy và Đa Giác Quan Cho Bé Sơ Sinh Size Mini 12x12cm - PiPo Vietnam,23.0,8347412586989,37000,37000,0,0,0,do-choi-me-be
276414093,Combo 02 Sữa Bột Anlene Gold 3X Hương Vanilla (Hộp thiếc 900g) - Tặng bộ 2 khăn Anlene (Màu ngẫu nhiên),10.0,3011801553181,849000,920000,71000,8,2,do-choi-me-be
275881756,"Xe đẩy cho bé du lịch A2 - Khung cao cấp siêu nhẹ, gấp gọn, bảo hành 12 tháng chính hãng",14.0,1555654844938,750000,750000,0,0,1,do-choi-me-be
275821678,Tã quần Huggies Skin Perfect Mega Jumbo L88+4 miếng với 2 vùng thấm giảm kích ứng da,245.0,8491579355707,370000,645750,275750,43,0,do-choi-me-be
275789648,Tã/Bỉm dán organic siêu cao cấp Moony Natural Newborn 62+4 miếng,24.0,8959655425196,330000,569400,239400,42,2,do-choi-me-be
274986656,Combo 2 - Tã quần người lớn SunMate siêu mềm mại mới size M18/L16/XL14 + 2 miếng,70.0,7872955392873,289000,377018,88018,23,1,do-choi-me-be
274731354,"Sữa Bột Nestlé S-26 ULTIMA 3 (S26) 750G từ Thụy Sỹ độc quyền tăng tốc độ kết nối não bộ 2,5 lần với NUTRILEARN CONNECT   Tặng ​Máy massage cổ​ (2-6 tuổi)",52.0,1617334386902,710000,878800,168800,19,2,do-choi-me-be
274032929,Thực phẩm dinh dưỡng y học Ensure Gold hương cà phê 800g/850g,1858.0,2579739633648,935000,1004000,69000,7,260,do-choi-me-be
273818646,Tã quần UniDry Siêu khô thoáng gói Jumbo mới size XXL,67.0,2275464169051,280000,377312,97312,26,2,do-choi-me-be
272661542,Combo 2 Tã/bỉm quần Merries Đủ Size M52/L44/XL38/XXL26,179.0,6773187242392,655000,770000,115000,15,8,do-choi-me-be
257771717,Combo 02 Sữa Bột Anlene Gold 5X Hương Vanilla (Hộp thiếc 800g) - Tặng bộ 2 khăn Anlene (Màu ngẫu nhiên),416.0,7509177783802,999000,1169000,170000,15,30,do-choi-me-be
207898804,Tặng Thêm 2 Miếng- Tã Quần Sunmate L14 Siêu Khô Thoáng (Tã Quần Người Lớn Sunmate Size L 16 Miếng /Gói) - Date Luôn Mới,366.0,9711263554176,170800,170800,0,0,7,do-choi-me-be
197735259,Núm ty Pigeon siêu mềm Plus thế hệ III phiên bản Nhật (2 cái/ hộp),4.0,7652024426084,210000,210000,0,0,0,do-choi-me-be
150565149,Bộ Dụng Cụ Lấy Ráy Tai Có Đèn Led Cao Cấp Kèm Hộp Đựng Sịn Sò Sử Dụng Cổng Sạc USB,260.0,8935190236420,179000,179000,0,0,41,do-choi-me-be
145394086,"Lợi sữa Hi Mom Hapi- Sữa nhiều hơn, thơm hơn, đặc hơn, mát hơn, thông tắc tia sữa",68.0,6500797983701,320000,320000,0,0,14,do-choi-me-be
145394084,"Siro Ăn Ngon BABYPLUS Hapi Cho Trẻ Biếng Ăn, Tăng Cân Tự Nhiên",26.0,4243155575527,359000,359000,0,0,7,do-choi-me-be
130829348,Xe Chòi Chân Kết Hợp Bàn Đạp Cho Bé Siêu Xinh Peaflo,426.0,4703116892016,285000,325000,40000,12,12,do-choi-me-be
115483447,Sữa bột Enfamil A+ NeuroPro 2 với 2’-FL HMO cho trẻ từ 6 –12  tháng tuổi– 400g,1791.0,9030720700265,259000,259000,0,0,64,do-choi-me-be
112109438,"Thùng sữa nước pha sẵn Nutricare Care 100 GOLD cho trẻ thấp còi, biếng ăn từ 1 tuổi (180ml)",67.0,1848284450063,609000,609000,0,0,5,do-choi-me-be
84698911,Nước Tắm Gội Thảo Dược Dr Papie,4.0,5315010798258,105000,105000,0,0,1,do-choi-me-be
73535991,"Khăn sữa sợi tre mềm mại thấm hút tốt, thương hiệu KACHOO 8 cái/hộp kích thước 30x30cm",615.0,8115814248936,79000,79000,0,0,101,do-choi-me-be
58918395,Kẹo dẻo đa Vitamin thiết yếu cho bé - L’il Critters Gummy Vites 300 viên mẫu mới,147.0,4534278245475,520000,520000,0,0,26,do-choi-me-be
57044918,Thùng 24 Chai Sữa Nước Abbott Pediasure Vani 237ml cho trẻ từ 1-10 tuổi,3987.0,3417378922211,991000,1334000,343000,26,304,do-choi-me-be
41382916,Combo 3 bịch Khăn vải khô đa năng Mama (bịch 240 tờ),15.0,8612599766308,149000,149000,0,0,1,do-choi-me-be
23957552,Combo 2 Tã Quần Người Lớn Sunmate Mềm Mại L8 (8 Miếng),18314.0,2034916335848,140000,199998,59998,30,586,do-choi-me-be
14472037,Sữa non COLOSBABY GOLD 0+ (800G),58.0,5971363005658,505000,505000,0,0,8,do-choi-me-be
3015787,Tã Quần Cao Cấp Moony Nhật Bản Bé Gái XXL26 (26 Miếng),388.0,2273732509310,283000,283000,0,0,19,do-choi-me-be
543129,Nước Giặt Quần Áo Cho Bé D-nee - Chai 3000ml (Xanh),3.0,7905387732502,194500,194500,0,0,0,do-choi-me-be
532984,Combo 6 Khăn Ướt Unifresh Vitamin E 80M (80 Miếng),18002.0,7901152730384,140000,158394,18394,12,1222,do-choi-me-be
498703,Combo 6 Khăn Ướt Unifresh Aloevera 80M (80 Miếng),20322.0,7900814377387,140000,158394,18394,12,1393,do-choi-me-be
412767,Tã Quần Cao Cấp Moony Nhật Bản Bé Gái L44 (44 Miếng),18248.0,8102092646233,290000,466400,176400,38,425,do-choi-me-be
277543194,Tã/bỉm quần Molfix Thiên nhiên Jumbo XXXL (20kg - 35kg) - Gói 22+6 miếng,4.0,6963365822471,224900,224900,0,0,0,do-choi-me-be
277445794,[Phiên bản Rắn vàng giới hạn] Tã quần Huggies Skin Perfect Super Jumbo XL52+6 với 2 vùng thấm giảm kích ứng da,731.0,2388703569478,329000,340000,11000,3,0,do-choi-me-be
277224672,Ghế gội đầu cỡ đại và trung cho bé gái Hồng & xanh lá - cho bé trai Xanh lá & và xanh dương,28.0,7267302046668,125000,125000,0,0,6,do-choi-me-be
276493282,Thực phẩm bổ sung Anlene Heart Plus với dưỡng chất chăm sóc sức khỏe tim mạch 750g/lon - Tặng máy massage cầm tay,46.0,2635907850779,619000,890000,271000,30,3,do-choi-me-be
276471702,Sữa Bột Friso Gold 4 Hộp Giấy 3.2kg (Dành Cho Trẻ Từ 2 - 6 Tuổi),24.0,5460667641914,1270000,1690000,420000,25,2,do-choi-me-be
276471365,[TẶNG THÊM 6 MIẾNG] Tã quần Bobby Siêu Khô Thoáng - 100% Thoáng Khí Ultra Jumbo,6.0,6190554492013,345000,442400,97400,22,0,do-choi-me-be
276365414,Combo 3 lon sữa Morinaga số 1 Hagukumi + 1 lon sữa Morinaga cùng loại,68.0,6251145209320,1635000,1635000,0,0,11,do-choi-me-be
275290159,"Máy đọc thẻ song ngữ Anh Việt, Máy đọc thẻ tiếng Anh loại 255 thẻ Flashcard 510 từ vựng",14.0,4552674918303,155000,155000,0,0,0,do-choi-me-be
275164004,Đồ chơi BÓP BÓP lòi mắt xả giảm STRESS căng thẳng cho nam nữ độc lạ,11.0,3005721540170,24000,33000,9000,27,0,do-choi-me-be
275123513,Tã Dán Cao Cấp Moony Nhật Bản M56 +8,39.0,6526022371222,290000,475000,185000,39,2,do-choi-me-be
274969365,Sản phẩm dinh dưỡng công thức Meiji Infant Formula 800g (Dành cho trẻ từ 0-1 tuổi),132.0,2903871170301,485000,485000,0,0,10,do-choi-me-be
274932063,"Ty Ngậm Dạ Quang Tommee Tippee Night Time Cho Bé 0-6, 6-18, 18-36 Tháng (Vỉ Đôi)",8.0,2045590001595,239700,255000,15300,6,2,do-choi-me-be
274402448,Tã quần Huggies Skin Perfect XL Super Jumbo 52+6 miếng với 2 vùng thấm giảm kích ứng da,1177.0,5239156884666,329000,473130,144130,30,1,do-choi-me-be
273266800,Sữa bột UC2 GROW PLUS 0+ lon 800G (dành cho trẻ suy dinh dưỡng),24.0,6366052880108,375000,375000,0,0,1,do-choi-me-be
272443190,"Bộ Đất Nặn 3D Deli 12/24 Màu - Đất Sét Nặn An Toàn, Không Dính Tay, Kèm Phụ Kiện Khuôn Nặn Cho Bé",69.0,3533344897066,45000,81000,36000,44,5,do-choi-me-be
272217375,Combo 6 Khăn ướt em bé UniDry Baby WTP - 80 miếng,37.0,2788722126748,140000,209130,69130,33,3,do-choi-me-be
271329976,Sữa bột công thức S-26 ULTIMA 1 350G với hợp chất NUTRILEARN CONNECT cho bé 0 - 12 tháng tuổi,510.0,5755740405947,339000,339000,0,0,16,do-choi-me-be
270876453,Đai đi xe máy cho bé cao cấp Chính Hãng Vinanoi LOẠI CÓ VAI ĐEO,39.0,5941500123048,76000,150000,74000,49,3,do-choi-me-be
213841943,Combo 2 Tã quần Merries Goodskin đủ size M50/L44/XL38/XXL28,37.0,1310023990069,680000,680000,0,0,3,do-choi-me-be
213752752,Combo 3 Tã quần Merries Goodskin đủ size M50/L44/XL38/XXL28,29.0,9265316824025,1020000,1020000,0,0,2,do-choi-me-be
203219000,"Sữa Cho Trẻ Biếng Ăn, Nhẹ Cân 1-10 Tuổi ETOMIL KID AZ 900G – Sữa Công Thức Tăng Cân, Tăng Chiều Cao – Hộp 900gr",43.0,4770747710403,493000,493000,0,0,3,do-choi-me-be
197714858,Bình sữa Pigeon PP Plus thế hệ III 160ml/240ml/330ml,161.0,2136232745257,234000,288000,54000,19,17,do-choi-me-be
168561882,Tã quần Bobby có đệm lưng thấm mồ hôi đủ size M/L/XL/XXL,362.0,5476684945603,449000,449000,0,0,75,do-choi-me-be
154703056,"Áo yếm máng dài tay Cotton chống thấm nước cho bé tập ăn, tập vẽ Mastela",178.0,6010107355019,90000,90000,0,0,8,do-choi-me-be
154702657,Xe đẩy gấp gọn cho bé Mastela A2 - Xe đẩy em bé khung Aluminum cao cấp siêu nhẹ và bền bảo hành 12 tháng,106.0,5851653881652,1530000,1530000,0,0,34,do-choi-me-be
129665687,(HCM) Tã quần người già Caryn size M gói lớn 32 miếng siêu tiết kiệm,139.0,7068502019944,365000,365000,0,0,14,do-choi-me-be
79008843,[COMBO 6 GÓI] KHĂN VẢI KHÔ ĐA NĂNG AIKO 270 TỜ/ GÓI,24.0,1532823916923,205000,205000,0,0,6,do-choi-me-be
70340831,Sữa Bột Vitadairy COLOSBABY BIO GOLD 1+ 800g,22.0,1843098916094,490000,490000,0,0,2,do-choi-me-be
57516996,Lá xô thơm (white sage hay sage trắng),289.0,2391007885744,125000,125000,0,0,41,do-choi-me-be
55102682,Bàn xây dựng đa năng 2020,244.0,9209313704815,980000,980000,0,0,86,do-choi-me-be
55081448,Bộ tranh xếp hình 150 mảnh – Hệ Mặt Trời ,184.0,9024792145023,45000,65000,20000,31,40,do-choi-me-be
25769067,Cờ Vua Nam Châm Cỡ Lớn miDoctor 4812A,1577.0,4806831698708,175000,175000,0,0,428,do-choi-me-be
25026925,Combo 2 Gói Tã Quần Người Lớn Sunmate Khô Thoáng M8 (8 Miếng/ Gói),0.0,4786629748412,180200,180200,0,0,0,do-choi-me-be
17463773,"Sữa bột Nutricare Gastro dinh dưỡng y học cho người viêm dạ dày, rối loạn tiêu hoá (900g)",362.0,2734372371045,485000,485000,0,0,39,do-choi-me-be
14536554,"Bộ 10 tấm Thảm xốp cho bé ECOBABY, thảm xốp đạt tiêu chuẩn Mỹ và Châu Âu -  kích thước 1 tấm 30x30cm, độ dày khoảng 1cm - Hình học",213.0,2260418003101,95900,123370,27470,22,30,do-choi-me-be
7248879,Bột Men Vi Sinh Xử Lý Hầm Cầu SiFa Bio Fast (300gr),899.0,5645884444356,39900,39900,0,0,54,do-choi-me-be
5448935,"Sữa bột Nutricare Gold Mới phục hồi bồi bổ cơ thể (400g, 900g)",289.0,7904723985503,435000,435000,0,0,32,do-choi-me-be
1000532,Sữa Bột Anlene Gold Movepro Hương Chocolate (Hộp Giấy 440g),3301.0,3707448644656,199000,235000,36000,15,172,do-choi-me-be
820405,Sữa Tắm Gội Toàn Thân Cetaphil Baby 2 In 1 (230ml),4872.0,6230270841445,170000,170000,0,0,451,do-choi-me-be
435870,Thực Phẩm Dinh Dưỡng Y Học: Ensure Gold Vani 850g,888.0,8006426668062,890000,890000,0,0,51,do-choi-me-be
277561712,[TẶNG KÈM 4 MIẾNG] Tã quần Bobby Siêu Khô Thoáng - 100% Thoáng Khí Mega Jumbo - L96,2.0,7653637535313,595500,595500,0,0,0,do-choi-me-be
276527729,TẤM ĐỆM LÓT SIÊU THẤM CARYN 20 MIẾNG,414.0,7059004459297,65000,65000,0,0,24,do-choi-me-be
276364131,Sữa Morinaga Số 3 Hương Vani - Kodomil dành cho bé trên 36 tháng tuổi,406.0,8240878891083,469000,551000,82000,15,35,do-choi-me-be
276176653,Kem đánh răng Colgate trẻ em hương dâu 40g - Kỳ Lân/Khủng Long - Giao ngẫu nhiên,24.0,4328028190791,9000,11700,2700,23,2,do-choi-me-be
276175375,"Nước giặt quần áo em bé D-nee 3000 ML - Dnee Sweet Dream (Smile Booster Series) hương thơm dịu nhẹ, an toàn cho trẻ em",6.0,9178042092336,205000,205000,0,0,0,do-choi-me-be
276149992,Nước Xả Quần Áo Cho Bé D-nee,1797.0,6498270010599,209000,245000,36000,15,63,do-choi-me-be
275722410,Dây đai an toàn cho trẻ khi đi xe máy - mẫu giao ngẫu nhiên,8.0,9841849110073,180000,180000,0,0,1,do-choi-me-be
275428279,Combo 2 Bộ Đệm Lót Đầu Gối Cho Bé Tập Bò - Hàng chính hãng (giao màu ngẫu nhiên),3.0,2044008542292,49000,98000,49000,50,0,do-choi-me-be
275220800,Tã quần người lớn Confidence Slim&Fit mỏng nhẹ vừa vặn size M gói 16+2 miếng,61.0,7243097763236,150000,249000,99000,40,3,do-choi-me-be
274167988,Combo 2 Hộp Sản Phẩm Dinh Dưỡng Công Thức Meiji Growing Up Formula EZcube - Nhập khẩu chính hãng (560g),19.0,9476685531022,810982,810982,0,0,1,do-choi-me-be
273768890,"Đồ chơi búp bê Elsa, Set búp bê chi em cỡ lớn, Búp Bê Barbie Công Chúa Elsa Kèm Nhiều Phụ Kiện - Hộp Quà Tặng Bé Gái",5.0,6769624914290,265000,265000,0,0,0,do-choi-me-be
273612599,[Mẫu mới] Tã dán Unidry G3X Supreme sơ sinh Newborn mới - 40 miếng,10.0,6053449166400,86000,134700,48700,36,0,do-choi-me-be
273562898,Nước Giặt Orita Concentrated Laundry Detergent 550ml,23.0,7123591784971,85000,85000,0,0,2,do-choi-me-be
273184061,Tã dán cao cấp Moony S84/M64/L54 - Nhập Khẩu Chính Hãng,21.0,1240935178101,273890,273890,0,0,0,do-choi-me-be
271378603,"Sữa bột CaloSure America+ lon 800g - Tăng cường miễn dịch và sức khoẻ tim mạch, Bữa ăn bổ sung hợp lý cho người bệnh tiểu đường",6.0,4711257173117,578000,578000,0,0,0,do-choi-me-be
269983548,Đai địu cho trẻ em bé 1 2 3 tuổi ngồi đi xe máy an toàn MySun,9.0,2750184158751,179000,250000,71000,28,1,do-choi-me-be
261996369,Tã dán Huggies Skincare Super Jumbo L68,265.0,2968033170377,280000,388700,108700,28,8,do-choi-me-be
254896872,Bộ Thẻ Ziczac - Decal - Flashcard Kích Thích Thị Giác Trí Não Cho Trẻ Sơ Sinh - Lalala Baby,20.0,6513392741863,30000,30000,0,0,2,do-choi-me-be
253620477,Sách Vải Song Ngữ Lalala baby Đa Giác Quan Cho Bé Sơ Sinh Size Mini 11x12cm - (0-12 tháng),38.0,9058825877953,22900,36000,13100,36,0,do-choi-me-be
252105964,Đồ Chơi Xếp Hình Nam Châm 64 Chi Tiết Freeship Nam Châm Xếp Hình Thông Minh - Đồ Chơi Giáo Dục Cho Bé - Đồ Chơi Trẻ Em HT SYS,47.0,4296468666250,188000,188000,0,0,4,do-choi-me-be
250080718,"Cờ tướng bằng gỗ tự nhiên - 40 x 35 cm - Quân đường kính 3,4cm - Chính hãng dododios",5.0,9688467585846,254000,254000,0,0,1,do-choi-me-be
248741673,Bình ống hút AXSTARS Richell Nhật Bản 200ml chống sặc cho bé từ 6 tháng | Baby,5.0,1492384652704,342655,342655,0,0,0,do-choi-me-be
214936838,Bộ đồ chơi trẻ em mô hình động vật 58 chi tiết thú rừng hoang dã nhựa an toàn giúp bé nhận biết thế giới xung quanh,4.0,9185228864230,205000,205000,0,0,2,do-choi-me-be
208307385,"Kem Đánh Răng Chicco Dành Cho Trẻ Em Hương Dâu (1-5 tuổi), Hương Chuối Táo (6 - 24 tháng) Dung Tích 50ml",81.0,4179025202442,175000,175000,0,0,7,do-choi-me-be
193098971,Đũa tập ăn xỏ ngón cho bé tập gắp Richell Nhật Bản | Baby,4.0,5388844121941,129000,129000,0,0,1,do-choi-me-be
190194625,[Kèm Video] Mắt Kính Trẻ Em SiPU Chính Hãng MK17 Chống Ánh Sáng Xanh + Chống gãy - Bé Trai Bé Gái (Kèm Hộp Ô Tô),20.0,1447950863311,189000,189000,0,0,3,do-choi-me-be
186435777,"Máy đọc thẻ song ngữ tiếng Việt và tiếng Anh, máy đọc thẻ song ngữ gồm 112 thẻ, 225 thẻ, máy đọc thẻ Tuệ Minh",4.0,5585186126200,75000,75000,0,0,2,do-choi-me-be
185967589,Xe Trượt Scooter Bằng Nhựa Cho Bé,3.0,1073894552997,125000,125000,0,0,0,do-choi-me-be
183896202,Tấm lót chống thấm cho người già LONGLIFE size 70x100cm,62.0,4259432545381,349000,349000,0,0,9,do-choi-me-be
164226301,Đồ Chơi Vô Lăng Xe Hơi Kèm Âm Thanh Cho Bé - Hàng Loại 1 - Chính Hãng MINIIN,14.0,2522143316186,199000,199000,0,0,5,do-choi-me-be
126022179,Tã Bỉm Dán/Quần YOULI XANH Đủ Size S56/M48/M44/L42/XL40/XXL36/XXXL34,108.0,5320070512325,125000,125000,0,0,23,do-choi-me-be
122911154,"Sữa Nhật Cho Bé Tăng Cân Từ 0 Đến 1 Tuổi Meiji Hỗ Trợ Tăng Hệ Miễn Dịch, Tạo Hệ Tiêu Hóa Tốt Hấp Thụ Dưỡng Chất Hiệu Quả Giúp Bé Phát Triển Cân Đối Nhất Cả Về Chiều Cao, Cân Nặng, Trí Não - 1 Hộp",11.0,4774879351851,585000,585000,0,0,1,do-choi-me-be
122712052,Sữa bột Vinamilk Dielac Grow Plus 1+ Hộp thiếc 850g (Sữa Non),7.0,6724547458648,385000,385000,0,0,3,do-choi-me-be
110308330,Sữa bột Nutricare Bone phòng chống loãng xương sụn khớp cho người lớn tuổi (850g),111.0,8309269538485,435928,435928,0,0,16,do-choi-me-be
59143353,Combo Tiết Kiệm: 6 Gói Khăn Ướt Bobby Care Không Hương 100 Miếng/Gói,157.0,1627779549081,235000,235000,0,0,20,do-choi-me-be
42824798,"Gói Bột Tẩy Rửa, Vệ Sinh Lồng Máy Giặt - Nội Địa Nhật",13.0,5111321305844,32500,32500,0,0,1,do-choi-me-be
24448316,Nước rửa bình sữa D-nee Mild & Care chai 500ml,807.0,9629274152171,72000,72000,0,0,166,do-choi-me-be
4748469,Boardgame Lớp Học Mật Ngữ - Cuộc Đua Sao Chổi ,1064.0,9473447969819,413100,459000,45900,10,130,do-choi-me-be
1744997,Tã Dán Siêu Thấm Caryn Gói Siêu Lớn M20 (20 Miếng),13428.0,5123774814323,180000,203800,23800,12,390,do-choi-me-be
1549545,Nước Giặt Arau Baby Túi (720ml) ,74.0,3665589862233,125000,125000,0,0,7,do-choi-me-be
277938067,Combo 02 Sữa Bột Anlene Gold 3X Hương Vanilla (Hộp thiếc 800g),359.0,5618756370270,809000,943000,134000,14,33,do-choi-me-be
276347416,"[1 Gói] 6 Quần Lót Cotton NARIS Dùng 1 Lần Mềm Mại, Mỏng, Thoáng Cho Mẹ Sau Sinh/ Phụ Nữ - Hàng Đẹp (katydang)",10.0,6953517103932,29000,29000,0,0,0,do-choi-me-be
276223540,"Combo 50 và 100 cái kẹo bóc quà bất ngờ cho bé,Túi mù hình con vật và đồ ăn làm quà tặng cho bé.",41.0,7576098355057,95000,95000,0,0,4,do-choi-me-be
276161372,Bộ 2 núm ti Dr.Brown's bình sữa cổ thường Số 2 (3 - 6 tháng),5.0,6814317502762,141000,169000,28000,17,1,do-choi-me-be
276129236,Combo Khăn Ướt Em Bé NUNA Không Mùi 30 Miếng/Bao,28.0,6463218817055,36000,45000,9000,20,1,do-choi-me-be
276030663,"Bình Sữa PPSU Ty Siêu Mềm Tự Nhiên Tommee Tippee 150ml, Núm Ty Của Bình 0-3 Tháng, Họa Tiết",6.0,8990933425027,288000,385000,97000,25,1,do-choi-me-be
275845926,"Gấu Bông Thỏ Trái Cây Siêu Mềm Mịn Siêu Đáng Yêu (25cm---->60cm) Vải Miniso 4 Chiều Mềm Mại Êm Ái, An Toàn Cho Người Sử Dụng",1.0,6181611212228,69000,69000,0,0,0,do-choi-me-be
275657925,Nature's Way Kids Smart VITA GUMMIES ( VITAMIN/ VEGIES) - Vitamin Tổng Hợp (60 viên/ Lọ),6.0,8057325210449,119400,398000,278600,70,2,do-choi-me-be
275498150,Thực Phẩm Bổ Sung Bánh Ăn Dặm Gerber Lil's Crunchies vị Rau Củ 42g dành cho trẻ trên 8 tháng tuổi,32.0,8192876464303,107000,119300,12300,10,4,do-choi-me-be
275498148,Thực Phẩm Bổ Sung Bánh Ăn Dặm Gerber Puffs vị Việt Quất 42g dành cho trẻ trên 8 tháng tuổi,36.0,7399465094557,89100,108300,19200,18,6,do-choi-me-be
275271537,"Xe trượt 3 bánh scooter bằng sắt cho bé, bánh xe phát sáng khi chạy",3.0,8786094699627,280000,280000,0,0,0,do-choi-me-be
274986614,Combo 2 - Tã dán người lớn SunMate mới size M10/L10/XL10,22.0,7087083996673,210110,210110,0,0,2,do-choi-me-be
274771247,"Thảm Nhạc Cho Bé Sơ Sinh, Thảm Đàn Piano Cho Bé, Thảm Đồ Chơi Cho Bé, Hình Thù Ngộ Nghĩnh Nhiều Màu - Hàng Nhập Khẩu",11.0,4684429961685,188000,188000,0,0,1,do-choi-me-be
274498133,Sữa Tắm/Gội Pigeon Jojoba / Hoa Hướng Dương 200ml - Bao bì mới 2024,35.0,2259822767152,78000,92000,14000,15,1,do-choi-me-be
273792361,Gậy cho người già chống trượt có đèn Led,102.0,7978431266811,199000,199000,0,0,8,do-choi-me-be
273646599,Đồ Chơi Búp Bê VDORA Có Âm Thanh Cho Bé Gái từ 3 Tuổi (Nhiều loại lựa chọn),11.0,4288395454714,129000,169000,40000,24,1,do-choi-me-be
273612613,[Mẫu mới] Tã quần Unidry G3X Supreme siêu mỏng size XXXL - 22+6 miếng,22.0,9804141059225,160000,216491,56491,26,4,do-choi-me-be
273523434,Sữa bột Anlene Gold 5X hộp giấy 1.2kg,50.0,7271595453884,530000,530000,0,0,4,do-choi-me-be
273517695,Đồ chơi súng nhựa lục ngắn bằng nhựa cho bé có đèn nhạc phát sáng giá rẻ tặng PIN AA,9.0,7461404140526,75000,100000,25000,25,0,do-choi-me-be
273309550,[Mẫu mới] Combo 2 Tã quần SunMate siêu khô thoáng G1 mới size L-14+2 miếng,161.0,7052944867262,350000,377018,27018,7,1,do-choi-me-be
205245912,Combo 6 Gói Tã quần Sunmate L8 Siêu Mềm Mại - Tã Quần Người Lớn - Date luôn mới,13.0,2545423156524,486000,486000,0,0,0,do-choi-me-be
196381756,"Thông tắc bồn cầu toilet siêu tốc 5 phút SIFA 999 700ml, 800ml, 1400ml, 1600ml chống hôi khử khuẩn",22.0,1159356142699,81000,81000,0,0,0,do-choi-me-be
184860970,Nước Giặt Quần Áo Cho Bé D-nee - Chai 3000ml (Tím),35.0,4390504079369,205000,205000,0,0,4,do-choi-me-be
172427438,"Túi xách bỉm sữa mẹ và bé UMOO kèm dây đeo chéo chất liệu vải dệt chống nước Mang cả thế giới bên mình vẫn gọn gàng, tươm tất ",11.0,7372958786289,437000,525600,88600,17,0,do-choi-me-be
167469632,"Cuộn Dây Bọc Biển Bọc Cạnh Bàn Chống Va Đập , Bịt Góc Bàn , Ghế , Tủ , Gường PaKaSa - Hàng Chính Hãng ",90.0,8261381095107,69000,138000,69000,50,7,do-choi-me-be
152447477,"Thảm xốp XPE cho bé dày 1,5cm của Umoo",7.0,9149084876491,488000,488999,999,0,2,do-choi-me-be
138076850,[COMBO] Ngũ Cốc Dinh Dưỡng Bầu 29 hạt _ Lợi Sữa Cao Cấp Min Min _ Ngũ Cốc Lợi Sữa Min Min 29 Hạt và 30 Hạt,22.0,4824415527110,195000,195000,0,0,8,do-choi-me-be
107995394,Bộ 2 Bình sữa mô phỏng tự nhiên hiệu Philips Avent (125 ml) cho trẻ từ 0 tháng tuổi 690.23,3.0,3545561249447,475000,485000,10000,2,0,do-choi-me-be
84575971,Vòng dâu tằm 7 và 9 bi bạc cho bé,30.0,5517634868174,79000,79000,0,0,7,do-choi-me-be
62829699,Bộ tranh xếp hình cao cấp 500 mảnh ghép – Thái Dương Hệ (40x50cm),161.0,8160054803704,115000,150000,35000,23,24,do-choi-me-be
57933293,Hộp 8 bộ đồ chơi lắp ráp Biệt đội cứu hỏa vòi rồng 8in1 Qman 1805 (313 chi tiết),293.0,2962697977738,209000,256000,47000,18,67,do-choi-me-be
54028973,Baby Rock Star - Trống bốn điệu nhạc,15.0,6813732909411,84700,110000,25300,23,2,do-choi-me-be
52178168,"Gối cho bé bú kê tay Rototo Bebe - Gối bú sữa giúp bố, mẹ đỡ mỏi tay",13.0,9278216646829,520000,520000,0,0,0,do-choi-me-be
46911328,Sữa bột Calokid Gold 2+ 900g,119.0,2901443294279,430000,430000,0,0,14,do-choi-me-be
17602936,"Bộ 4 Khoá Chặn Cửa Tủ , Tủ Lạnh Bảo Vệ An Toàn Cho Bé Milliken NL-3021 - Màu Ngẫu Nhiên",815.0,1899181988653,54000,54000,0,0,131,do-choi-me-be
17462885,"Sữa bột Nutricare Gastro dinh dưỡng y học cho người viêm dạ dày, rối loạn tiêu hoá (400g)",519.0,2847461755173,280000,280000,0,0,54,do-choi-me-be
2791853,"Kem nghệ tươi dưỡng da trắng mịn, sạch sạm nám Wonmom 50g",611.0,9094448635208,220000,310000,90000,29,71,do-choi-me-be
1000538,Sữa Bột Anlene Gold Movepro 3X Hương Vanilla (Hộp Thiếc 400g),1105.0,3707043119085,209000,235000,26000,11,79,do-choi-me-be
755394,Cờ Domino Ngà Lớn Liên Hiệp Thành KDNL,997.0,1161159898203,86000,86000,0,0,102,do-choi-me-be
474634,Tã Dán Bobby Siêu Mỏng Thấm Gói Siêu Lớn L68 (68 Miếng),44.0,8107578233068,280000,280000,0,0,7,do-choi-me-be
277728667,Bộ Sạc Siêu Nhanh 2.0 Type C 45W dành cho Samsung S20/S21/S22/S23/S24/S25 Ultra Note 10/20 Plus và các dòng điện thoại cổng C,12.0,7551336784692,59000,59000,0,0,3,thiet-bi-kts-phu-kien-so
276257753,Củ sạc Choetech PD5009 du lịch đa năng công suất cao 65W (2 USB C+ 1 USB A)  (Hàng chính hãng),0.0,7094771737934,1099000,1099000,0,0,0,thiet-bi-kts-phu-kien-so
227746564,"Kính Cường Lực KingKong Có Khung Tự Dán, Ngăn Bụi Loa Dành Cho iPhone - Full Hộp, Dán Full Màn - Hàng Chính Hãng",153.0,4607134216136,104999,138597,33598,24,30,thiet-bi-kts-phu-kien-so
273217833,Tai nghe nhét tai jack cắm Type-C có mic hoco. M101 Pro tương thích rộng với các máy Android chân Type C và cho Iphone 15 Ipad Chân Type C  - Hàng chính hãng,275.0,7990404206087,89000,169000,80000,47,25,thiet-bi-kts-phu-kien-so
195300846,Cáp Sạc ANKER Powerline+ II USB-C To USB-C Phiên Bản Marvel - A9547 / A9549 - Hàng Chính Hãng,670.0,8278259790819,170000,300000,130000,43,106,thiet-bi-kts-phu-kien-so
276799691,Tai nghe Bluetooth True Wireless Realme Buds T300 Âm Thanh Không Gian 360° - Hàng chính hãng,38.0,3971543009708,491000,990000,499000,50,5,thiet-bi-kts-phu-kien-so
276117054,Tai nghe Bluetooth Apple AirPods 4,393.0,5930065364186,3190000,4990000,1800000,36,61,thiet-bi-kts-phu-kien-so
274990556,Chuột không dây LOGITECH M331 Cổng USB - Hàng chính hãng ,357.0,6880091677758,339000,339000,0,0,34,thiet-bi-kts-phu-kien-so
274544706,"Giá đỡ laptop di động GL1x01 đế tản nhiệt cho Laptop, kê laptop Mac tiện lợi - Hàng chính hãng",412.0,2896034995311,77000,125000,48000,38,27,thiet-bi-kts-phu-kien-so
273831862,Dây HDMI FIRO ATMOS - Cáp HDMI 2.1 8K/60Hz/48Gbps - Dài 2M Lõi Dù Dùng Cho Tivi/ Máy Tính/ Playstation - Hàng Chính Hãng,108.0,8226594284445,175000,339000,164000,48,16,thiet-bi-kts-phu-kien-so
273217798,"Tai Nghe có dây nhét tai M101 Pro 3.5mm âm thanh hay, chống ồn, hỗ trợ mic nghe gọi đầy đủ dây dài 1.2m - Hàng Chính Hãng",344.0,6599546476695,89000,139000,50000,36,30,thiet-bi-kts-phu-kien-so
276018348,Củ sạc Choetech PD5020 du lịch đa năng (35W)/ PD5021 (45W)/ PD5022 (70W)- hàng chính hãng,1.0,4878346309677,719000,719000,0,0,0,thiet-bi-kts-phu-kien-so
142439870,Cáp sạc Baseus Cafule sạc nhanh dùng cho iPhone - Hàng chính hãng,3269.0,7712347894123,69000,79000,10000,13,517,thiet-bi-kts-phu-kien-so
276175506,Củ sạc Choetech PD6051 nhanh 2 cổng PD 35W  có màn hình LED hiển thì thông số sạc (hàng chính hãng),1.0,7447648390993,399000,399000,0,0,0,thiet-bi-kts-phu-kien-so
274467128,Tai Nghe Bluetooth Nhét Tai Không Dây FIRO A18 - Pin Dock Sạc 300mAh - Bluetooth V5.3 - Tai Nghe FIRO A18 Điều Khiển Cảm Ứng Thông Minh - Công Nghệ Kháng Nước IPX5 - Tai Nghe Không Dây FIRO A18 - Phù Hợp Với Tất Cả Dòng Máy - Hàng Chính Hãng,752.0,2225707702817,365000,699000,334000,48,323,thiet-bi-kts-phu-kien-so
273393456,Dây Đeo Thay Thế Dành Cho Vòng Đeo Tay Thông Minh Xiaomi MiBand 8/ Miband 9 Ngàm Thép Chắc Chắn_ Hàng Chính Hãng,83.0,4765289130198,59000,59000,0,0,5,thiet-bi-kts-phu-kien-so
273271786,Hub chuyển đổi USB Type-C Sang USB 3.0/HDMI/Type C - Hub chuyển đổi 3in1 RiBi - Hàng Chính Hãng,95.0,9546449332170,145000,199000,54000,27,5,thiet-bi-kts-phu-kien-so
272030678,Tai Nghe Bluetooth Cao Cấp EQ2 5.3 Pin 7h Âm Thanh Sống Động Bass căng - Hàng Chính Hãng,732.0,9453454090803,299000,299000,0,0,141,thiet-bi-kts-phu-kien-so
135284107,Headphone Tai Nghe Chụp Tai bluetooth Rockspace O2 kết nối không dây có mic nghe nhạc liên tục 15h - Hàng chính hãng bảo hành 12 tháng,946.0,8918158075067,455000,559000,104000,19,231,thiet-bi-kts-phu-kien-so
181185263,Tai Nghe Baseus Encok 3.5mm lateral in-ear Wired Earphone H17 - Hàng Chính Hãng,64.0,8508241936421,155000,249000,94000,38,7,thiet-bi-kts-phu-kien-so
271995193,"Tai Nghe Bluetooth Không Dây Cao Cấp EQ1 Pin 7H Âm Thanh Sống Động Bass Chắc Cảm Ứng, Có Mic Đèn Led Sang Trọng - Hàng Chính Hãng",691.0,4447932338199,329000,329000,0,0,125,thiet-bi-kts-phu-kien-so
275771254,"Cáp Sạc Nhanh USB Type C to Type C PD 100W - Dây Cáp Dữ Liệu FIRO USB 3.2 Gen2, Sạc Nhanh PD 100W, Truyền Dữ Liệu 20Gbps, Video 8K60Hz - 20V@5A PD100W/8K60Hz/20Gbps - Dài 2 Mét - Dùng Cho iPhone 15 Series, Macbook, Laptop, Smartphone - Hàng Chính Hãng",68.0,6168756484817,175000,339000,164000,48,4,thiet-bi-kts-phu-kien-so
272420302,"Cáp sạc thay thế cho các dòng đồng hồ Garmin Fenix 7, Fenix 6, Fenix 5, Forerunner 955, 945, 935, 245, 265, 255, 45, 645, Instinct, Viviactive 3, Venu/ Garmin Epix Gen 2- Hàng Chính Hãng",763.0,8158707989596,75000,75000,0,0,53,thiet-bi-kts-phu-kien-so
270747030,Cáp sạc USB to IP Remax RC-152i chiều dài 1m sạc 2.4A và truyền dữ liệu đồng thời 480MB/s có đèn tiện lợi - Hàng chính hãng,507.0,8285573506497,99000,150000,51000,34,67,thiet-bi-kts-phu-kien-so
263433314,"Hub Type-C To HDMI FIRO 6in1 Chuẩn HDTV - Hub Chuyển Đổi Type-C Chia 6 Cổng - 1 Cổng HDMI/HDTV 4K, 2 Cổng USB 3.0, 2 Khe Đọc Thẻ TF Và SD, 1 Cổng Sạc Nhanh Type C PD - Kết Nối Tốc Độ Cao - Dùng Cho Smartphone/Laptop/PC/Tivi/Playstation – Hàng Chính Hãng",993.0,3481330963860,299000,579000,280000,48,101,thiet-bi-kts-phu-kien-so
253358703,Thẻ Nhớ microSD SanDisk Ultra A1 150MB/s 512GB - Hàng Nhập Khẩu,147.0,3452429660279,790000,790000,0,0,20,thiet-bi-kts-phu-kien-so
251518027,Cáp sạc và truyền dữ liệu cho IP Remax RC-138i - Hàng chính hãng,4.0,5127662251023,49499,54999,5500,10,0,thiet-bi-kts-phu-kien-so
217474954,Ốp Lưng Silicone TPU Trong Suốt GOR Dành Cho Samsung Galaxy S23 Ultra / S23 Plus / S23 - Hàng Chính Hãng,31.0,7484974180061,69000,69000,0,0,3,thiet-bi-kts-phu-kien-so
213701520,"Miếng Lót Chuột Da Kai.N Mouse Pad Leather, Chống Thấm, Da Mềm, Siêu Mịn, Size 270x210mm_ Hàng Chính Hãng",495.0,6069085014558,49000,49000,0,0,40,thiet-bi-kts-phu-kien-so
192977208,Đồng hồ Thông minh Chống nước IP67 Dành cho Trẻ em nhuẩn AMA Watch Q16S Hàng chính hãng ,534.0,5312995340585,395000,395000,0,0,104,thiet-bi-kts-phu-kien-so
187118836,Bộ 2 miếng kính cường lực Gor cho iPhone 13 Mini / 13 / 13 Pro / 13 Pro Max - Full Box - Gor - Hàng chính hãng,53.0,6270258919625,149000,149000,0,0,9,thiet-bi-kts-phu-kien-so
177334663,Thẻ Nhớ Micro SDXC SanDisk UHS-1 128GB Class 10 100MB/s - Hàng Chính Hãng,954.0,4750316926018,241000,480000,239000,50,139,thiet-bi-kts-phu-kien-so
174599595,"Chuột game có dây Logitech G203 Lightsync - Tùy chỉnh RGB, 6 nút lập trình, nhẹ, 8000 DPI, PC/Mac - Hàng chính hãng",452.0,5541752365576,399000,399000,0,0,118,thiet-bi-kts-phu-kien-so
162772687,Chuột không dây Logitech SIGNATURE M650 Wireless/Bluetooth - Hàng Chính Hãng,22.0,6718492473078,619000,619000,0,0,2,thiet-bi-kts-phu-kien-so
162028506,Ốp lưng thoát nhiệt dành cho iPhone 11 / 12 / 13 / 11 Pro / 12 Pro / 13 Pro / 11 Pro Max / 12 Pro Max / 13 Pro Max / 12 Mini / 13 Mini - Hàng chính hãng,559.0,3743494144065,59000,99000,40000,40,121,thiet-bi-kts-phu-kien-so
158868703,[MIỄN PHÍ 1 NĂM] SIM MAX DATA 4G VIETNAMOBILE 7GB/Ngày + FREE Gọi Nội Mạng. Trọn Gói 12 Tháng Không Cần Nạp Tiền - Hàng Chính Hãng,2899.0,3327326776704,396000,650000,254000,39,437,thiet-bi-kts-phu-kien-so
130172342,Cáp sạc nhanh siêu bền IP 20W Baseus Superior Series Fast Charging Data Cable Type-C to iP PD (480Mbps)-Hỗ trợ sạc nhanh PD 20W dành cho iPhone 12 / PD 18W dành cho iP11/ iP XS Max- Hàng chính hãng,1243.0,3161265138260,79999,79999,0,0,221,thiet-bi-kts-phu-kien-so
123836523,Adapter Sạc 1 Cổng USB Type-C 20W Apple,11331.0,9189782407730,420000,790000,370000,47,3182,thiet-bi-kts-phu-kien-so
80857582,Kính Cường Lực Chống Nhìn Trộm KingKong Dành Cho iPhone - Full Hộp - Dán Full Màn - Hàng Chính Hãng ,384.0,5277466755487,47000,47000,0,0,39,thiet-bi-kts-phu-kien-so
77558147,Giá Đỡ Điện Thoại Ô Tô Xe Hơi Hợp Kim Nhôm Hàng Không – Tự Động – Thông Minh - Xoay Chuyển Đa Góc Độ -– Mini Hàng Chính Hãng ,280.0,1945444735996,599000,599000,0,0,88,thiet-bi-kts-phu-kien-so
72636913,Jack chuyển Type C to 3.5 chính hãng Baseus chính hãng,330.0,4134679608772,109000,129000,20000,16,56,thiet-bi-kts-phu-kien-so
17533229,Bao Da Smart Case Gen2 TPU Dành Cho iPad Mini 5 - Hàng nhập khẩu,824.0,9125734030916,85000,170000,85000,50,200,thiet-bi-kts-phu-kien-so
6509837,Dây cáp kết nối VGA HDB 15 đực sang HDB 15 đực dài 1.5M UGREEN VG101 11630 - Hàng chính hãng,424.0,5006323689446,94100,120000,25900,22,94,thiet-bi-kts-phu-kien-so
536965,Tai nghe chụp tai Logitech H111 - Hàng chính hãng,291.0,6503600761257,243000,243000,0,0,64,thiet-bi-kts-phu-kien-so
299461,Chuột Không Dây Logitech M331 Silent - Hàng Chính Hãng,9982.0,6706057278594,349000,349000,0,0,2186,thiet-bi-kts-phu-kien-so
277004702,"Cáp DisplayPort FIRO - Dây DisplayPort 1.4 8K/60Hz/32,4Gbps - Dây Cáp DP to DP - Dài 3M Lõi Dù Dùng Cho Tivi / Máy Tính / Playstation - Hàng Chính Hãng",12.0,7970130180098,230000,440000,210000,48,1,thiet-bi-kts-phu-kien-so
276827665,Bộ Sạc Nhanh Cho Iphone PD20W Hoco C80/C80A Plus 2 cổng Usb và Type-C kèm dây sạc Type-C sang iPhone 1M Sạc 0-50% Pin trong 30 phút - Hàng chính hãng,837.0,1861584445671,189000,300000,111000,37,146,thiet-bi-kts-phu-kien-so
276782048,Củ Sạc Nhanh Cho Iphone Hoco C80/C80Plus/CS13/CS13A - Hỗ trợ sạc nhanh 20W PD QC3.0 - Hàng Chính Hãng,735.0,4122627316209,129000,199000,70000,35,120,thiet-bi-kts-phu-kien-so
277396725,"Ví Da Kiêm Giá Đỡ Dux Ducis Neva Magnetic Wallet Stand Cho Iphone, 3 Ngăn Đựng Thẻ, Chống Trộm, Hít Mạnh_ Hàng Chính Hãng",1.0,9975941789507,350000,350000,0,0,0,thiet-bi-kts-phu-kien-so
277234896,Ốp lưng trong suốt chống ố vàng UNIQ LIFEPRO XTREME cho Samsung Galaxy S25 Ultra_ Hàng chính hãng,1.0,1539258935829,390000,390000,0,0,0,thiet-bi-kts-phu-kien-so
109455098,Cáp sạc nhanh PD20W truyền dữ liệu Baseus Metal Data Type-C sang iPhone ( 2 size ) - Hàng chính hãng,1418.0,7869578064782,149000,250000,101000,40,156,thiet-bi-kts-phu-kien-so
273834370,Cáp HDMI FIRO ATMOS - Dây HDMI 2.1 8K/60Hz/48Gbps - Dài 2M Lõi Dù Dùng Cho Tivi/ Máy Tính/ Playstation - Hàng Chính Hãng,484.0,4640731302817,175000,339000,164000,48,47,thiet-bi-kts-phu-kien-so
276569271,"Bút Laser, Bút Trình Chiếu Điều Khiển Từ Xa Có Đầu USB Kết Nối Với Máy Tính - Hàng chính hãng",12.0,6987106698978,181000,181000,0,0,1,thiet-bi-kts-phu-kien-so
275402528,Combo kê tay bàn phím và lót chuột da 3D Kai.N Comfortable Bracers chống mỏi cổ tay_ Hàng chính hãng,11.0,5562775910174,299000,299000,0,0,0,thiet-bi-kts-phu-kien-so
275316535,Miếng Lót Chuột Da Kai (Mouse Pad) 2 Mặt 2 Màu 270x210mm - Hàng Chính Hãng ,17.0,7917478411070,45000,45000,0,0,1,thiet-bi-kts-phu-kien-so
275223460,"Cáp sạc và truyền dữ liệu VIVAN VXL100 1M 2.4A - Tương thích với các thiết bị Apple, sạc nhanh, Hàng chính hãng",11.0,2368935451095,69000,69000,0,0,0,thiet-bi-kts-phu-kien-so
275001891,Chuột Văn Phòng Không Dây Logitech M221 - Silent - Hàng Chính Hãng,120.0,3357992939687,222000,222000,0,0,16,thiet-bi-kts-phu-kien-so
272359341,Headphone Tai nghe bluetooth chụp tai không dây chống ồn chủ động ANC ROCKSPACE O3 có mic nghe nhạc 15h hàng chính hãng,143.0,1614250980299,625000,799000,174000,22,22,thiet-bi-kts-phu-kien-so
274184304,Pin sạc dự phòng mini tích hợp dây sạc Rockspace Y11 sạc nhanh 22.5w dung lương 10000mAh - Hàng chính hãng bảo hành 12 tháng,107.0,7221824564319,465000,489000,24000,5,7,thiet-bi-kts-phu-kien-so
275773339,"Cáp Sạc Nhanh USB Type C to Type C PD 240W - Dây Cáp Dữ Liệu FIRO USB4 CABLE - Sạc Nhanh PD 240W, Truyền Dữ Liệu 40Gbps, Video 8K60Hz - 48V@5A PD240W/8K60Hz/40Gbps - Dài 1,5 Mét - Dùng Cho iPhone 15 Series, Macbook, Laptop, Smartphone - Hàng Chính Hãng",84.0,3328036709565,225000,429000,204000,48,6,thiet-bi-kts-phu-kien-so
176752662,"Kính Cường Lực Kingkong iPhone, Màn Nhám Chống Vân Tay Dành Cho Game Thủ - Full Hộp - Hàng Chính Hãng",802.0,5808955118468,115000,115000,0,0,133,thiet-bi-kts-phu-kien-so
275841111,Đồng Hồ Samsung Galaxy Watch7 - Hàng chính hãng,3.0,1074152129758,4750000,7990000,3240000,41,2,thiet-bi-kts-phu-kien-so
274990357,Chuột không dây Logitech B175 - Kết nối USB Receiver - Hàng Chính Hãng,0.0,2115608350552,167000,167000,0,0,6,thiet-bi-kts-phu-kien-so
274667635,"Hub Chuyển Đổi USB Type C ASWEI - 4 in 1, 5 in 1, 6 in 1, 7 in 1, 8 in 1 - HDMI, USB 3.0, PD, SD, TF, RJ45, Audio 3.5mm - Tốc Độ Cao, Hàng Chính Hãng",35.0,7739946158185,118000,227000,109000,48,10,thiet-bi-kts-phu-kien-so
273662105,Ốp lưng trong suốt chống ố dành cho iPhone 12 / 13 / 14 / 15 / 12 Pro / 12 Pro Max / 13 Pro / 13 Pro Max / 14 Plus / 14 Pro / 14 Pro Max / 15 Plus / 15 Pro / 15 Pro Max - Hàng chính hãng,108.0,3746814515306,89000,169000,80000,47,11,thiet-bi-kts-phu-kien-so
273359004,Củ sạc nhanh WP-U128 WEKOME 2 cổng TypeC tổng 40W GANcherger - Hàng chính hãng,6.0,7794722617800,350000,420000,70000,17,0,thiet-bi-kts-phu-kien-so
273150134,Tai nghe Bluetooth Apple AirPods Pro 2 USB-C - MTJV3ZP/A,602.0,8389593678196,5390000,6199000,809000,13,104,thiet-bi-kts-phu-kien-so
271964457,Miếng Dán Cường Lực CHỐNG NHÌN TRỘM Dành Cho iPhone 15/ iPhone 15 Plus/ iPhone 15 Pro/ iPhone 15 ProMax Mipow Kingbull HD ANTI SPY PROTECTOR _ Hàng Chính Hãng,1.0,8251847833747,413999,413999,0,0,0,thiet-bi-kts-phu-kien-so
217291125,"Đế sạc không dây nam châm Kai Magnetic Wireless Charger dùng cho iPhone 14/ 13/ 12 Series (15W, Wireless Magnetic Quick charger) - Hàng chính hãng ",0.0,4035817048940,349999,384998,34999,9,0,thiet-bi-kts-phu-kien-so
203968586,"Power Adapter - Củ Sạc Cho Điện Thoại Android, IOS",334.0,8637751228690,59000,59000,0,0,1,thiet-bi-kts-phu-kien-so
203645556,USB Bluetooth Adapter Dongle Audio Receiver Basues BA04 Tốc Độ Cao Bluetooth 5.0 Hoạt Động Tốt Trong 20m - Hàng Chính Hãng,17.0,5435832940920,139000,139000,0,0,3,thiet-bi-kts-phu-kien-so
195300886,Cáp Sạc ANKER PowerLine+ II USB-C to Lightning - Phiên Bản Marvel - A9551 / A9548 - Hàng Chính Hãng,783.0,8849926181554,299000,550000,251000,46,127,thiet-bi-kts-phu-kien-so
179951358,"Giá đỡ laptop, máy tính hợp kim nhôm nguyên khối,điều chỉnh 6 cấp độ,thiết kế tản nhiệt kiểu dáng sang trọng chống rung,chịu tải nặng xếp gọn mang theo TiMa.lala - Hàng chính hãng",247.0,3753367984882,179000,179000,0,0,19,thiet-bi-kts-phu-kien-so
174593834,"Chuột bluetooth PIXLINK P103BL 2 chế độ sạc pin siêu mỏng không gây tiếng ồn chuyên dùng cho Máy tính, pc, Laptop, Tivi Hàng Chính Hãng",395.0,8631283549023,149000,149000,0,0,87,thiet-bi-kts-phu-kien-so
166320772,Tai Nghe Gaming Có Mic Rời xMOWI RX3 Dùng Được Cho Cả Máy Tính Và Điện Thoại - Hàng Chính Hãng,2.0,4176203240873,139000,150000,11000,7,0,thiet-bi-kts-phu-kien-so
153045640,"Cáp sạc nhanh C to C 25w dùng cho Samsung Galaxy S21, Folder 3- hàng Chính Hãng",43.0,1333956949783,39000,39000,0,0,7,thiet-bi-kts-phu-kien-so
123518348,Tai nghe Remax RM-201 - Hàng chính hãng,1703.0,2161686473638,99000,150000,51000,34,301,thiet-bi-kts-phu-kien-so
118424390,Chuột không dây DAREU LM115G Black - Pink - Hàng Chính Hãng,209.0,2550548087105,155000,155000,0,0,52,thiet-bi-kts-phu-kien-so
86018342,Kính Cường Lực KingKong 9D Trong Suốt Dành Cho iPhone - Full Hộp Sắt Cao Cấp - Dán Full Màn - Hàng Chính Hãng,0.0,1667679854969,119000,119000,0,0,0,thiet-bi-kts-phu-kien-so
85118373,"Cáp sạc Baseus Type C 100W, Cáp sạc siêu nhanh 100W Baseus Metal Data Cable Type C to Type C (100W) - Hàng nhập khẩu",25.0,7592339667061,79000,79000,0,0,1,thiet-bi-kts-phu-kien-so
72811865,"Dây Cáp Sạc Nhanh Type-C To Light.ning 20W Dành Cho iPhone, Cho iPad Chuẩn MFI C94, Dài 1.2 Mét RAVPower RP-CB1004 - Hàng Chính Hãng",373.0,2729484358756,299000,450000,151000,34,75,thiet-bi-kts-phu-kien-so
49648343,Thẻ Nhớ Micro SD Hikvision 64Gb Class 10 - Hàng Chính hãng,482.0,2887582294731,94100,200000,105900,53,43,thiet-bi-kts-phu-kien-so
35420153,"Cáp sạc nhanh, truyền dữ liệu tốc độ cao Baseus Cafule Type C cho Samsung S8/S9/ Note8/ Note9/ Xiaomi/ Huawei/ Oppo/Nokia ( 3A, Sạc nhanh Quick charge 3.0, Siêu bền)- Hàng nhập khẩu",1223.0,7650450605756,79000,79000,0,0,262,thiet-bi-kts-phu-kien-so
22877109,Combo chuột phím không dây Logitech MK275 - Hàng chính hãng,83.0,9629512304713,488000,488000,0,0,11,thiet-bi-kts-phu-kien-so
17454114,Bao da 360 độ Dada dành cho iPad Pro 11 Inch 2018 - Hàng chính hãng,69.0,8878461293437,65000,130000,65000,50,9,thiet-bi-kts-phu-kien-so
2054629,Cáp Chuyển Đổi Ugreen HDMI Sang DVI Sợi Tròn 11150 1.5m - Hàng Chính Hãng,2919.0,1212520218134,102000,150000,48000,32,424,thiet-bi-kts-phu-kien-so
389145,"Chuột không dây Logitech B175 - đầu thu USB 2.4Ghz, pin 1 năm, nhỏ gọn, thiết kế thuận cả 2 tay, phù hợp PC/ Laptop - Hàng chính hãng",7949.0,6703911071070,189000,189000,0,0,1174,thiet-bi-kts-phu-kien-so
54665,Chuột không dây Logitech M185 - Hãng chính hãng,146.0,5006348510336,225000,225000,0,0,29,thiet-bi-kts-phu-kien-so
277776200,VIETMAP W20 - Thiết bị chuyển đổi CarPlay/ A.ndroid Auto không dây - Hàng chính hãng,7.0,4853205136906,790000,790000,0,0,1,thiet-bi-kts-phu-kien-so
277729004,Bộ Sạc Siêu Nhanh 25W Type C dành cho Samsung và các dòng điện thoại cổng C,12.0,5843518257001,59000,89000,30000,34,4,thiet-bi-kts-phu-kien-so
276831136,"Bộ Sạc Nhanh PD 20W Cho iPhone, iPad Hoco C76Plus/CS13/CS13A - Hỗ trợ sạc nhanh 0-50% Pin trong 30p - Hàng Chính Hãng",338.0,7520517854857,139000,239000,100000,42,33,thiet-bi-kts-phu-kien-so
276502830,"Bộ Sạc Nhanh 30W WeKome WU-39 Dành Cho iPh, SS - Kèm Cáp Sạc Bọc Dù Chắc Chắn - Hàng Chính Hãng",9.0,4008449431930,250000,250000,0,0,1,thiet-bi-kts-phu-kien-so
275197306,"Bàn Phím Led Rainbow Gaming Giả cơ K82 có núm chỉnh âm lượng cho máy tính , laptop hàng nhập khẩu",62.0,5824662669258,275000,275000,0,0,13,thiet-bi-kts-phu-kien-so
275130483,Loa Bluetooth JBL Go 4 - Hàng Chính Hãng,175.0,8105457878696,1089000,1090000,1000,0,37,thiet-bi-kts-phu-kien-so
274989970,Chuột văn phòng Logitech B100 - Hàng Chính Hãng,102.0,8194929811783,79000,79000,0,0,3,thiet-bi-kts-phu-kien-so
274819635,Chuột có dây HP 105 (822M9AA) - Hàng chính hãng,11.0,3160381480304,129000,149000,20000,13,2,thiet-bi-kts-phu-kien-so
274649327,Pin sạc dự phòng Rockspace Y11 sạc nhanh 22.5w dung lượng 20000mAh có tích hợp kèm dây sạc - Hàng chính hãng bảo hành 12 tháng,73.0,2645197740220,599000,699000,100000,14,11,thiet-bi-kts-phu-kien-so
273472564,Tai Nghe Bluetooth RiBi G60 - Âm thanh cực hay - Pin trâu đến 8h - Sạc nhanh Type - C - Mẫu mã cực đẹp -  Hàng chính hãng,305.0,5891330407457,169000,199000,30000,15,67,thiet-bi-kts-phu-kien-so
273456496,"Tai nghe cho Iphone chân dẹt cao cấp Hoco. M111 Max/Pro hỗ trợ nghe gọi mic đầy đủ, cắm dùng trực tiếp không cần kết nối bluetooth - Hàng chính hãng",424.0,2533763999578,199000,359000,160000,45,53,thiet-bi-kts-phu-kien-so
272420279,Cáp sạc nhanh thay thế cho các dòng đồng hồ Garmin cổng Type C- Hàng Chính Hãng,290.0,1650668411899,75000,75000,0,0,16,thiet-bi-kts-phu-kien-so
271984126,"Dây Sạc nhanh cho Iphone PD 20W Type C to IP Hoco X14 dây dù chống đứt chống rối siêu bền, truyền dữ liệu dài 1M/2M/3M - Hàng Chính Hãng",269.0,3659083692344,89000,159000,70000,44,37,thiet-bi-kts-phu-kien-so
271966725,Loa Bluetooth Sony SRS-XB100 - Hàng chính hãng,113.0,9086010072461,1090000,1390000,300000,22,26,thiet-bi-kts-phu-kien-so
263354473,Chuột không dây Logitech M240 Silent Bluetooth - Hàng chính hãng,15.0,7495779310169,369000,369000,0,0,1,thiet-bi-kts-phu-kien-so
249050883,Giá Đỡ Điện Thoại Cao Cấp RIBI - Xoay 360 độ - Tăng Giảm Chiều Cao - Có Thể Gấp Gọn - Hàng Chính Hãng,213.0,7666704096150,45000,69000,24000,35,33,thiet-bi-kts-phu-kien-so
199706098,"Chuột không dây PROLiNK PMW6009 độ nhạy cao, tiết kiệm pin dành cho PC, Macbook, Laptop - Hàng chính hãng",226.0,2596875839172,129000,129000,0,0,70,thiet-bi-kts-phu-kien-so
196857039,"Giá Đỡ Laptop Hợp Kim Nhôm Cao Cấp FIRO F39 - Đế Tản Nhiệt Cho Laptop,Macbook,Máy Tính Xách Tay,Gấp Gọn Tiện Lợi - 10 Vị Trí Điều Chỉnh Góc Độ - Tương Thích Với Các Dòng Laptop/Macbook 11 - 17inch Và Tất Cả Máy Tính Bảng - Hàng Chính Hãng",548.0,4465182858807,219000,424000,205000,48,161,thiet-bi-kts-phu-kien-so
191684818,"Tai Nghe Bluetooth True Wireless AMOI F9 Cảm Ứng Vân Tay, Nâng Cấp Dock Sạc có Led Báo Pin Kép - Hàng Nhập Khẩu",3672.0,4384075895764,89000,99000,10000,10,1166,thiet-bi-kts-phu-kien-so
191477357,Ốp lưng dẻo trong phong cách mới dành cho iPhone 12 / 13 / 14 / 12 Pro / 12 Pro Max / 13 Pro / 13 Pro Max / 13 Mini / 14 / 14 Max / 14 Pro / 14 Pro Max  - Hàng chính hãng,1627.0,9374964020304,139000,199000,60000,30,285,thiet-bi-kts-phu-kien-so
183513216,"Chuột công thái học không dây Logitech Lift Vertical - Bluetooth|USB Logi Bolt, Silent giảm ồn, 4 nút tùy chỉnh, tương thích với Windows/macOS/iPad/PC - Hàng chính hãng",22.0,6841823592015,1490000,1490000,0,0,2,thiet-bi-kts-phu-kien-so
174490279,"Chuột không dây bluetooth Logitech Signature M650 - Dành cho tay có kích cỡ từ nhỏ tới trung bình, Cuộn SmartWheel, giảm ồn, các nút bên có thể tùy chỉnh - Hàng chính hãng",340.0,4199924139476,590000,590000,0,0,60,thiet-bi-kts-phu-kien-so
150937588,"Cáp Sạc Nhanh 20W Dành Cho iPhone Remax RC-171, Chuẩn TypeC to IP,  Sử Dụng Chip E-marker, Chống Sạc Quá Tải, Chống Gãy Cáp - Hàng Chính Hãng",258.0,6862675264895,125000,125000,0,0,55,thiet-bi-kts-phu-kien-so
136021325,Bảng vẽ điện tử VINSA 1060 Plus - Hàng chính hãng,266.0,6232289096470,580000,580000,0,0,66,thiet-bi-kts-phu-kien-so
118722616,Chuột có dây LOGITECH B100 - Hàng chính hãng,479.0,5152430152751,79000,79000,0,0,29,thiet-bi-kts-phu-kien-so
117929765,"Bộ 2 Loa Mini Dorron V116, Âm Thanh Nổi, Bass Trầm - Phiên Bản Nâng Cấp - Hàng Chính Hãng",166.0,9229990455974,139000,139000,0,0,49,thiet-bi-kts-phu-kien-so
112056073,Bao da cho iPad Pro 11 inch / iPad Pro 12.9 inch 2021/2022 Nillkin Bumper Leather Case Pro (Có khe cắm bút Apple Pencil) - Hàng Nhập Khẩu,216.0,8699812195767,490000,490000,0,0,71,thiet-bi-kts-phu-kien-so
111726388,"Đầu bút thay thế ngòi cao cấp dành cho Apple Pencil 1, 2, Pencil Pro - Apple Pencil Tips_ Hàng Chính Hãng",579.0,8490398309992,64000,64000,0,0,63,thiet-bi-kts-phu-kien-so
111031533,Cáp sạc nhanh 2.4A và truyền dữ liệu chân type-C Remax Colorful Light RC-152a [Hàng chính hãng],1787.0,7498405049052,99000,150000,51000,34,385,thiet-bi-kts-phu-kien-so
110850007,Tai nghe nhét tai có dây jack 3.5mm Remax RM-512 (New Package) - Hàng chính hãng,5343.0,7491719637488,99000,150000,51000,34,1053,thiet-bi-kts-phu-kien-so
104261141,Chuột không dây chơi game HXSJ X801 thiết kế độc lạ Led RGB đổi màu click chống ồn DPI 1600 - Hàng chính hãng,412.0,6282642123012,299000,499000,200000,40,157,thiet-bi-kts-phu-kien-so
88073058,Túi chống nước UAG WaterProof cho điện thoại - Hàng Chính Hãng,690.0,8470837089394,200000,200000,0,0,95,thiet-bi-kts-phu-kien-so
73179180,Thẻ Nhớ microSD SanDisk Ultra 128GB UHS-I - 100MB/s (New 2020) - Hàng Nhập Khẩu,8072.0,6431304737240,235000,235000,0,0,1280,thiet-bi-kts-phu-kien-so
59482840,"Bộ Hub QGeeM đa năng 5 trong 1 dành cho MacBook Pro 13/15 Surface Go, USB C Adapter - Hàng chính hãng",31.0,5410030136030,258000,298000,40000,13,5,thiet-bi-kts-phu-kien-so
24865067,Bút laser trình chiếu Slide VSON N35 - Hàng nhập khẩu,401.0,4293139810312,151000,151000,0,0,74,thiet-bi-kts-phu-kien-so
1457747,Thẻ Nhớ Micro SDXC SanDisk UHS-1 64GB Class 10 - Hàng Chính Hãng,9318.0,8866806983877,145000,250000,105000,42,1466,thiet-bi-kts-phu-kien-so
1059892,Dây Cáp Sạc Lightning Cho iPhone Anker PowerLine II 0.9m - A8432 - Hàng Chính Hãng,10548.0,1357935491649,221000,330000,109000,33,1285,thiet-bi-kts-phu-kien-so
360759,Tai nghe có dây Logitech H340 - Hàng chính hãng,285.0,6501896608317,459000,459000,0,0,27,thiet-bi-kts-phu-kien-so
299431,Chuột Không Dây Logitech M221 - Hàng Chính Hãng,815.0,6709713196454,250000,250000,0,0,215,thiet-bi-kts-phu-kien-so
277375757,Hộp Tròn Đựng Tai Nghe Cáp Sạc - Hàng chính hãng,6.0,5037241833218,15000,30000,15000,50,2,thiet-bi-kts-phu-kien-so
277361307,"Tai Nghe Nhét Tai Có Dây Xiaomi Âm Thanh Sống Động, Jack 3.5mm - Hỗ Trợ Mic, Dùng Cho Học Tập, Giải Trí - Hàng Chính Hãng",19.0,2481005672281,99000,99000,0,0,2,thiet-bi-kts-phu-kien-so
276801920,"Gậy quay video MP19s thông minh,chụp ảnh, livestream, kim loại bền bỉ, gimbal 360 dõi theo, nâng cấp, hàng chính hãng",209.0,8293443218802,1099000,1099000,0,0,33,thiet-bi-kts-phu-kien-so
276475241,Chuột không dây Logitech M241 Silent Bluetooth - Hàng chính hãng,0.0,6026972194033,419000,419000,0,0,0,thiet-bi-kts-phu-kien-so
276380115,"Sáp Gel Đuổi Chuột An Toàn Hiệu Quả, Không Độc Hại - Hàng Nhập Khẩu",66.0,6611116214486,35000,35000,0,0,0,thiet-bi-kts-phu-kien-so
276025056,Loa Bluetooth LG XBOOM GO XG2 - Hàng Chính Hãng,1326.0,7393697037466,691000,1390000,699000,50,4,thiet-bi-kts-phu-kien-so
275543799,Chuột văn phòng có dây Newmen M007 màu Đen - Hàng Chính Hãng,10.0,1349046874504,89000,89000,0,0,0,thiet-bi-kts-phu-kien-so
275358119,Giá Đỡ kim loại N3 cho laptop máy tính bảng hỗ trợ tản nhiệt và điều chỉnh góc máy hàng nhập khẩu,43.0,1383479338167,95000,95000,0,0,7,thiet-bi-kts-phu-kien-so
275316800,Miếng lót chuột Kai hình tròn siêu dễ thương nhiều mẫu mới_ Hàng chính hãng,80.0,5550883556862,29000,29000,0,0,7,thiet-bi-kts-phu-kien-so
274994587,Chuột không dây Bluetooth Logitech M240 Silent - Hàng chính hãng,77.0,9019114928115,319000,319000,0,0,11,thiet-bi-kts-phu-kien-so
273916258,"Giá Đỡ Ipad Hợp Kim Nhôm Để Bàn Xoay 360 Độ Cho Điện Thoại, Máy Tính Bảng L01 - Hàng chính hãng",84.0,3991056767553,99000,99000,0,0,11,thiet-bi-kts-phu-kien-so
273536891,Pin dự phòng PD 20W Rockspace P91 sạc nhanh 10000mAh Hàng chính hãng bảo hành 12 tháng,57.0,2697217224377,269000,299000,30000,10,7,thiet-bi-kts-phu-kien-so
273457735,"Tai Nghe Bluetooth Lenovo XT80 Thể Thao , Chống Ồn Chủ Động ANC , Âm Thanh Nổi - Hàng Chính Hãng",120.0,5585931912589,285000,285000,0,0,24,thiet-bi-kts-phu-kien-so
253397539,Chuột máy tính không dây HyperWork Silentium MS01 - Hàng Chính Hãng,233.0,8351242870330,398000,398000,0,0,36,thiet-bi-kts-phu-kien-so
242665662,Miếng Lót Chuột FIRO MXL800 EXTENDED - Tấm Lót Chuột Cỡ Lớn 2 Mặt 80cmx40cm - Chất Liệu Da PU Cao Cấp - Tấm Lót Chuột Và Bàn Phím Chơi Game - Tấm Trải Bàn Làm Việc - Hàng Chính Hãng FIRO,1117.0,7697916502932,119000,229000,110000,48,140,thiet-bi-kts-phu-kien-so
225200930,Đầu chuyển đổi USB TypeC và USB 3.0 thương hiệu RIBI - hàng chính hãng,42.0,2884184569296,29000,50000,21000,42,2,thiet-bi-kts-phu-kien-so
199525542,Adapter Sạc Anker 511 Charger Nano 3 30W 1 Cổng Type-C A2147 - Hàng Chính Hãng,957.0,6805384413322,311000,430000,119000,28,169,thiet-bi-kts-phu-kien-so
197587166,Tai Nghe Bluetooth Không Dây FIRO A18 - Tai Nghe FIRO A18 Bluetooth V5.3 - Điều Khiển Cảm Ứng Thông Minh - Công Nghệ Kháng Nước IPX5 - Tai Nghe Bluetooth Giảm Tiếng Ồn FIRO A18 - Phù Hợp Với Tất Cả Dòng Máy - Hàng Chính Hãng,342.0,1703718956994,365000,699000,334000,48,101,thiet-bi-kts-phu-kien-so
196855678,"Bàn Phím Không Dây Logitech Signature K650 - Nhỏ gọn, gác tay tích hợp, tương thích Mac , Bluetooth & USB Bolt - Hàng chính hãng",7.0,2567196437381,1260000,1260000,0,0,1,thiet-bi-kts-phu-kien-so
195915487,Thẻ Nhớ MicroSDXC SanDisk Extreme Pro V30 A2 128GB 200MB/s SDSQXCD-128G (New 2022) - Hàng Nhập Khẩu,365.0,3013570435564,365000,365000,0,0,61,thiet-bi-kts-phu-kien-so
195277333,Ốp lưng dẻo cho iPhone 8 / SE 2020 / 8 Plus / X / XS / XR / XS Max / 11 / 11 Pro / 11 Pro Max / 12 / 12 Pro / 12 Pro Max / 12 Mini / 13 / 13 Pro / 13 Pro Max / 13 Mini / 14 / 14 Pro / 14 Pro Max / 14 Max -Hàng chính hãng-Photodesign VN,1537.0,4654046877304,149000,250000,101000,40,296,thiet-bi-kts-phu-kien-so
185409732,Tai Nghe Bluetooth Lenovo Livepods LP40 TWS Hàng Chính Hãng,2084.0,3221619404224,156000,156000,0,0,150,thiet-bi-kts-phu-kien-so
182833187,Giá đỡ kẹp điện thoại kim loại gắn gương chiếu hậu xe máy C2 hàng TiMa.lala - Hàng chính hãng,130.0,9254004589649,79000,89000,10000,11,18,thiet-bi-kts-phu-kien-so
179573066,"Đế Tản Nhiệt Laptop, Máy Tính Xách Tay Besti BTY02 , Có Đèn Led Cực Đẹp, 6 Quạt Giúp Làm Mát Nhanh Bảo Vệ Máy Tính Mà Không Gây Ồn Thích Hợp Cho Nhiều Loại Laptop - Hàng Chính Hãng 	",104.0,4276312700429,350000,350000,0,0,15,thiet-bi-kts-phu-kien-so
174593880,Chuột Không Dây Sạc Pin 2.4GHz PIX-LINK P1 Siêu Mỏng Không Gây Tiếng Ồn Sạc 1 Lần Dùng 1 Tuần Cho Laptop Macbook PC Tivi - Hàng Chính Hãng,840.0,2431610236901,79000,79000,0,0,117,thiet-bi-kts-phu-kien-so
174593799,"Chuột Bluetooth Không Dây PIX-LINK  P90A Wireless USB Tự Sạc Pin Siêu Mỏng, Chống Ồn - Hàng Chính Hãng",534.0,9227240017700,229000,229000,0,0,78,thiet-bi-kts-phu-kien-so
173058453,"Chuột không dây bluetooth Logitech POP MOUSE - giảm ồn, nút emoji tùy chỉnh - Hàng chính hãng",1043.0,5991786113961,595000,595000,0,0,209,thiet-bi-kts-phu-kien-so
172146754,Ốp lưng chống sốc lưng trong phong cách mới dành cho iPhone 11 / 12 / 13 / 11 Pro / 12 Pro / 13 Pro / 11 Pro Max / 12 Pro Max / 13 Pro Max / 12 Mini / 13 Mini - Hàng chính hãng,1197.0,3890541598905,179000,250000,71000,28,304,thiet-bi-kts-phu-kien-so
155780905,Tai nghe có dây nhét tai âm bass sâu Remax RM-620 - Hàng chính hãng,698.0,4313057096104,199000,300000,101000,34,138,thiet-bi-kts-phu-kien-so
148813604,Chuột không dây Logitech M331 SILENT-Hàng chính hãng,128.0,6597177703780,319000,319000,0,0,22,thiet-bi-kts-phu-kien-so
121242259,Chuột có dây Dell MS116-Hàng chính hãng,60.0,8881436489379,99000,109000,10000,9,2,thiet-bi-kts-phu-kien-so
116725239,"Chuột không dây Bluetooth, chuột máy tính HXSJ M107B chống ồn, DPI 1600, chế độ kép wireless usb 2.4Ghz, bluetooth chuyên dùng cho laptop, máy tính, tivi - Hàng chính hãng",331.0,5161751145414,149000,249000,100000,40,75,thiet-bi-kts-phu-kien-so
76480235,"Bao Tay Chơi Game Cảm Ứng Chống Mồ Hôi SIDOTECH Siêu Mỏng Vải Sợi Carbon Siêu Bền Chống Giãn Xù, Cảm Ứng Nhạy Thuộc Dòng Găng Tay Chơi Game Bao Ngón Tay Cho PUBG Tốc Chiến Freefire Liên Quân mobile - Hàng Chính Hãng",2517.0,7045498575398,29000,38000,9000,24,229,thiet-bi-kts-phu-kien-so
76067387,Đầu đọc thẻ nhớ 2.0 Hoco HB20 Mindful - hỗ trợ khe microSD/SD (Hàng chính hãng),178.0,4272879154603,99000,99000,0,0,45,thiet-bi-kts-phu-kien-so
75582647,Bộ Cốc sạc và Cáp sạc nhanh Baseus Super Si PD 20W CCCJGCC for iPhone 12 (Hàng chính hãng),102.0,4517224713945,169000,169000,0,0,20,thiet-bi-kts-phu-kien-so
34557311,"Túi phụ kiện công nghệ BUBM chuyên dụng 1 ngăn, 2 ngăn đựng dây cáp, pin sạc dự phòng có quai xách cầm tay tiện lợi- Hàng chính hãng",87.0,8238637827086,99920,124900,24980,20,18,thiet-bi-kts-phu-kien-so
19772753,"Dây cáp sạc nhanh Type-C truyền data tốc độ cao Baseus Cafule Type C to Type C PD cho Smartphone / Tablet / Macbook / Laptop Type C  dài 1M (3A, 60W, Sạc nhanh PD, Sạc nhanh QC 4.0 Quick Charge) - hàng chính hãng",423.0,4659611465287,78000,108000,30000,28,62,thiet-bi-kts-phu-kien-so
4312979,Chuột không dây Logitech M220 Silent - Hàng chính hãng,1068.0,9974896103712,235000,235000,0,0,172,thiet-bi-kts-phu-kien-so
125781,Tai Nghe Nhét Tai Sony Fontopia MDR-E9LP - Hàng Chính Hãng,10837.0,6508902455033,140000,159000,19000,12,1457,thiet-bi-kts-phu-kien-so
277527693,"Thiết bị định vị Hoco E92 tích hợp pin, có thể sạc lại bằng sạc không dây, chống nước IP68, dạng thẻ siêu mỏng, định vị toàn cầu chống thất lạc - Hàng chính hãng",5.0,2622443061411,285000,285000,0,0,1,thiet-bi-kts-phu-kien-so
277026525,Dây Cáp Chuyển Đổi DisplayPort Sang HDMI màu đen Displayport To HDMI Hàng Nhập Khẩu,8.0,4679609526842,160000,160000,0,0,0,thiet-bi-kts-phu-kien-so
276619020,Bao Case Ốp Auto Unlocked Có Khóa Chống Thất Lạc Rơi Tai Nghe cho Samsung Galaxy Buds 3 / Buds 3 Pro - Hàng Chính Hãng,9.0,2731371704731,159000,159000,0,0,1,thiet-bi-kts-phu-kien-so
276120897,Cáp sạc nhanh Baseus Silky Series Fast Charging Cable Type-C to iP 20W- Hàng chính hãng,17.0,5970384488870,120000,180000,60000,33,0,thiet-bi-kts-phu-kien-so
276115570,"Apple Watch Series 10 GPS (Viền nhôm, dây cao su)",24.0,8996562197469,10900000,12990000,2090000,16,4,thiet-bi-kts-phu-kien-so
275467638,Loa Bluetooth iCore mini - Hàng chính hãng,18.0,8491532016072,159000,159000,0,0,4,thiet-bi-kts-phu-kien-so
275357872,Giá Đỡ kim loại cho laptop máy tính bảng hỗ trợ tản nhiệt và điều chỉnh độ cao góc máy hàng nhập khẩu,23.0,1821890918737,150000,150000,0,0,3,thiet-bi-kts-phu-kien-so
274810310,Chuột không dây LOGITECH M331 Cổng USB - Hàng chính hãng,44.0,2267605884090,345000,345000,0,0,6,thiet-bi-kts-phu-kien-so
274704205,Cáp sạc 3 đầu Baseus StarSpeed 1 for 3 Fast Charging Data Cable USB to M+L+C 3.5A - Hàng chính hãng,37.0,5838774266644,159000,230000,71000,31,3,thiet-bi-kts-phu-kien-so
273900797,Củ sạc nhanh PD 20W nhỏ gọn iCybernet IC-2001 - Hàng chính hãng,183.0,6193207895107,129000,200000,71000,36,16,thiet-bi-kts-phu-kien-so
273682062,"Củ sạc nhanh Robot GaN Nexode Mini 30W Ugreen CD359 , 65W Ugreen CD244 | Tương thích Apple, Samsung , Xiaomi | Bảo hành 18 tháng - Hàng Chính Hãng",8.0,1542929958741,279000,279000,0,0,2,thiet-bi-kts-phu-kien-so
273452284,Dung dịch Vệ Sinh Màn Hình Macbook Kai.N Screen Cleaning Kit 200ml Kháng Khuẩn Điện Thoại / Máy ảnh / Đồng Hồ / Laptop - HÀNG CHÍNH HÃNG,45.0,6741093869004,75000,75000,0,0,6,thiet-bi-kts-phu-kien-so
273363090,Cáp sạc nhanh WDC-11 WEKOME Type-C to Type-C 100W[ Hàng chính hãng],8.0,9269679305549,79000,98000,19000,19,1,thiet-bi-kts-phu-kien-so
273303118,Ốp lưng cứng chống ố sạc từ tính dành cho iPhone 12 / 13 / 14 / 15 / 16 / 12 Pro / 12 Pro Max / 13 Pro / 13 Pro Max / 14 Plus / 14 Pro / 14 Pro Max / 15 Plus / 15 Pro / 15 Pro Max / 16 Plus / 16 Pro / 16 Pro Max - Hàng chính hãng,312.0,8442037389596,199000,269000,70000,26,39,thiet-bi-kts-phu-kien-so
273084871,Bộ chia USB 3.0 ra 4 cổng tốc độ cao 5Gbps -Hàng Chính Hãng,78.0,7789540016814,80000,80000,0,0,5,thiet-bi-kts-phu-kien-so
270701425,"Cáp sạc nhanh 3 trong 1 Remax RC-189th chiều dài 1,2m sạc nhanh 3.1A - Hàng chính hãng",454.0,8175740761923,100000,200000,100000,50,55,thiet-bi-kts-phu-kien-so
207789733,Sạc dự phòng All-in-one dung lượng 15000mAh Remax RPP-276 - Hàng chính hãng,7.0,5758772352068,948999,948999,0,0,2,thiet-bi-kts-phu-kien-so
199249541,Adapter Sạc Anker 313 / 311 Charger Gen 2 30W 1 Cổng Type-C A2639 - Hàng Chính Hãng,1052.0,9775909580395,371000,500000,129000,26,159,thiet-bi-kts-phu-kien-so
196487034,Ốp lưng da cao cấp dành cho iPhone 14 / 14 Plus / 14 Pro / 14 Pro Max - Hàng chính hãng,194.0,8143576972240,169000,250000,81000,32,34,thiet-bi-kts-phu-kien-so
194823010,"Set 5 Cút Nối Dây Điện KV774 / PCT, Kẹp Nối Dây Điện Nhanh",134.0,2255089444753,22000,22000,0,0,8,thiet-bi-kts-phu-kien-so
192726528,Ốp Case Siêu Mỏng Thinfit cho Apple Watch Series 7/ Series 8 Size 41/45mm- Hàng chính hãng,75.0,8566897054508,79000,79000,0,0,12,thiet-bi-kts-phu-kien-so
192445205,Củ sạc nhanh GaN công suất 33W Remax RP-U25 chuẩn kép PD + QC 3.0 - Hàng chính hãng,317.0,1093252200876,299000,390000,91000,23,73,thiet-bi-kts-phu-kien-so
161007768,Ốp lưng dẻo mỏng dành cho iPhone 11 / 12 / 13 / 11 Pro / 12 Pro / 13 Pro / 11 Pro Max / 12 Pro Max / 13 Pro Max / 12 Mini / 13 Mini - Hàng chính hãng,1058.0,8588264920005,49000,69000,20000,29,186,thiet-bi-kts-phu-kien-so
156634748,"	Cáp Sạc truyền dữ liệu 2.4 chống dối, dây dù dành cho Iphone,Ipad Hoco X14 Giao màu ngẫu nhiên- Hàng chính hãng",587.0,2870172358823,48000,48000,0,0,104,thiet-bi-kts-phu-kien-so
152923535,"Bình xịt vệ sinh màn hình, bàn phím laptop/ máy tính 650ML, vệ sinh đa năng trên loại bề mặt- Hàng nhập khẩu+ Tặng kèm khăn lau cao cấp- CHỌN MẪU",194.0,8005807038833,72000,72000,0,0,22,thiet-bi-kts-phu-kien-so
135716055,Ốp da cao cấp dành cho iPhone 13 / 13 Pro / 13 Pro Max / 13 Mini - Hàng chính hãng,375.0,1807276884420,149000,250000,101000,40,101,thiet-bi-kts-phu-kien-so
126075524,Củ sạc nhanh 30W Remax RP-U82 chuẩn kép QC+PD - Hàng chính hãng,766.0,3998876323077,290000,390000,100000,26,179,thiet-bi-kts-phu-kien-so
124702330,"Adapter Củ Sạc Nhanh Đến 25W Type C PPS PD 3.0 QC 3.0 RAVPower RP-PC156 Dành Cho Điện Thoại Samsung, iPhone, iPad - Hàng Chính Hãng",208.0,9370627724125,269000,500000,231000,46,45,thiet-bi-kts-phu-kien-so
110169574,"Thảm Lót Chuột Cỡ Lớn, Dùng Được Hai Mặt - Da PU Chống Nước - Doron HD01 - Kiêm Deskpad Thảm Da, Trải Bàn Làm Việc - Hàng Nhập Khẩu",664.0,9386204573964,52000,52000,0,0,155,thiet-bi-kts-phu-kien-so
102782859,Tai nghe In Ear Remax RM330 - Hàng chính hãng,2639.0,7495132522527,199000,250000,51000,20,589,thiet-bi-kts-phu-kien-so
81224454,Ốp lưng cao cấp dành cho iPhone  - Photodesign VN - Hàng chính hãng,51.0,4921356552040,119000,199000,80000,40,15,thiet-bi-kts-phu-kien-so
76474502,[Loại Tốt] Bút Chỉ Laser Trình Chiếu Điều Khiển Không Dây Từ Xa KhoNCC-R400 2.4ghz Hàng Chính Hãng Dùng Khi Thuyết Trình PowerPoint - KLVQ-BTC-R400-200 (Đen),38.0,5724599019568,230000,230000,0,0,5,thiet-bi-kts-phu-kien-so
75993812,Hub USB 3.0 Chia 4 cống Cao Cấp - Cổng chia USB Cao Cấp -  Chính Hãng VinBuy ,4.0,1106053551229,36900,36900,0,0,2,thiet-bi-kts-phu-kien-so
68985833,"Dây sạc Cáp sạc Nam châm Đồng hồ Thông minh Q12, Q16, Q19, Q100, TD26, A28, DS60, DS66, Y95, D06, DF39 Hàng nhập khẩu",1558.0,8750210825567,47000,47000,0,0,189,thiet-bi-kts-phu-kien-so
56196502,Chuột Gaming Logitech G102 Gen 2 Lightsync - Hàng Chính Hãng,457.0,9001182358669,409000,409000,0,0,99,thiet-bi-kts-phu-kien-so
54889765,Baseus LV106-B01 Đầu Chuyển OTG USB Type C Sang USB | Chính hãng Baseus,541.0,8967744750603,85000,85000,0,0,68,thiet-bi-kts-phu-kien-so
49658272,"Dây cáp sạc nhanh Type-C dài 2M hiệu Baseus Cafule Type C to Type C PD truyền data tốc độ cao  cho Smartphone / Tablet / Macbook / Laptop Type C Samsung Huawei Oppo Xiaomi Vsmart (3A, 60W, Sạc nhanh PD, Sạc nhanh QC 4.0 Quick Charge) - Hàng nhập khẩu",383.0,3441949909509,69000,69000,0,0,76,thiet-bi-kts-phu-kien-so
20589215,Pin Sạc AAA Eneloop Panasonic - Hàng Chính Hãng,25.0,1908102470754,215000,215000,0,0,2,thiet-bi-kts-phu-kien-so
19419738,Bộ Thu Phát Bluetooth TP-Link UB400 USB Nano Bluetooth 4.0 - Hàng Chính Hãng,5686.0,5347164230856,135000,135000,0,0,1057,thiet-bi-kts-phu-kien-so
1995735,Dây Cáp Sạc Đa Năng 2 Trong 1 USB Type-C / Micro USB Xiaomi (1m) - Hàng Chính Hãng,149.0,5999171792928,59000,59000,0,0,4,thiet-bi-kts-phu-kien-so
277437272,Dây đeo Silicone cho Redmi Watch 5 / Redmi Watch 4 / Xiaomi Mi Band 8 Pro / Xiaomi Mi Band 9 Pro  - Hàng Chính Hãng,4.0,7577191742237,99000,99000,0,0,0,thiet-bi-kts-phu-kien-so
277249694,Bộ Chia Tẩu Sạc Ô Tô 1 Ra 3 Cổng Cao Cấp Socket - Hàng Nhập Khẩu,4.0,9307895361368,95000,95000,0,0,0,thiet-bi-kts-phu-kien-so
276829576,CỐC SẠC NHANH 12W 2 CỔNG CHỐNG CHÁY NỔ HOCO C73 - CỦ SẠC ĐA NĂNG 2.4A CHO CÁC DÒNG ĐIỆN THOẠI CHÍNH HÃNG,404.0,5159780798149,65000,99000,34000,34,49,thiet-bi-kts-phu-kien-so
276560632,Vỏ ốp dành cho AirPods 4 RINGKE Silicone - Hàng Chính Hãng,6.0,6464219246735,450000,450000,0,0,2,thiet-bi-kts-phu-kien-so
276558808,"Cáp Sạc Nhanh Type-C to Type-C PD 240W - Dây Cáp Dữ Liệu FIRO USB4 CABLE - Sạc Nhanh PD 240W 48V@5A, Xuất Video 8K60Hz, Truyền Dữ Liệu 40Gbps - PD240W/8K60Hz/40Gbps - Dài 1,5 Mét - Dùng Cho iPhone15,16 Series, Macbook, Laptop, Smartphone - Hàng Chính Hãng",6.0,6802185261461,225000,429000,204000,48,0,thiet-bi-kts-phu-kien-so
276395255,Ốp lưng cho SamSung Galaxy Z Flip 4 chính hãng X-level dạng da mềm - Hàng nhập khẩu,3.0,4941420244718,120000,120000,0,0,0,thiet-bi-kts-phu-kien-so
276295047,Đồng Hồ Thông Minh Xiaomi Redmi Watch 5 ACTIVE – Hàng Chính Hãng,16.0,6357025069033,740000,740000,0,0,4,thiet-bi-kts-phu-kien-so
276272219,"Ốp lưng dành cho iPad A16 Gen 11 2025 , Gen 10 10.9inch silicon dẻo cao cấp chống sốc 4 góc - Hàng chính hãng",7.0,1422438921679,81000,81000,0,0,2,thiet-bi-kts-phu-kien-so
276036666,"Kê Tay cho bàn phím cơ chất liệu da mềm mại thoải mái , bảo vệ cổ tay hàng nhập khẩu",6.0,8465778828936,145000,145000,0,0,0,thiet-bi-kts-phu-kien-so
275583558,"Đầu chuyển usb sang type c, bộ chuyển đổi usb type c  UA17 - Hàng chính hãng",15.0,9322180333444,129000,129000,0,0,0,thiet-bi-kts-phu-kien-so
275208201,Chuột led không dây M103 Bluetooth + USB Wireless 2.4G - Pin sạc cổng typeC - Chống ồn cho máy tính hàng nhập khẩu,10.0,7239413833029,180000,180000,0,0,3,thiet-bi-kts-phu-kien-so
275197028,Bộ Bàn phím chuột Led RGB Bluetooth BL30 mini siêu mỏng pin sạc chống ồn cho PC Laptop smartphone hàng nhập khẩu,13.0,8686073419492,185000,185000,0,0,1,thiet-bi-kts-phu-kien-so
274580183,Dán vòng bảo vệ từng mắt camera cho iPhone 15 pro max / 15pro / 15 plus / ip15 chính hãng Kuzoom - Hàng chính hãng,11.0,9621512457603,108637,108637,0,0,4,thiet-bi-kts-phu-kien-so
274022910,"Cáp sạc nhanh Kai.N Type C đồng hồ Garmin Fenix 7, Fenix 6,5, Epix, Forerunner 955, 945, 935, 245, 255, 45, 645, Venu_ Hàng chính hãng.",36.0,5761689062170,71000,71000,0,0,4,thiet-bi-kts-phu-kien-so
273359621,Củ Sạc nhanh 65W WEKOME WP-U147 2 Cổng TYPE-C và 1 cổng USB-A[ Hàng chính hãng],14.0,1565401546694,539000,650000,111000,17,2,thiet-bi-kts-phu-kien-so
273095636,Tai nghe Bluetooth Truewireless JBL Wave Beam - Hàng Chính Hãng,327.0,1441437352439,1289000,1290000,1000,0,78,thiet-bi-kts-phu-kien-so
271584453,"Bộ Dụng Cụ Vệ Sinh Tai Nghe, Bàn Phím Máy Tính Đa Năng 7 Trong 1, Nhỏ Gọn, Tiện Lợi - Hàng Chính Hãng",171.0,5229876280044,65000,85000,20000,24,18,thiet-bi-kts-phu-kien-so
253358448,Thẻ Nhớ microSD SanDisk Ultra A1 150MB/s 256GB - Hàng Nhập Khẩu,327.0,4583010536573,415000,415000,0,0,30,thiet-bi-kts-phu-kien-so
248723656,"Giá Đỡ Điện Thoại Trên Ô Tô Kẹp Điện Thoại Trên Xe Hơi Chắc Chắn, Thích Hợp Nhiều Vị Trí Trên Ô Tô - HÀNG CHÍNH HÃNG MINIIN",11.0,3948081974343,99000,99000,0,0,0,thiet-bi-kts-phu-kien-so
242430297,Kính Cường Lực G5 Full Màn Hình cho các dòng Iphone - Hàng chính hãng,7.0,1299468134422,32500,65000,32500,50,3,thiet-bi-kts-phu-kien-so
227490134,Thẻ Nhớ SanDisk 256G-32G-64G-128GB MicroSD Ultra Class 10  - Hàng Chính Hãng,361.0,7465603725463,140000,140000,0,0,43,thiet-bi-kts-phu-kien-so
213867018,"Ốp lưng cho SamSung Galaxy S23 Ultra chính hãng Nillkin dạng sần chống vân tay, chống va đập - Hàng chính hãng",5.0,2457507310644,168598,168598,0,0,0,thiet-bi-kts-phu-kien-so
203957192,Miếng lót chuột Yuumy ( Thời trang nữ tiện lợi cỡ trung - Miếng lót da Seasand YLC2 ),720.0,2605087365094,29000,55000,26000,47,11,thiet-bi-kts-phu-kien-so
196687191,"Dây Cáp Chuyển USB 5V to DC Jack 5.5 / 4.0 / 3.5 / 2.5mm Cho Quạt Sạc, Đèn Sạc, Đèn LED - Hàng Chính Hãng NAVIVU",42.0,3238654843063,35000,35000,0,0,3,thiet-bi-kts-phu-kien-so
195915991,Thẻ Nhớ MicroSDXC SanDisk Extreme Pro V30 A2 256GB 200MB/s SDSQXCD-256G (New 2022) - Hàng Nhập Khẩu,275.0,9342108571607,610000,610000,0,0,41,thiet-bi-kts-phu-kien-so
174593826,Lót chuột máy tính PixLink kích thước 22x18cm hàng chính hãng,2899.0,7965972194609,15000,29000,14000,48,138,thiet-bi-kts-phu-kien-so
165032162,Ốp lưng dành cho Samsung Galaxy S21 FE Rugged Shield Cao Cấp - Hàng Nhập Khẩu,47.0,8118821459797,95998,95998,0,0,10,thiet-bi-kts-phu-kien-so
162747786,Bàn phím văn phòng có dây Newmen E007-Hàng chính hãng,4.0,6480552955887,189000,189000,0,0,1,thiet-bi-kts-phu-kien-so
160919813,"Micro Thu Âm Cao Cấp CV Cắm cổng USB, Độ Nhậy Cao, Chống ồn, Livestream, Hát Karaoke, quay video, ghi âm, Vlog, Chơi game, Học Online trò chuyện qua Zoom, MSN, SKYPE Tương thích máy tính để bàn, Laptop, MAC OS- Hàng chính hãng",24.0,4946743127372,880000,880000,0,0,4,thiet-bi-kts-phu-kien-so
154835064,Đồng hồ Thông minh Trẻ em Model Q15 lắp SIM nghe gọi 2 chiều 3 màu Xanh Hồng Đen Hàng chính hãng,491.0,1480484102390,400000,400000,0,0,110,thiet-bi-kts-phu-kien-so
149248936,Bao Da ipad Gen 9 20201 kèm khay đựng bút chính hãng MUTURAL - Hàng nhập khẩu,34.0,3091964652053,239899,349999,110100,31,7,thiet-bi-kts-phu-kien-so
111982297,"Dây Cáp Thunderbolt 4 Chuẩn Intel CHOETECH A3010-BK Dài 0.8M, 40Gbps, Sạc PD 100W, 8K 60Hz, 5K 60Hz, 4K 60Hz Kép - Hàng Chính Hãng",169.0,1954855125834,699000,1090000,391000,36,30,thiet-bi-kts-phu-kien-so
98149754,Bao Da Dành Cho iPad Pro 11 inch 2021/2022 và iPad Pro 12.9 inch 2021/2022 ESR Rebound Magnetic Slim Case - Hàng Nhập Khẩu,335.0,4951054187843,850000,850000,0,0,92,thiet-bi-kts-phu-kien-so
87107826,"Dây Cáp Sạc Type C To Lightning CHOETECH IP0039 MFI C94 Dài 1.2M Sạc Nhanh 20W Dành Cho iPhone 11, 12, IP13, IP14, Cho iPad - Hàng Chính Hãng",400.0,8935678253110,269000,450000,181000,40,83,thiet-bi-kts-phu-kien-so
74530820,"Giá Đỡ Kẹp Điện Thoại, Máy Tính Bảng Có Chân Kẹp Đầu Giường, Cạnh Bàn Hàng Xoay Chuyển – Điều Chỉnh Góc Độ Tùy Thích Hàng Chính Hãng ",288.0,7614390569431,199000,199000,0,0,78,thiet-bi-kts-phu-kien-so
72014868,Ốp lưng da cao cấp dành cho iPhone 12 / 12 Pro / 12 Pro Max / 12 Mini,463.0,9960945467041,149000,199000,50000,25,161,thiet-bi-kts-phu-kien-so
69238917,Dây cáp sạc nhanh 100W chuẩn PD 2.0 Type C to type-c QC 3.0 hiệu Baseus Cafule type c to Type C cho iPad Pro 2018 / 2020 / Samsung / Huawei / Xiaomi / Tablet / Macbook / Laptop Type C - Hàng nhập khẩu,740.0,4634677542639,119000,119000,0,0,147,thiet-bi-kts-phu-kien-so
56879851,Chuột Quang MACRO HXJS J900 RGB Bề Mặt Lưới Xuyên Thấu Cực Đẹp DPI 6400 - Hàng chính hãng,239.0,5303412275109,299000,399000,100000,25,84,thiet-bi-kts-phu-kien-so
45586976,Đế tản nhiệt COOLING PAD cho laptop - Hàng nhập khẩu,26.0,3379631321127,117900,117900,0,0,1,thiet-bi-kts-phu-kien-so
277005436,"Bộ 2 Giá Treo Loa Móc Cao Cấp Xoay 360 độ, chịu trọng lượng loa 45kg bền đẹp - Hàng chính hãng",14.0,4990853468063,149000,149000,0,0,0,thiet-bi-kts-phu-kien-so
276807578,"Thiết bị định vi toàn cầu GPS S2 Tag dành Apple Find My, định vị chính xác vị trí đồ vật, thú cưng, chìa khóa, xe cộ -  Hàng chính hãng/Hàng nhập khẩu",18.0,9962503122025,109000,238000,129000,54,3,thiet-bi-kts-phu-kien-so
276515204,Tai nghe bluetooth nhét tai RiBi X55 - Siêu mỏng - Nằm gọn trong tai - Không gây đau tai - Invisible Wearing - Hàng chính hãng,85.0,7511449582082,99000,138000,39000,28,21,thiet-bi-kts-phu-kien-so
276445779,"Giá Kệ Để Cây Máy Tính CPU Có Thể Thay Đổi Kích Thước, Hàng Nhập Khẩu",13.0,1650181311501,139000,250000,111000,44,1,thiet-bi-kts-phu-kien-so
276238106,Sò Lạnh Quạt Tản Nhiệt Điện Thoại Chính Hãng GM10/GM26 thế hệ mới làm lạnh siêu nhanh chơi game siêu mượt giúp tăng FPS - Bảo Hành 12 Tháng - Hàng Chính Hãng,14.0,3630209772125,259000,259000,0,0,1,thiet-bi-kts-phu-kien-so
276005793,Chuột không dây HXSJ T67 6 nút cầm tay công thái học dùng cho văn phòng chơi game chuyên nghiệp - hàng chính hãng,8.0,4205679729298,99000,149000,50000,34,0,thiet-bi-kts-phu-kien-so
275507775,"Dây cắm AUX 2 đầu 3.5 dùng kết nối Loa Bluetooth với Máy tính, Laptop, TV, cáp âm thanh, jack 3.5mm dài 50cm - Hàng nhập khẩu",47.0,6238302399066,19000,19000,0,0,1,thiet-bi-kts-phu-kien-so
275378015,Lót Chuột vải cho máy tính laptop Nhiều Mẫu hàng nhập khẩu,39.0,3309814348140,55000,55000,0,0,5,thiet-bi-kts-phu-kien-so
275224684,Củ Sạc LINRUI Hỗ Trợ Sạc Nhanh QC3.0 PD20W - Hàng Chính Hãng,12.0,7003258493021,219000,219000,0,0,1,thiet-bi-kts-phu-kien-so
275207839,Chuột Led Không Dây GX9 - Bluetooth + Wireless USB 2.4G - Pin sạc - Chống ồn cho máy tính Laptop hàng nhập khẩu,54.0,8999923245424,195000,195000,0,0,7,thiet-bi-kts-phu-kien-so
274384609,"Hub Type C FIRO 11in1 - Hub Chuyển Đổi Type C To HDMI Chuẩn HDTV - 1 Cổng HDMI 4K, 1 Cổng VGA, 1 Cổng Mạng Lan, 1 Cổng Type C PD, 4 Cổng USB 3.0&2.0, 2 Khe Đọc Thẻ TF/SD, 1 Cổng Audio - Kết Nối Tốc Độ Cao-Dùng Cho Smartphone/Laptop/PC/Tivi-Hàng Chính Hãng",111.0,5172107653657,659000,1279000,620000,48,12,thiet-bi-kts-phu-kien-so
274180163,Chuột Không Dây GX9 - Bluetooth + Wireless 2.4G - Pin sạc - Chống ồn -Dru-hàng chính hãng ,37.0,2651789859361,168000,210000,42000,20,8,thiet-bi-kts-phu-kien-so
273906522,"Cáp sạc USB to IP iCybernet IC-1001 sạc 2.4A và truyền dữ liệu đồng thời, chiều dài 1,2m - Hàng chính hãng",291.0,4034962079830,50000,100000,50000,50,32,thiet-bi-kts-phu-kien-so
273445189,"Bộ sạc điện thoại cho Iphone và Android hoco. C106 cổng USB sạc nhanh 2.1A dây dài 1M, dòng điện ổn định an toàn bảo vệ máy - Hàng Chính Hãng",153.0,1347620375359,69000,69000,0,0,21,thiet-bi-kts-phu-kien-so
273289076,Củ Sạc Samsung 25W ( (EP-T2510) Không kèm Cáp- Hàng Chính Hãng,18.0,6737497857731,189000,189000,0,0,5,thiet-bi-kts-phu-kien-so
272125991,"Dây sạc đa năng 3 đầu X76 sạc tất cả các dòng máy 3 trong 1 tiện lợi, Dây dài 1m dòng 2A dây dù chống đứt chống rối siêu bền - Hàng Chính Hãng",208.0,7369683695667,79000,79000,0,0,37,thiet-bi-kts-phu-kien-so
271222060,"Micro thu âm cài áo không dây dùng quay tiktok, quay video - Hàng chính hãng",405.0,8168342249259,237500,250000,12500,5,46,thiet-bi-kts-phu-kien-so
263419899,"Hub Type C FIRO 6in1 - Hub Chuyển Đổi Type C To HDMI Chuẩn HDTV - 1 Cổng HDMI/HDTV 4K, 2 Cổng USB 3.0, 2 Khe Đọc Thẻ TF Và SD, 1 Cổng Sạc Nhanh Type C PD - Kết Nối Tốc Độ Cao - Dùng Cho Tivi/Laptop/Playstation/PC/Smartphone – Hàng Chính Hãng",305.0,8876831140504,299000,579000,280000,48,26,thiet-bi-kts-phu-kien-so
262478106,"Lót Chuột FIRO - Miếng Lót Chuột Cỡ Lớn 80cmx40cm - Tấm Lót Chuột, Pad Chuột FIRO Sử Dụng 2 Mặt Tiện Lợi - Chất Liệu Da PU Cao Cấp - Thiết Kế Sang Trọng - Chống Nhăn, Chống Nước, Chống Bám Bụi - Hàng Chính Hãng",412.0,8588750689810,138000,265000,127000,48,38,thiet-bi-kts-phu-kien-so
209163201,Tai Nghe Bluetooth Nhét Tai Không Dây FIRO Fi5 Pro2 - Pin Dock Sạc 300mAh - Bluetooth 5.3 - Tai Nghe FIRO Fi5 Pro2 Điều Khiển Cảm Ứng Thông Minh - Công Nghệ Kháng Nước IPX5 - Tai Nghe Không Dây FIRO Fi5 Pro2 - Phù Hợp Với Tất Cả Dòng Máy - Hàng Chính Hãng,213.0,2913439618467,385000,739000,354000,48,29,thiet-bi-kts-phu-kien-so
196718477,Ốp lưng kéo nắp hỗ trợ sạc từ tính dành cho iPhone 12 / 13 / 14 / 15 / 12 Pro / 12 Pro Max / 13 Mini / 13 Pro / 13 Pro Max / 14 Plus / 14 Pro / 14 Pro Max / 15 Plus / 15 Pro / 15 Pro Max - Hàng chính hãng,272.0,5392370045005,239000,250000,11000,4,53,thiet-bi-kts-phu-kien-so
191501918,Dây Cao Su Thay Thế cho Samsung Galaxy Fit 2 (SM-R220)- Hàng chính hãng,506.0,3858993326658,75000,75000,0,0,89,thiet-bi-kts-phu-kien-so
178077895,Giá Đỡ Máy Tính Laptop Macbook Besti BTY01 Hợp Kim Nhôm Cao Cấp Giúp Tản Nhiệt Có Thể Tháo Rời - Hàng Chính Hãng ,64.0,6992162808289,370000,370000,0,0,14,thiet-bi-kts-phu-kien-so
158868825,[FREE 6 Tháng] SIM MAX DATA 4G VIETNAMOBILE 6GB/Ngày + Miễn Phí Gọi Nội Mạng. Trọn Gói 6 Tháng Không Cần Nạp Tiền - Hàng Chính Hãng,639.0,1957606254728,299000,299000,0,0,90,thiet-bi-kts-phu-kien-so
143860118,Sạc dự phòng 20000mAh sạc nhanh không dây 15W Remax RPP-207 sạc nhanh 22.5W QC3.0 - Hàng chính hãng,391.0,8178129402985,599000,900000,301000,33,121,thiet-bi-kts-phu-kien-so
137118482,"SIM 4G VINAPHONE 500GB/THÁNG - U1500 KHÔNG GIỚI HẠN DATA ( CÓ 500Gb/tháng tốc độ 4G, hết vẫn tiếp tục dùng KHÔNG GIỚI HẠN DUNG LƯỢNG với tốc độ cao 5Mbps) - Hàng chính hãng",266.0,2244701771338,950000,950000,0,0,53,thiet-bi-kts-phu-kien-so
134364129,Bộ Thu Phát Bluetooth TP-Link UB500 USB Nano Bluetooth 5.0 - Hàng Chính Hãng,109.0,9696747624729,114000,199000,85000,43,8,thiet-bi-kts-phu-kien-so
111050867,Cáp sạc nhanh 2.4A và truyền dữ liệu cho android Remax Colorful Light RC-152m [Hàng chính hãng],880.0,5333069254429,99000,150000,51000,34,199,thiet-bi-kts-phu-kien-so
95681232,Adapter Sạc Anker 1 cổng 65W Hỗ Trợ Sạc Nhanh PIQ 3.0 PowerPort III Pod Lite - A2718 - Hàng chính hãng,546.0,4148796130805,449000,750000,301000,40,92,thiet-bi-kts-phu-kien-so
79887552,"Tai nghe không dây blueetooth LANITH cao cấp 5.0 TWS F9 – Tai nghe Bluetooth kiểu dáng hiện đại, thời thượng - Hàng nhập khẩu – TA0002",76.0,4718097947696,79000,109200,30200,28,9,thiet-bi-kts-phu-kien-so
78011688,"Adapter Củ Sạc 100W 2 Cổng Type C cho Macbook, Laptop, Smartphone CHOETECH PD6008 Kèm Dây Cáp Type C to C 100W - Hàng Chính Hãng",160.0,6120792491157,899000,1500000,601000,40,38,thiet-bi-kts-phu-kien-so
73315307,Thẻ Nhớ microSD SanDisk Ultra 64GB UHS-I - 100MB/s (New 2020) - Hàng Nhập Khẩu,7594.0,1804693412350,135000,135000,0,0,999,thiet-bi-kts-phu-kien-so
67975846,"Giá đỡ kẹp điện thoại cho xe máy/ xe mô tô Selfiecom C2 - Chống trộm, chống rung lắc, dễ dàng lắp đặt",104.0,8955702075325,37000,37000,0,0,29,thiet-bi-kts-phu-kien-so
67907870,Chuột Bluetooth Silent Logitech Pebble M350 - Hàng chính hãng,20.0,3760895905121,469000,469000,0,0,3,thiet-bi-kts-phu-kien-so
36007224,Bàn phím có dây Dell KB216 USB - Hàng Chính Hãng,317.0,5962247457113,160000,160000,0,0,3,thiet-bi-kts-phu-kien-so
33762008,Miếng Dán Kính Cường Lực Cho Iphone 11 - Màu Đen - Full Màn Hình - Hàng Chính Hãng,16.0,8695055448062,35999,35999,0,0,0,thiet-bi-kts-phu-kien-so
1600005,Tai Nghe Nhét Tai Mi Basic Xiaomi HSEJ03JY - Hàng Chính Hãng,37.0,7963621275338,109000,109000,0,0,4,thiet-bi-kts-phu-kien-so
554401,Đầu Nối HDMI Ugreen (20107) - Hàng Chính Hãng,1272.0,1520145846824,48100,60000,11900,20,199,thiet-bi-kts-phu-kien-so
370998,Chuột Có Dây Logitech M100R - Hàng Chính Hãng,79.0,6707473552275,118000,118000,0,0,6,thiet-bi-kts-phu-kien-so
360738,"Tay cầm chơi game console có dây Logitech F310 - 4 phím di chuyển D-Pad, tương thích TV Android, dây 1.8m - Hàng chính hãng",7.0,1457896146210,469000,469000,0,0,0,thiet-bi-kts-phu-kien-so
277477220,"Giá Đỡ Điện Thoại 3 Trong 1 Kèm Pin Dự Phòng & Loa Bluetooth - Tiện Lợi, Dễ Dàng Mang Theo Khi Di Chuyển - HÀNG CHÍNH HÃNG MINIIN",9.0,6999560680314,99000,99000,0,0,0,thiet-bi-kts-phu-kien-so
276465950,Bao da Máy đọc sách Kindle Paperwhite 6 ( 12th Gen ) - Hàng nhập khẩu,9.0,1845287014849,290000,290000,0,0,0,thiet-bi-kts-phu-kien-so
276273967,Ốp lưng dẻo trong phong cách mới dành cho iPhone 16 / 16 Plus / 16 Pro / 16 Pro Max - Hàng chính hãng,32.0,9237445983471,149000,199000,50000,25,7,thiet-bi-kts-phu-kien-so
276154310,"Cáp sạc thay thế cho các dòng đồng hồ Garmin Fenix 7, Fenix 6, Fenix 5, Forerunner 955, 945, 935, 245, 265, 255, 45, 645, Instinct, Viviactive 3, Venu/ Garmin Epix Gen 2- Hàng Nhập Khẩu",20.0,1530089051041,160000,160000,0,0,4,thiet-bi-kts-phu-kien-so
275802989,Tấm Lót Chuột HT SYS - Hàng Chính Hãng,11.0,3913521223781,100000,179000,79000,44,3,thiet-bi-kts-phu-kien-so
275637708,"Dây Đeo Thép Thay Thế Dành Cho Huawei Watch Fit 3, Kai.N Milanese Pro Huawei Fit 3_ Hàng chính hãng",20.0,8182821265718,149000,149000,0,0,2,thiet-bi-kts-phu-kien-so
275577016,Loa Bluetooth Sony ULT FIELD 1 - Hàng Chính Hãng,20.0,4016678960125,2240000,2990000,750000,25,2,thiet-bi-kts-phu-kien-so
275417415,Lót Chuột Tròn Có Kê Tay Chống Chai Họa Tiết Dễ Thương 18 x 23 cm PaKaSa - Hàng chính hãng,24.0,1311666465998,59000,118000,59000,50,4,thiet-bi-kts-phu-kien-so
275196429,Bàn phím không dây K635 - pin sạc TypeC - đa kết nối bluetooth 5.0 + 3.0 + Usb wireless 2.4g hàng nhập khẩu,19.0,2267998088102,380000,380000,0,0,2,thiet-bi-kts-phu-kien-so
274400149,[TẶNG DÂY SẠC 4 ĐẦU] Sạc Dự Phòng 20000mAh - 66W Siêu nhanh sạc nạp dùng bộ vi mạch thế hệ mới - Hàng nhập khẩu,52.0,4075619785015,179000,179000,0,0,14,thiet-bi-kts-phu-kien-so
273908828,"Bộ sạc nhanh chuẩn PD 20W iCybernet IC-3002 cáp C to C 1,2m (Cáp hỗ trợ sạc tối đa 100W cho mọi thiết bị typeC) - Hàng chính hãng",202.0,4302635868162,179000,300000,121000,40,28,thiet-bi-kts-phu-kien-so
273719219,Giá Đỡ Điện Thoại Máy Tính Bảng Thông Minh S100 Kiêm Kệ Đỡ Cho Điện Thoại Đa Năng Chỉnh Được Chiều Cao - Hàng chính hãng,13.0,5724492465410,189000,189000,0,0,0,thiet-bi-kts-phu-kien-so
273159767,Ốp lưng chống sốc trong suốt cho Samsung Galaxy S23 FE hiệu Likgus Crashproof giúp chống chịu mọi va đập - hàng nhập khẩu,3.0,7449424459731,83999,83999,0,0,0,thiet-bi-kts-phu-kien-so
272128001,Dây Sạc Đa Năng 4 in 1 Hoco X76 dòng sạc 2A dài 1m dây dù siêu bền - 2 đầu dùng cho iPhone - 1 đầu TypeC - 1 đầu micro usb - Hàng Chính Hãng,9.0,2663473143773,75000,75000,0,0,0,thiet-bi-kts-phu-kien-so
262973320,Đế sạc đồng hồ samsung galaxy Watch 4/watch5/Watch 5pro(chân type c)-Hàng chính hãng,85.0,1557061977900,139000,139000,0,0,6,thiet-bi-kts-phu-kien-so
248939498,"Đế Sạc Nhanh Không Dây Hàng Chính Hãng Chuẩn QI, Sạc Không Dây Thông Minh Tiện Lợi Cho/Dành Cho IPhone/SamSung/Xiaomi/Oppo",44.0,9259224982696,150000,150000,0,0,6,thiet-bi-kts-phu-kien-so
207164366,Thẻ nhớ MicroSD Sandisk High Endurance 128GB (SDSQQNR-128G-GN6IA) - Hàng chính hãng,18.0,6288013201829,399000,429000,30000,7,2,thiet-bi-kts-phu-kien-so
201308561,"Chuột game có dây Logitech G102 Lightsync - Tùy chỉnh RGB, 6 nút lập trình, nhẹ, 8000 DPI, PC/Mac - Hàng Chính Hãng",1074.0,2936922418686,439000,439000,0,0,150,thiet-bi-kts-phu-kien-so
195305683,Adapter Sạc ANKER PowerPort III Nano 20W Phiên Bản Marvel Giới Hạn - A2633 - Hàng Chính Hãng,340.0,9279750529947,250000,480000,230000,48,91,thiet-bi-kts-phu-kien-so
191375629,"Tai Nghe Phone Nhét Tai Nghe Nhạc Chơi Game Teement Qkz Ak2 Pro Mới Nhất Âm Thanh Super Bass, Dây Chống Rối, Có Mic Đàm Thoại Tương Thích Điện Thoại Máy Tính Bảng Laptop Pc - Hàng Chính Hãng",124.0,1842867883273,150000,150000,0,0,18,thiet-bi-kts-phu-kien-so
130864784,"Cáp sạc nhanh 100W type c to type c Baseus Cafule Series Metal - dây sạc 2 đầu type c bọc dù dài 1m 2m cho androi samsung oppo,...vv - hàng chính hãng",21.0,6707318251085,79000,79000,0,0,1,thiet-bi-kts-phu-kien-so
130084156,"Cáp sạc cho iPhone/ iPad Baseus Superior Series Fast Charging Data Cable USB to iP (2.4A, 480Mbps, Fast charge, ABS/ TPE Cable)- Hàng chính hãng",4.0,9958370286095,55000,55000,0,0,1,thiet-bi-kts-phu-kien-so
127360244,Ốp lưng lụa dành cho iPhone 13 Pro/ 13 Pro Max chính hãng siêu mỏng 0.3mm bảo vệ camera - Hàng Nhập Khẩu,106.0,5105330452160,98999,149999,51000,34,24,thiet-bi-kts-phu-kien-so
118191706,Tai nghe bluetooth F9 Pro thương hiệu PAGINI phiên bản cập nhật 2021 – Thời gian sử dụng lên tới 4h - Tai nghe không dây mang lại sự tiện lợi cho người sử dụng – Âm thanh trầm ấm - Hàng nhập khẩu,19.0,2918305219155,79000,129000,50000,39,5,thiet-bi-kts-phu-kien-so
111152487,"Bộ Sạc Cho Iphone Hoco C73 2 cổng usb sạc nhanh 2.4A sạc 2 thiết bị cùng lúc, ổn định dòng điện - Hàng Chính Hãng",182.0,3556841265398,89000,89000,0,0,21,thiet-bi-kts-phu-kien-so
104268199,Chuột không dây kiểu đứng sạc pin HXSJ T22 wireless USB 2.4GHz chống mỏi tay chuyên dùng cho pc laptop macbook ipad tivi - Hàng chính hãng,530.0,8023460122789,239000,349000,110000,32,154,thiet-bi-kts-phu-kien-so
91013563,"Remote Quạt Senko Điều Khiển (Tất Cả Các Loại như TR1683, DR1608, TR1628, DH1600) Hàng Chính Hãng",777.0,7296516175994,69000,69000,0,0,92,thiet-bi-kts-phu-kien-so
88928186,"Bộ Củ Sạc Dành Cho Macbook, Laptop, Điện Thoại 65W CHOETECH PD8002 GaN Tech + Type-C to C 100W 1.8M XCC-1002-GY - Hàng Chính Hãng",161.0,2609099903530,1180000,1180000,0,0,31,thiet-bi-kts-phu-kien-so
82033657,Bao Da Case Cover Dành Cho iPad Mini 5/ iPad Pro 11 inch/ iPad Air 3 / iPad Pro 3/ iPad Air 4 / iPad 7/8 / iPad Pro 12.9 inch - Hàng Chính Hãng Có Khe Cắm Apple Pencil,249.0,2446501101601,89000,178000,89000,50,81,thiet-bi-kts-phu-kien-so
77868208,Webcam HXSJ S4 HD 1080P USB3.0 2.0 Có Thể Điều Chỉnh 360° Kèm Mic Cho Cuộc Gọi Video - Hàng Chính Hãng,1463.0,9439761944784,299000,499000,200000,40,457,thiet-bi-kts-phu-kien-so
73768914,"Ốp lưng Memumi cho iPhone 12 mini / 12 Pro /12 Pro Max bảo vệ camera, siêu mỏng 0.3 mm Hàng nhập khẩu",4.0,5973903545921,95000,95000,0,0,0,thiet-bi-kts-phu-kien-so
67517393,Thẻ Nhớ Camera Hikvision 64Gb Class 10 ( Chuyên dùng cho Camera IP ) - Hàng Chính hãng,0.0,7372436652270,185000,185000,0,0,0,thiet-bi-kts-phu-kien-so
58736477,"Giá Đỡ Kẹp Điện Thoại, Máy Tính Bảng Có Chân Kẹp Đầu Giường, Cạnh Bàn Hàng Chính Hãng Helios",73.0,9355864632357,195994,195994,0,0,20,thiet-bi-kts-phu-kien-so
56308749,"Ốp Lưng Kính Cường Lực Trong Suốt, Viền Máy Dẻo Dành Cho Iphone X / XS/ XS Max / XR /  7 8 PLus Hàng Chính Hãng Helios",217.0,8035180071269,108000,108000,0,0,91,thiet-bi-kts-phu-kien-so
25468367,Miếng Lót Chuột (24.5 x 20 cm) - Hàng Nhập Khẩu,33.0,3303361259238,14500,14500,0,0,3,thiet-bi-kts-phu-kien-so
21430781,Máy trợ giảng SHIDU SD-S358 - Hàng Chính Hãng,173.0,8542050579362,410000,410000,0,0,21,thiet-bi-kts-phu-kien-so
2063013,Đầu Đọc Thẻ Nhớ Ugreen 20250 - Hàng Chính Hãng,11.0,1052626885331,170000,184000,14000,8,0,thiet-bi-kts-phu-kien-so
899654,Chuột Không Dây DareU LM115G MultiColor - Hàng Chính Hãng,195.0,6704699352658,229000,229000,0,0,38,thiet-bi-kts-phu-kien-so
515545,"Combo chuột phím không dây Logitech MK215 - nhỏ gọn với đủ phím số, 1 đầu thu USB, không dây 10m, pin 2 năm - Hàng chính hãng",93.0,1479546343534,390000,390000,0,0,14,thiet-bi-kts-phu-kien-so
359483,Bàn Phím Không Dây Logitech K270 - Hàng Chính Hãng,39.0,6802347419866,439000,439000,0,0,6,thiet-bi-kts-phu-kien-so
277614163,Tay Điều Khiển Dùng Cho Quạt Mitsubishi (Đã có pin) - Hàng chính hãng,10.0,9047292552327,75000,75000,0,0,0,thiet-bi-kts-phu-kien-so
276605031,Bao Case Ốp Bảo vệ Silicone cho Airpods 4 (2024) - Hàng Chính Hãng,6.0,5729447202221,99000,99000,0,0,2,thiet-bi-kts-phu-kien-so
276412411,"Ốp nhám siêu mỏng 0.3mm cho iPhone 16 Pro Max / 16 Pro /16 Plus / iphone16 hiệu Memumi, mặt lưng chống trượt, chống bám bẩn - hàng nhập khẩu",8.0,1504247811081,115000,115000,0,0,1,thiet-bi-kts-phu-kien-so
275992445,Thẻ nhớ 64GB/128GB MicroSDXC PNY Elite-X 100 MB/s - Hàng chính hãng,5.0,2617287276682,110000,110000,0,0,0,thiet-bi-kts-phu-kien-so
275794192,[ Type C  Adapter ] Đầu chuyển type C sang USB 3.0  / iP hỗ trợ OTG cho điện thoại tablet laptop UA17 _ hàng Nhập Khẩu,15.0,3934552590784,150000,150000,0,0,0,thiet-bi-kts-phu-kien-so
275542974,"Dây Sạc Nhanh, Cáp Sạc 3 Đầu Công Suất Tối Đa 100W, Sạc Tất Cả Các Dòng Máy, Dây Dài 1-1.2m Loại Dây Dù Chống Đứt - Hàng Nhập Khẩu",15.0,9381493045263,88000,88000,0,0,1,thiet-bi-kts-phu-kien-so
274999494,"Ốp lưng chống sốc cho Samsung Galaxy Z Fold 5 hiệu Xundd Fitted Armor Case trang bị túi khí bảo vệ góc, gờ bảo vệ camera - hàng chính hãng",5.0,3981042163322,195000,195000,0,0,0,thiet-bi-kts-phu-kien-so
274805333,Dây Cáp Nối Dài Âm Thanh 3.5mm Dài 1M AUX001-BK Loa Tai Nghe - Hàng Chính Hãng,8.0,9209908554075,168000,168000,0,0,1,thiet-bi-kts-phu-kien-so
274750424,Chuột Bluetooth Không Dây Máy Tính TEKKIN Có Thể Sạc Lại  - hàng nhập khẩu,27.0,5394041520561,59000,59000,0,0,1,thiet-bi-kts-phu-kien-so
274388406,Dây sạc Cáp sạc Từ tính Đồng hồ Thông minh TK S9 CD99 S16 hình tròn 2 - 4 lõi sạc nhanh Truyền dữ liệu Kết nối máy tính Hàng nhập khẩu,178.0,7548888283374,55000,55000,0,0,7,thiet-bi-kts-phu-kien-so
273908414,"Cáp sạc nhanh IP chuẩn PD 20W iCybernet IC-1003 TypeC to IP chiều dài 1,2m - Hàng chính hãng",474.0,4667409843489,79000,150000,71000,47,58,thiet-bi-kts-phu-kien-so
273363222,"Cáp sạc nhanh WDC-10 WEKOME Type-C to iPh PD20W dành cho iph, ipad [Hàng chính hãng]",9.0,2632879351886,79000,98000,19000,19,2,thiet-bi-kts-phu-kien-so
263648732,"Hub USB Type-C To HDMI FIRO 6in1 Chuẩn HDTV - Hub Chuyển Đổi Type-C Chia 6 Cổng - 1 Cổng HDMI/HDTV 4K, 2 Cổng USB 3.0, 2 Khe Đọc Thẻ TF Và SD, 1 Cổng Sạc Nhanh Type C PD - Kết Nối Tốc Độ Cao - Hub USB FIRO – Hàng Chính Hãng",142.0,9133298808840,299000,579000,280000,48,19,thiet-bi-kts-phu-kien-so
263066197,Ốp Lưng Sần chống sốc cho Samsung Galaxy A34 hiệu Nillkin Super Frosted Shield (Đính kèm giá đỡ hoặc miếng dán từ tính) - Hàng Chính Hãng,24.0,3464756810236,117990,117990,0,0,5,thiet-bi-kts-phu-kien-so
253297311,"Đài Radio NS-8093BT, Bluetooth NNS, Bắt Sóng FM, AM,SW /USB/TF, Cổng Thẻ Nhớ Đài To âm thanh sống động - Hàng Chính Hãng",39.0,4344140190966,390000,390000,0,0,6,thiet-bi-kts-phu-kien-so
216093230,"Chuột có dây Logitech B100 | M90 - Dây dài 1m8, thiết kế ôm tay, thuận cả 2 tay - Hàng chính hãng",1428.0,8217352026851,78000,78000,0,0,124,thiet-bi-kts-phu-kien-so
196928645,Bao da dạng ví dành cho Xiaomi POCO C40 Hanman có quai cài - Hàng nhập khẩu,4.0,6948405792497,150000,150000,0,0,0,thiet-bi-kts-phu-kien-so
189685611,"Cáp Sạc nhanh  2.4 A tự ngắt Gen2 Baseus Explorer Series dùng cho ipad, iPhone 13,12,11promax (USB to IP, Auto Power-Off, 2.4A Fast Charging & Data Cable)- Hàng chính hãng",60.0,9902790962512,150000,269000,119000,44,9,thiet-bi-kts-phu-kien-so
174593802,"Chuột Không Dây PIX-LINK P103A Pin Sạc USB 2.4GHz DPI 1600, Không Tiếng Ồn Sử Dụng Cho PC, Laptop, Tivi Hàng Chính Hãng",127.0,8703448717972,115000,115000,0,0,30,thiet-bi-kts-phu-kien-so
171939157,"Lót chuột Logitech Mouse Pad - Đế cao su chống trượt, lướt dễ dàng, bề mặt chống đổ tràn, bền bỉ, nhỏ gọn - Hàng chính hãng",765.0,6065952362771,249000,249000,0,0,147,thiet-bi-kts-phu-kien-so
137742771,Bao Da Smart Case Gen2 TPU Dành Cho iPad 10.2 inch/ Air 10.5 inch/ Pro 10.5 inch - Hàng Nhập Khẩu,127.0,9740565429406,89000,178000,89000,50,19,thiet-bi-kts-phu-kien-so
136034105,Giá đỡ điện thoại để bàn Màu Đen Ugreen 80628 LP106 - Hàng Chính Hãng,54.0,9383049929489,88000,88000,0,0,7,thiet-bi-kts-phu-kien-so
135078386,"Chuột không dây HXSJ M103B wireless Bluetooth tự sạc pin siêu mỏng không gây tiếng ồn chuyên dùng cho Máy tính, pc, Laptop, Tivi  - Hàng chính hãng",237.0,5886239261212,159000,249000,90000,36,54,thiet-bi-kts-phu-kien-so
132144149,"Cường Lực Chống Nhìn Trộm KingKong Dành Cho iPhone X-XS, XS Max, iPhone 11, 11Pro, 11ProMax, iPhone 12, 12Mini, 12Pro, 12Pro Max, iPhone 13, 13Mini, 13Pro, 13Pro Max - Dán Full Màn - Hàng Chính Hãng",476.0,4590771378820,99990,99990,0,0,54,thiet-bi-kts-phu-kien-so
124088830,"Bộ Sạc Hoco C72 Cho iPhone, iPad.,.. - Sạc Nhanh Tối Đa 2.1 A, Bảo Vệ Mạch Điện - Hàng Chính Hãng",105.0,3438276630502,89000,89000,0,0,17,thiet-bi-kts-phu-kien-so
115980611,"Tẩu sạc cho ô tô Baseus sạc nhanh 45W chuẩn PD , Q.C 3.0 - Hàng Chính Hãng",282.0,3054451884305,299000,299000,0,0,36,thiet-bi-kts-phu-kien-so
112937202,Chuột DareU Gaming EM908 (LED RGB) - Hàng Chính Hãng,181.0,8010948382951,315000,315000,0,0,59,thiet-bi-kts-phu-kien-so
112087792,"Thẻ nhớ chuyên camera Mirco SD HIKVISION  64G - 32GB - 92MB/s, chuyên ghi hình cho camera, máy ảnh, ... Hàng nhập khẩu",442.0,6070263703269,79000,79000,0,0,32,thiet-bi-kts-phu-kien-so
110376984,Ốp dẻo cao cấp dành cho iPhone 12 / 12 Pro / 12 Pro Max / 12 Mini  - Hàng chính hãng,88.0,3249073364699,69000,119000,50000,42,15,thiet-bi-kts-phu-kien-so
107067035,Thẻ Nhớ SanDisk Ultra MicroSDXC UHS-1 100 MB/s Class 10 32GB/64GB/128GB - Hàng Chính Hãng,418.0,1765042388292,118000,118000,0,0,45,thiet-bi-kts-phu-kien-so
101891086,Tai nghe AUX 3.5mm Baseus Encok H19 Wired Earphone-Hàng Chính Hãng Baseus,14.0,3817010403506,109000,199000,90000,45,1,thiet-bi-kts-phu-kien-so
87108804,Dây Cáp Sạc Điện Thoại USB Type C To Type C 30W Dài 1M CHOETECH CC0002-V2 - Hàng Chính Hãng,67.0,1715673145999,99000,180000,81000,45,15,thiet-bi-kts-phu-kien-so
87108370,Dây Cáp Sạc Nhanh USB Type C To Type C 60W Dài 1.2M Hỗ Trợ Sạc Nhanh iPhone 15 CHOETECH XCC-1003 - Hàng Chính Hãng,274.0,3807336408507,180000,180000,0,0,70,thiet-bi-kts-phu-kien-so
76176924,"VINETTEAM Giá Đỡ Laptop Nhôm N8 Màu Bạc Thiết Kế Thông Minh 2 Tầng Điều Chỉnh Độ Cao, Gấp Gọn Và Tản Nhiệt Cho Laptop, Surface, Ipad, Macbook Cho Máy Từ 12~17inch - Hàng Chính Hãng",7.0,9984268675310,263940,263940,0,0,0,thiet-bi-kts-phu-kien-so
75801356,Tai Nghe True Wireless Earbuds SoundPeats Mac - Hàng chính hãng,160.0,8662621012095,568000,798000,230000,29,41,thiet-bi-kts-phu-kien-so
57842537,Củ Sạc Nhanh Cho Iphone Hoco C80 - Hỗ trợ sạc nhanh 20W PD QC3.0 - Hàng Chính Hãng,269.0,9203332143396,110000,125000,15000,12,50,thiet-bi-kts-phu-kien-so
26267844,Cáp âm thanh 3.5Mm nối dài 1M UGREEN 40673Av118-Hàng chính hãng,22.0,5247877510927,60000,60000,0,0,5,thiet-bi-kts-phu-kien-so
23542112,Cáp sạc ngắn cho iPhone/iPad/iPod Baseus Nimble 2A 23cm - Hàng Chính Hãng,45.0,6201838715843,71000,71000,0,0,12,thiet-bi-kts-phu-kien-so
11477102,Adapter Sạc 2 Cổng Anker PowerPort Mini 12W - A2620 - Hàng Chính Hãng,62.0,9794263453574,159000,159000,0,0,13,thiet-bi-kts-phu-kien-so
2001029,Bộ Chuyển Đổi Ugreen HDMI Sang VGA Audio Cáp Tròn Có Nguồn Phụ 40253 - Hàng Chính Hãng,1760.0,2978161678858,170000,260000,90000,35,281,thiet-bi-kts-phu-kien-so
27577966,Máy Xay Sinh Tố Lock&Lock EJM462 (350W - 1.2 Lít) - Hàng Chính Hãng,1004.0,1750319309651,775000,1723000,948000,55,198,dien-gia-dung
273310816,Máy Vắt Cam Lock&Lock EJJ231 (40W) - Hàng chính hãng,29073.0,2796150178083,282000,475000,193000,41,3876,dien-gia-dung
271421508,Nồi cơm điện Locknlock Nemo Rice Cooker EJR384IVY (605W - 1.2L) - Hàng Chính Hãng,92.0,5564344693148,1826000,2825000,999000,35,13,dien-gia-dung
275332051,"Máy hút bụi cầm tay mini Locknlock ENV136WHT Mini vacuum cleaner - 14V, 500mA, 75W - Dung tích 0.5L- Hàng chính hãng",40.0,3212166748075,1350000,1920000,570000,30,4,dien-gia-dung
3480333,Bình Đun Siêu Tốc 2 lớp Lock&Lock EJK738WHT (1.7 Lít) - Trắng - Hàng chính hãng,15162.0,1675525008344,544000,837000,293000,35,2534,dien-gia-dung
277348495,"Nồi cơm điện tử 1.8L Sunhouse SHD8909B - 6 chế dộ, giữ ấm 12 tiếng - Mâm nhiệt lớn, cơm dẻo, chín đều - Hàng chính hãng",2.0,7084391348842,1100000,1530000,430000,28,0,dien-gia-dung
275522847,"Quạt tuần hoàn không khí Elmich CFE-8787, quạt làm mát diện rộng và làm mới không khí, gọn nhẹ, dễ dàng mang theo mọi nơi - Hàng chính hãng",107.0,4309004697729,848000,1669000,821000,49,18,dien-gia-dung
275522844,"Quạt sạc tuần hoàn không khí Elmich CFE-8786, dung lượng pin lớn, hoạt động liên tục tới 10h, tạo nên luồng gió mạnh,  di chuyển linh hoạt 90° theo chiều ngang tạo luồng gió đa chiều, làm mát nhanh, dễ chịu - Hàng chính hãng",14.0,5257000082047,1460000,2490000,1030000,41,2,dien-gia-dung
275515112,Nồi áp suất Elmich PCE-1805 dung tích 2.5L - Hàng Chính Hãng,895.0,5075273721539,1000000,2090000,1090000,52,179,dien-gia-dung
26020574,Bếp Dương Từ Đôi Proficook PC-DKI 1067 (3500W) - Hàng Chính Hãng,8.0,6895748252934,4734000,4734000,0,0,2,dien-gia-dung
201843850,Máy ép chậm Nagakawa NAG0818 (200W) - Trục ép 6 phân đoạn kiệt bã - Ống tiếp thực phẩm lớn - Hàng chính hãng,19.0,8226535741335,1500000,3490000,1990000,57,7,dien-gia-dung
4701559,Ấm Điện Thủy Tinh Siêu Tốc Có Điều Chỉnh Nhiệt Độ Lock&Lock EJK341 (1.8L) - Hàng chính hãng,15045.0,3002117730471,819000,1260000,441000,35,2651,dien-gia-dung
112723721,Bếp Gas Âm Kết Hợp Bếp Từ Keplercook KL201C( 78cm-2000w)- Hàng Chính Hãng,4.0,4630688067744,3416000,3416000,0,0,1,dien-gia-dung
274541135,"Máy Đánh Trứng, Đánh Sữa Và Tạo Bọt Cafe Cầm Tay Di Động 3 Tốc Độ Sử Dụng Pin Sạc Cao Cấp - Hàng chính hãng",267.0,7412283967097,105000,115000,10000,9,22,dien-gia-dung
275294279,Máy Xay Thịt Đa Năng Cối Inox 2 Lít Dao Thép 4 Lưỡi Siêu Khoẻ - Hàng nhập khẩu,28.0,1485307754834,189000,250000,61000,24,1,dien-gia-dung
273569820,Máy ép chậm trái cây Famco 9701FC - Hàng Chính Hãng,23.0,3276587784554,1089000,2150000,1061000,49,4,dien-gia-dung
273568833,Nồi lẩu điện Elmich mini đa năng 1.5L MPE-3911 - Hàng Chính Hãng,289.0,9259050198097,381000,690000,309000,45,36,dien-gia-dung
273561794,"Nồi nấu chậm, nấu cháo, chưng yến 1L Elmich SCE-8524OL - Hàng Chính Hãng",418.0,7145419161259,540000,999000,459000,46,48,dien-gia-dung
133412437,Bếp 3 từ Keplercook KL175TDI (73cm. 5.500w)- Hàng chính hãng,0.0,4937790652285,6500000,6500000,0,0,0,dien-gia-dung
26141367,Bếp Âm Từ 4 Bếp Lofra HIN604 (58cm - 7200W) - Hàng Chính Hãng,0.0,5453054561822,25191000,25191000,0,0,0,dien-gia-dung
26020619,Bếp Âm Từ Đôi Dual D813 (70cm - 4000W) - Hàng Chính Hãng,0.0,2048425700219,9534000,9534000,0,0,0,dien-gia-dung
112706070,"Bếp Điện Từ Keplerccok KL68ICSN ( 73cm, 4000w) - Hàng Chính Hãng",1.0,1686924819302,3185000,3185000,0,0,0,dien-gia-dung
112686780,"Bếp 2 Từ KL79IIS ( 73cm, 4000w) - Hàng Chính Hãng",0.0,5046638821163,6136000,6136000,0,0,0,dien-gia-dung
273358997,Bếp điện từ Elmich ICE 3879 - Hàng Chính Hãng,67.0,9556247644207,1120000,1800000,680000,38,17,dien-gia-dung
273358116,Máy sấy tóc Elmich HDE 1823 - Hàng Chính Hãng,256.0,8763546031204,341000,599000,258000,43,27,dien-gia-dung
273170734,"Máy vắt cam tự động Bear CZJ-A04B1, dung tích 400ml, dễ dàng vệ sinh, công suất 30W - HÀNG CHÍNH HÃNG",22.0,9422386700218,390000,390000,0,0,1,dien-gia-dung
271199622,Máy xay sinh tố cầm tay Elmich BLE 3890 (55W) - Hàng chính hãng,163.0,1466679054718,511000,899000,388000,43,18,dien-gia-dung
271199618,Máy xay sinh tố cầm tay Elmich BLE 3889 (55W) - Hàng chính hãng,100.0,3681042080026,478000,899000,421000,47,13,dien-gia-dung
271199608,"Máy làm sữa hạt Elmich CBE 3904 OL, công suất 800W, 7 chế độ nấu được thiết lập sẵn, lưỡi dao 3 tầng 8 cánh giúp xay nhuyễn - Hàng chính hãng",380.0,1931759872579,1530000,3300000,1770000,54,74,dien-gia-dung
263967937,Máy pha cà phê Bear SB-CF06A - Hàng chính hãng,167.0,1195253014306,448000,790000,342000,43,32,dien-gia-dung
191595065,Bàn ủi cầm tay Tefal DT8230E1 - Hàng chính hãng,18.0,7525331160878,1338000,1999000,661000,33,1,dien-gia-dung
188042106,Bàn ủi hơi nước cầm tay PHILIPS STH1000/10 (900W) - Hàng Chính Hãng,75.0,6781580738433,749000,958800,209800,22,7,dien-gia-dung
184973099,"Máy Hút Bụi Cầm Tay Không Dây VinBuy Lực Hút Mạnh Mẽ 16000PA Chức Năng Hút Bụi Khô Và Ướt - Máy Hút Bụi Ô Tô, Máy Hút Bụi Gia Đình - Hàng Chính Hãng",3138.0,9225409194779,435000,800000,365000,46,456,dien-gia-dung
173550857,"Máy ép chậm Elmich JEE - 1855OL, công suất 240W, ống tiếp nguyên liệu rộng 83mm, độ ồn cực thấp 55 dB - Hàng chính hãng (New)",606.0,2424669364588,1900000,3890000,1990000,51,123,dien-gia-dung
162841495,Máy cạo râu khô và ướt Philips S1103/02 - Hàng Chính Hãng,619.0,8726430708489,572000,935000,363000,39,92,dien-gia-dung
104908436,"Quạt mini để bàn, quạt tích điện usb CTFAST M102 - Quạt cầm tay 3 tốc độ, điều chỉnh hướng gió 360 độ, không gây ồn, pin sạc dung lượng cao - hàng chính hãng",2944.0,5423811666686,209000,209000,0,0,675,dien-gia-dung
104850983,"Quạt mini để bàn, quạt USB tích điện cầm tay CTFAST - M109 : Thiết kế thông minh 3 tốc độ làm mát, chất liệu cao cấp bền bỉ, điều chỉnh 360 độ, không gây ồn, pin sạc 1200mah, dễ dàng mang theo sử dụng - hàng chính hãng",986.0,7206211262449,140000,199000,59000,30,160,dien-gia-dung
102431931,Ấm Đun Siêu Tốc Inox 2 Lớp Sunhouse SHD1353 (1.8 Lít) - Hàng Chính Hãng,1673.0,9024023778409,293000,461000,168000,36,382,dien-gia-dung
78488079,Quạt Điện Đứng Senko L1638 - Giao Màu Ngẫu Nhiên - Hàng Chính Hãng,911.0,2498850038438,365000,365000,0,0,183,dien-gia-dung
77767851,Máy lọc không khí SUNHOUSE SHD-15AP9715 (40W) - Hàng chính hãng,1070.0,4806403979470,1240000,2030000,790000,39,343,dien-gia-dung
68258241,Máy hút bụi cầm tay Deerma DX115C (600W) - Hàng Chính Hãng,39.0,2051550020312,499000,499000,0,0,3,dien-gia-dung
48537880,Ấm Siêu Tốc Inox SUNHOUSE HAPPY TIME HTD1055 (1.5L) - Hàng Chính Hãng,10820.0,2614497209006,158000,190000,32000,17,2494,dien-gia-dung
34281542,Quạt Đứng Toshiba F-LSA10(K)VN (50W) - Hàng Chính Hãng,3759.0,9886642203853,881000,1050000,169000,16,638,dien-gia-dung
31276266,Máy Hút Bụi Mini Cầm Tay DEERMA - Hàng Chính Hãng,2595.0,5313067433519,489000,489000,0,0,390,dien-gia-dung
26078293,Quạt đứng Toshiba F-LSA10(H)VN (50W) - Xám - Hàng chính hãng,58.0,6910223627813,989000,1171000,182000,16,13,dien-gia-dung
3619821,Máy cạo râu Panasonic ES6850 - Hàng Chính Hãng,429.0,2011450991471,255000,255000,0,0,144,dien-gia-dung
2635471,Quạt Đứng Toshiba F-LSD10(H)VN (30W) - Xám - Hàng chính hãng,1394.0,7570202794319,1697000,1740000,43000,2,371,dien-gia-dung
684651,Ấm Siêu Tốc Inox Happy Time Sunhouse HTD1081 (1.8 lít)- Hàng chính hãng,9700.0,1796666148277,138000,220000,82000,37,845,dien-gia-dung
530774,Bếp Hồng Ngoại Sunhouse SHD6011 (2000W) - Đen- hàng chính hãng,13616.0,1987689927967,630000,894000,264000,30,2723,dien-gia-dung
54716577,Bình Đun Siêu Tốc 2 Lớp Lock&Lock EJK738BLK (1.7L) - Hàng Chính Hãng,9463.0,5062880816121,497000,837000,340000,41,2134,dien-gia-dung
277539595,"Quạt Cầm Tay Turbo Mini Tích Điện Tốc Độ Gió Mạnh, 100 Chế Độ Làm Mát, Màn Hình LED Hiển Thị Nhỏ Gọn Mang Đi - Hàng nhập khẩu",9.0,6046742632818,119000,138000,19000,14,1,dien-gia-dung
276946145,Lõi lọc nước số 1 Kangaroo Extra - Hàng chính hãng,25.0,2312606520333,30000,70000,40000,57,0,dien-gia-dung
276008980,"Quạt Mini Để Bàn , Quạt Tích Điện Tích Hợp Đèn Ngủ, Quạt Kẹp Bàn Besti- Quạt Cầm Tay 3 Tốc Độ, Điều Chỉnh Hướng Gió 360 Độ, Không Gây Ồn, Pin Sạc Dung Lượng Cao - Hàng Chính Hãng ",34.0,8234574973051,230000,230000,0,0,6,dien-gia-dung
275512782,"Máy xay thịt, xay thực phẩm cho bé Elmich CHE-8665, 6 lưỡi inox 304 xay nhanh, nhuyễn mịn, đảo trộn đồng đều các loại thực phẩm, an toàn tuyệt đối với trẻ nhỏ - Hàng chính hãng",58.0,7750022713261,443000,990000,547000,55,13,dien-gia-dung
275494225,Nồi chiên không dầu Philips 6.2 lít NA230/00  - Hàng chính hãng,26.0,6151034622840,2200000,2999000,799000,27,7,dien-gia-dung
275481655,"Máy cạo râu Enchen Mini 6, lưỡi dao kép tự mài siêu mỏng, chống nước IPX7 cạo khô và ước, pin trâu - Hàng chính hãng",35.0,3522140536556,189000,249000,60000,24,4,dien-gia-dung
275068673,Bếp đôi điện từ hồng ngoại Sunhouse SHB81011-EC - Hàng chính hãng,55.0,9015689268057,2390000,3432000,1042000,30,3,dien-gia-dung
274554505,"Máy sấy tóc công nghệ ion Elmich HDE-8591, công suất 1900W, tay cầm gấp gọn tiện dụng, sấy ion với mật độ lên tới 1,2 triệu ion/m3 kèm lực gió khỏe - Hàng Chính Hãng",69.0,4964088743785,648000,1290000,642000,50,6,dien-gia-dung
274160498,Nồi chiên không dầu 5.5L Sunhouse SHD4022 - Hàng chính hãng,289.0,1279772475383,1160000,1700000,540000,32,56,dien-gia-dung
273962380,[Xả lỗ] Tông đơ cắt tóc cao cấp SK - Hàng chính hãng,26.0,4514543967182,142500,150000,7500,5,3,dien-gia-dung
112728718,Bếp Điện Từ Keplercook  Kl79ICS (73cm-4000w)- Hàng Chính Hãng.,0.0,6554831578112,6136000,6136000,0,0,0,dien-gia-dung
271421398,Nồi cơm điện mini LocknLock EJR314IVY (300W) - Hàng chính hãng,214.0,5533983136176,1500000,2140000,640000,30,34,dien-gia-dung
91978576,"Nồi cơm điện áp suất Cuckoo CRP-PK1000S 1,8 lít nhiều màu - Hàng chính hãng",6.0,4442931799920,3490000,5460000,1970000,36,3,dien-gia-dung
120824825,Nồi cơm điện Cuckoo 1.08L CR-0671 - Lòng nồi chống dính - Tiết kiệm điện - Hàng chính hãng Cuckoo Vina,112.0,3389932515235,940000,1180000,240000,20,26,dien-gia-dung
204310795,Máy xay sinh tố Locknlock Multi Blender EJM416WHT (800W) - Hàng chính hãng,305.0,5793593631215,1798000,2781000,983000,35,57,dien-gia-dung
273356998,Quạt không cánh kết hợp lọc không khí Elmich BFE-3936 - Hàng Chính Hãng,23.0,7491318758158,4100000,7799000,3699000,47,5,dien-gia-dung
273263931,Bàn là hơi Sunhouse SHD2065 (1600W) - Hàng chính hãng,115.0,5514860380997,231000,393000,162000,41,8,dien-gia-dung
271289099,"Máy Làm Sữa Hạt, Máy Nấu Sữa Hạt OSTMARS Hàng Chính Hãng MINIIN 800ml - 8 Chức Năng Xay Nấu Tiện Lợi",493.0,3956108987018,369000,369000,0,0,34,dien-gia-dung
270751652,Gioang cao su thay thế cho nồi áp suất điện 5L 6L SUNHOUSE các model - Hàng chính hãng,19.0,9938103157964,20000,20000,0,0,0,dien-gia-dung
270243031,Máy ép chậm Sunhouse Mama SHD5515 600ml - Hàng chính hãng,362.0,2733900398825,1260000,1910000,650000,34,68,dien-gia-dung
249206305,Nồi cơm điện tử Tefal Rice Mate Mini 0.7L RK515168 - Hàng chính hãng,51.0,5551691519466,993000,1699000,706000,42,7,dien-gia-dung
201622469,Máy pha cà phê tự động Bear CF-B02V1 - Hàng chính hãng,81.0,7828345744159,1220000,1590000,370000,23,11,dien-gia-dung
197693898,Nồi chiên không dầu B.COOK Dung tích lớn 6L - Hàng chính hãng,1474.0,7228218631368,590000,590000,0,0,25,dien-gia-dung
187063412,"Máy Xay Sinh Tố Cầm Tay Bear, Nghiền Hoa Quả Công Suất Lớn, Chất Liệu An Toàn LLJ-D04A1 - Hàng Chính Hãng",209.0,6465789121542,521000,790000,269000,34,33,dien-gia-dung
163170724,Máy Lọc Không Khí Xiaomi Mi Air Purifier 4 lite (BHR5274GL) (33W) - Hàng chính hãng,172.0,4557691441440,2000000,3990000,1990000,50,39,dien-gia-dung
147903537,Bếp Từ Đơn Sunhouse SHD6157 (1800W) - Kèm Nồi Lẩu - Hàng Chính Hãng,3665.0,8293191711699,635000,1094000,459000,42,351,dien-gia-dung
143116407,"Máy phun sương xông tinh dầu tạo ẩm Rhino H901 dung tích 420ml, nhỏ gọn, không gây tiếng ồn, tích hợp đèn ngủ RGB nhiều màu, có chế độ tự ngắt - Hàng chính hãng",382.0,5490721493261,90000,129000,39000,30,93,dien-gia-dung
134550148,Nồi cơm điện tử Elmich RCE-1789 (1.2 Lít) - Hàng chính hãng,221.0,9780589593011,1163000,1899000,736000,39,51,dien-gia-dung
133815741,"Nồi Lẩu Điện Đa Năng Mini Ca Nấu Mì, Cơm Đa Năng 2 Tầng Cao Cấp Núm Xoay 2 Nấc Nhiệt Kèm Giá Hấp 1,8L Chính Hãng MINIIN",980.0,9201885680990,99000,99000,0,0,209,dien-gia-dung
126979953,Máy sấy tóc Philips BHD510/00 - Hàng Chính Hãng,355.0,3432964755333,1095000,1555000,460000,30,87,dien-gia-dung
114773096,"Cao su non, băng tan, keo lụa cuốn ren ống nước, cuốn ren co nối, tê máy lọc nước (Cuộn 10 mét) - Hàng chính hãng",179.0,4464592312259,15000,15000,0,0,6,dien-gia-dung
110348059,Nối thẳng 2 đầu ren 13/21/27 dùng trong máy lọc nước - Hàng chính hãng,143.0,4643824534314,15000,15000,0,0,3,dien-gia-dung
107137543,Bếp Từ Đơn Elmich ICE-1828OL (2100W) - Hàng Chính Hãng,600.0,4709785051189,900000,1790000,890000,50,161,dien-gia-dung
74173695,Bộ Lọc Thay Thế Pureit Classic - Hàng chính hãng,331.0,9465552860440,450000,450000,0,0,45,dien-gia-dung
58057114,Máy xay sinh tố Philips HR2223/00 - Hàng Chính Hãng,92.0,3481700140819,1580000,1983600,403600,20,35,dien-gia-dung
20366631,Bàn Ủi Hơi Nước Sunhouse SHD2063P (1600W) – Hàng Chính Hãng,3641.0,2599875951114,230000,332000,102000,31,385,dien-gia-dung
9483224,"Combo 3 lõi lọc nước Karofi 1,2,3 chính hãng",129.0,7900935627224,139000,139000,0,0,31,dien-gia-dung
7270329,Bếp Gas Dương Mặt Kính Sunhouse SHB204MT - Hàng chính hãng,2479.0,9976119170426,548000,1023000,475000,46,439,dien-gia-dung
3873843,Máy Vắt Cam Philips HR-2738 - Hàng Nhập Khẩu,1093.0,1608940672609,549000,549000,0,0,263,dien-gia-dung
3577985,Quạt Đứng Toshiba F- LSA20(W)VN (60W) - Trắng - Hàng chính hãng,3462.0,7647557377563,1200000,1310000,110000,8,697,dien-gia-dung
2393139,Nồi Lẩu Điện Sunhouse SHD4521 (3L) - Hàng chính hãng,7453.0,6696610916141,490000,776000,286000,37,639,dien-gia-dung
729928,Quạt Treo Tường Tường Lồng Nhựa Lifan T-109 - Xám Trắng - Hàng chính hãng,60.0,1679120690157,255000,255000,0,0,11,dien-gia-dung
630207,Bình Đun Siêu Tốc Sunhouse HTD1088 (1.8 lít) - Hàng chính hãng,9588.0,1791253886396,158000,220000,62000,28,1025,dien-gia-dung
392067,Bàn Ủi Khô Philips HD1172/01 (1000W) - Hàng chính hãng,20144.0,1630907572448,309000,389000,80000,21,1450,dien-gia-dung
277613191,"Máy cạo râu Enchen Mini X {New 2025} 15 lưỡi dao tự mài, đầu cạo 3D kháng nước toàn thân pin trâu - Hàng chính hãng",3.0,6716937625583,259000,399000,140000,35,0,dien-gia-dung
277438871,"Máy Xay Sinh Tố Cầm Tay Mini Ostmars - Sạc Tích Điện, 10 Lưỡi Dao Đa Năng, Dung Tích 500ml - HÀNG CHÍNH HÃNG MINIIN",17.0,9400798431704,199000,199000,0,0,1,dien-gia-dung
276438100,Bàn ủi hơi nước Bear IR-4H15H 1500W - Hàng chính hãng,10.0,5941807777902,672000,1090000,418000,38,1,dien-gia-dung
276383377,Máy xay thịt 2 lưỡi dao kép Sunhouse SHD5403 300W - Hàng chính hãng,801.0,6357122680451,387000,650000,263000,40,78,dien-gia-dung
275930457,"Máy Vắt Cam, Máy Ép Cam Tự Động Thế Hệ Mới, Sach USB Tiện Lợi - Hàng Nhập Khẩu",6.0,1498622461082,199000,199000,0,0,0,dien-gia-dung
275826680,Súng Khò Gas Điện Tử Cầm Tay Sử Dụng Bình Ga Mini - Hàng chính hãng ,8.0,2437771604006,49000,98000,49000,50,0,dien-gia-dung
275376515,XẢ KHO NỒI CHIÊN KHÔNG DẦU CAMEL 7L - HÀNG NHẬP KHẨU,31.0,2246012381345,525000,550000,25000,5,1,dien-gia-dung
275004348,Quạt mini cầm tay TEKKIN pin khủng 10000 mah gấp gọn 5 cấp độ gió linh hoạt - hàng nhập khẩu,62.0,5236899673559,129000,129000,0,0,8,dien-gia-dung
274962252,"Lẩu điện Kangaroo KG40EH1, dung tích 4L, công suất 1300W, cấu trúc đĩa truyền nhiệt giúp truyền nhiệt nhanh và đều, an toàn tự ngắt khi quá nhiệt  - Hàng chính hãng",15.0,7514160566376,611000,937000,326000,35,1,dien-gia-dung
274793000,Bình đun siêu tốc Philips 1.7 lít HD9395/90 - Hàng chính hãng,30.0,1877656037176,968000,1399000,431000,31,8,dien-gia-dung
274455551,Máy cạo râu du lịch Magic B-61 - Hàng chính hãng,22.0,8008040143582,339000,690000,351000,51,4,dien-gia-dung
273634419,Nồi cơm điện tử Elmich 0.8L RCE-3915 - Hàng Chính Hãng,88.0,9618093309851,864000,1599000,735000,46,10,dien-gia-dung
273196643,"Tủ sấy quần áo BENNIX màu sắc thời trang, tiện lợi BN-113TS công suất 1500W hàng chính hãng",4.0,1152788795879,850000,850000,0,0,0,dien-gia-dung
273171128,"Máy xay sinh tố cầm tay Bear LLJ-B03C1, dung tích 300ml, lưỡi dao kép xay mạnh, dễ mang theo sử dụng - HÀNG CHÍNH HÃNG",32.0,3075092352461,599000,699000,100000,14,6,dien-gia-dung
272428559,Ấm siêu tốc Elmich KEE 8457 - Hàng Chính Hãng,56.0,1063965927312,708000,990000,282000,28,11,dien-gia-dung
263586550,Máy làm sữa hạt Elmich CBE3902 mẫu mới 2023 điều khiển cảm ứng - Hàng chính hãng,85.0,1005010264013,2050000,3399000,1349000,40,15,dien-gia-dung
262061219,Quạt Tích Điện Để Bàn Xiaomi Lydsto XD-ZMXHS02 - Hàng nhập khẩu,125.0,8689252257177,499000,499000,0,0,23,dien-gia-dung
252132703,Combo 1 bộ 123 + 1 lõi số 1 Sunhouse SHLL (tổng 4 lõi) - Hàng chính hãng ,84.0,4194477797339,128000,172000,44000,26,11,dien-gia-dung
248342498,Phụ Kiện thay thế chuyên dụng dành cho Robot hút bụi Deebot T10,35.0,1879930751425,20000,20000,0,0,0,dien-gia-dung
205251409,Nồi cơm điện Locknlock EJR346BLK (Giữ ấm 24h - 5 chế độ nấu - lòng nồi chống dính) 1.2 Lít - Black - Hàng chính hãng,964.0,3836682293123,1440000,2043000,603000,30,182,dien-gia-dung
147903536,Bếp Từ Đơn Sunhouse SHD6803 (2000W) - Kèm Nồi Lẩu - Hàng Chính Hãng,3654.0,1823297016401,1000000,1187000,187000,16,488,dien-gia-dung
147356517,Máy Xay Sinh Tố PHILIPS HR2041/10 450W - Hàng Chính Hãng,2.0,8922032122830,609000,609000,0,0,0,dien-gia-dung
108020412,"Máy hút chân không thực phẩm Shineye W230 tự động, hút khô và hút ướt với 2 chế độ hàn, tích hợp hàn độc lập, kiểm soát lực hút, hàng chính hãng",702.0,2757382690913,595000,595000,0,0,152,dien-gia-dung
105742554,Máy xay ăn dặm 0.3L Bear QSJ-A01F2 (GR-B03V2) Hàng chính hãng,61.0,9267291510150,395000,620000,225000,36,7,dien-gia-dung
88206665,"Máy Sấy Tóc Philips BHD350/10 - Công Suất 2100W, 3 Chế Độ Sấy, ION - Hàng Chính Hãng",457.0,8112175103873,617000,955000,338000,35,100,dien-gia-dung
81676555,Bàn Ủi Hơi Nước Philips STH3010/70 (1000W) - Hàng Chính Hãng,935.0,5821148925177,834000,1399000,565000,40,193,dien-gia-dung
80964740,"Máy Sấy Tóc Cao Cấp Công Suất Lớn 2200W Chuyên Dụng Cho Hair Salon - Máy Sấy Tóc Bổ Sung Ion Dưỡng Ẩm, Làm Mềm Mượt Tóc - Máy Sấy Tóc Cao Cấp Động Cơ Êm Ái, Ổn Định – Chính Hãng VinBuy",0.0,2556125190270,500000,500000,0,0,288,dien-gia-dung
74890928,Nồi cơm điện tử Toshiba RC-18NTFV(W) (1.8 Lít) - HÀNG CHÍNH HÃNG,2787.0,2009270730707,2352000,2890000,538000,19,803,dien-gia-dung
71111211,TÔNG ĐƠ CẮT TÓC CHUYÊN NGHIỆP KEMEI- KM 809A,1043.0,7052664976507,399000,399000,0,0,289,dien-gia-dung
70818712,Máy Sấy Tóc Panasonic EH-ND21-P645 - Hàng Chính Hãng,28.0,9641648400749,499000,561600,62600,11,4,dien-gia-dung
70527500,Quạt Bàn Tròn Hatari HT-PS20M1 - Hàng Chính Hãng - Màu Ngẫu Nhiên,21.0,8902097384037,470000,470000,0,0,6,dien-gia-dung
57878964,Nồi cơm cao tần Toshiba RC-10IX1PV (1 Lít)- Hàng Chính Hãng,1119.0,1380713925807,2325000,2990000,665000,22,391,dien-gia-dung
52293499,Máy Cạo Râu Xiaomi Enchen BlackStone 3 - Hàng Nhập Khẩu,574.0,3372093162376,290000,290000,0,0,76,dien-gia-dung
44996545,Máy hấp thực phẩm đa năng 03 tầng Magic Korea A61 (10.5 lít) - Hàng Chính Hãng,1848.0,4112129250252,480000,799000,319000,40,333,dien-gia-dung
37535371,Lò Vi Sóng Sharp R-209VN-SK (20 lít) - Hàng Chính Hãng,967.0,4740823068004,1410000,1560000,150000,10,168,dien-gia-dung
6805039,Nồi Cơm Điện Nắp Rời Sunhouse SHD8105 (1.2L) - Hàng chính hãng,650.0,4556248945659,400000,709000,309000,44,62,dien-gia-dung
4754633,Máy Đánh Trứng Philips HR3705 (300W) - Hàng Chính Hãng,3930.0,1112433547232,629000,820000,191000,23,794,dien-gia-dung
2635459,Quạt Treo Tường Toshiba F-WSA20(H)VN (55W) - Xám - Hàng chính hãng,1783.0,5472515783238,1090000,1220000,130000,11,376,dien-gia-dung
1953341,Máy Sấy Tóc Sunhouse SHD2306 - Đen,763.0,5944399452437,240000,340000,100000,29,72,dien-gia-dung
456050,Nồi Cơm Điện Nắp Gài Sharp KS-181TJV - 1.8 L - Hàng chính hãng,3933.0,1894974995160,573000,899000,326000,36,251,dien-gia-dung
277026999,"Bàn là hơi nước cầm tay SOKANY SK-11045 công suất lớn 1200W, là siêu phẳng, siêu nhanh, nhỏ gọn tiện lợi cho cả gia đình -HÀNG CHÍNH HÃNG",106.0,3996737801591,558000,558000,0,0,17,dien-gia-dung
277024305,"Máy sấy tóc ion âm 2 chiều nóng lạnh SOKANY SK14019 công suất 2400W,  chăm sóc tóc, bảo vệ tóc khỏi hư tổn - HÀNG CHÍNH HÃNG",83.0,1300461270523,700000,700000,0,0,17,dien-gia-dung
277008574,"Máy xay thịt đa năng 2IN1 SOKANY SK-7030 cối INOX304, công suất 500W xay thịt, bóc tỏi tiện lợi - HÀNG CHÍNH HÃNG - DELIYA",81.0,7581074399995,610000,610000,0,0,16,dien-gia-dung
276986140,"Máy sấy tóc 2 chiều nóng lạnh SOKANY SK-14020 công suất lớn 2400W, cung cấp ion âm chăm sóc tóc chuyên nghiệp - HÀNG CHÍNH HÃNG - DELIYA",110.0,8086985563066,753000,753000,0,0,16,dien-gia-dung
276031734,NỒI CƠM ĐIỆN 1.8L SUNHOUSE SHD8611N (700W)- Hàng chính hãng,56.0,1772654005222,680000,1100000,420000,38,12,dien-gia-dung
275522845,"Quạt tuần hoàn không khí Elmich CFE-8791, làm mát diện rộng và làm mới không khí tới 20 lần/giờ, quạt tạo luồng gió tuần hoàn và điều hòa không khí trong phòng  - Hàng chính hãng",9.0,6839477761568,2384000,4555000,2171000,48,3,dien-gia-dung
275513762,"Ấm đun nước siêu tốc Elmich 1,7L KEE 1774 P - Hàng chính hãng",25.0,4485059885037,628000,999000,371000,37,3,dien-gia-dung
275512795,"Nồi áp suất cơ Elmich 5L PCE-8792, công suất lớn 1000W, dung tích 5L, tuyệt đối an toàn với van xả tự động được thiết kế trên nắp nồi, bảo hành 24 tháng, đổi trả 12 tháng - Hàng chính hãng",27.0,3450808126031,1610000,2990000,1380000,46,4,dien-gia-dung
275271315,Máy Xay Hạt Tiêu Hạt Cafe Hạt Khô Gia Vị Đa Năng Công Suất 250w 8 Lưỡi Dao Cực Bén Chất Liệu Cối Inox - Hàng Nhập Khẩu,29.0,7438080133254,175000,175000,0,0,6,dien-gia-dung
275242477,"Máy Xay Sinh Tố, Máy Xay Đa Năng Nhật Bản 4 Lưỡi Công Suất 350W Dung Tích 750ml - Hàng nhập khẩu",13.0,8311520898292,155000,195000,40000,21,5,dien-gia-dung
274069716,Nồi áp suất điện tử Elmich PCE-8571 - Hàng chính hãng,45.0,4691261168108,1540000,3199000,1659000,52,6,dien-gia-dung
273351249,Máy cạo râu khô và ướt Philips S5880/20,26.0,9197803755822,2173000,3355000,1182000,35,3,dien-gia-dung
273262929,Máy xay sinh tố đa năng Sunhouse SHD5114 (450W) - Hàng chính hãng,86.0,6223473499441,471000,920000,449000,49,9,dien-gia-dung
271199612,Máy vắt cam Elmich 700ml CJE 3921 OL (40W) - Hàng chính hãng,112.0,3789443822967,301000,550000,249000,45,9,dien-gia-dung
271078037,"Quạt Mini Để Bàn, Quạt Tích Điện Sạc USB Besti - Quạt Cầm Tay 3 Tốc Độ, Điều Chỉnh Hướng Gió Xoay 360 Độ, Kiểu Dáng Sang Trọng , Không Gây Ồn, Pin Sạc Dung Lượng Lớn - Hàng Chính Hãng",182.0,7586368376760,270000,270000,0,0,34,dien-gia-dung
262386218,"Máy hút bụi cầm tay đa năng 4in1 JETZT X12, lực hút 21000PA, hàng chính hãng",97.0,4551089384721,1189000,1980000,791000,40,18,dien-gia-dung
203291718,"Máy sấy tóc chống xơ rối, làm khô nhanh, thuận tiện khi sử dụng",106.0,4766927678350,152000,160000,8000,5,20,dien-gia-dung
188131717,"Tay mở cốc lọc 123, Tay vặn cốc lọc 10in, 20in, Tay mở vỏ màng RO - Hàng Chính Hãng",161.0,3775354397578,30000,40000,10000,25,1,dien-gia-dung
187772909,"Máy Xay Bột Khô Đa Năng Bear Cà Phê, Hạt Tiêu, Ngũ Cốc Công Suất Lớn MDJ-A02G3 - Hàng Chính Hãng",66.0,9117582871980,444000,750000,306000,41,9,dien-gia-dung
186318183,Bếp điện từ Elmich ICE-3874 2100W Hàng Chính Hãng,105.0,4183255163851,1030000,1435000,405000,28,15,dien-gia-dung
186278651,Máy Ép Chậm Elmich JEE-3898 200W - Hàng Chính Hãng,364.0,3103757786704,1820000,3890000,2070000,53,83,dien-gia-dung
155065478,"Máy Hút Bụi Cầm Tay Không Dây 9000Pa, Hút Bụi Ô Tô, Giường Nệm, Sofa, Laptop - HÀNG CHÍNH HÃNG",527.0,3328221506004,279000,279000,0,0,123,dien-gia-dung
130412385,Bàn Là Ủi Áo Quần Hơi Nước Cầm Tay Tiện Lợi Loại 1 Hàng Chính Hãng MINIIN- Là Được Tất Cả Loại Vải- Gấp Gọn Tiện Dụng,1415.0,6599608920397,329000,329000,0,0,43,dien-gia-dung
118137722,Bàn ủi hơi nước cầm tay Lock&Lock ENI223WHT 1600W - Hàng chính hãng,2679.0,8575811737716,921000,1551000,630000,41,488,dien-gia-dung
109298151,"Máy Pha Cà Phê KONKA KCFCS2 Thiết Kế Kiểu Mới Hiện Đại, Sang Trọng - Hàng nhập khẩu",493.0,9249425526256,425000,429000,4000,1,115,dien-gia-dung
103692716,Nồi Cơm Điện Tử Toshiba RC-10NMFVN (WT) (1 Lít) - Hàng Chính Hãng,33.0,6927754012545,2220000,2550000,330000,13,10,dien-gia-dung
80022729,Nồi cơm điện tử Tefal RK733168 - Hàng chính hãng,42.0,6954409141614,954000,1699000,745000,44,9,dien-gia-dung
71685858,2 Lõi lọc số 1 Karofi - Lõi SMAX DUO 1 - VI LỌC - hàng chính hãng Karofi,132.0,5033607381970,110000,110000,0,0,28,dien-gia-dung
71159586,Nồi Chiên Không Dầu Điện Tử Lock&Lock EJF296BLK (7.2 Lít) - Kèm Chảo Nướng - Hàng Chính Hãng,7622.0,6720042290057,2670000,6187000,3517000,57,2559,dien-gia-dung
57899819,Nồi cơm cao tần Toshiba RC-18IX1PV (1.8 Lít) - Hàng Chính Hãng,67.0,9571123437987,2582000,2982000,400000,13,10,dien-gia-dung
56525193,Tay vặn ly cốc máy lọc nước R.O đa năng vặn 03 ly lọc thô và màng RO,86.0,8793572582730,15000,15000,0,0,19,dien-gia-dung
50820173,Quạt làm mát và lọc không khí Iruka I-99 - Hàng chính hãng,90.0,4960935879774,3900000,6590000,2690000,41,24,dien-gia-dung
48972911,Tông đơ cắt tóc chuyên nghiệp thế hệ mẫu mã kiểu dáng mớiKemei KM1998,266.0,4255682230498,449000,499000,50000,10,43,dien-gia-dung
47197271,Máy cạo râu khô kemei 2024,150.0,7473101971693,244000,299000,55000,18,31,dien-gia-dung
20831639," Bộ lõi lọc nước Kangaroo số 1, 2, 3 Hàng chính hãng",109.0,1692002682309,91000,91000,0,0,11,dien-gia-dung
14678375,Quạt đứng Toshiba F-LSD10(W)VN (30W) - Hàng chính hãng,3104.0,2874407911294,1690000,1820000,130000,7,803,dien-gia-dung
10131404,Máy lọc không khí Sharp FP-J40E-W (23W) - Hàng chính hãng,4047.0,2208828968986,3707000,4215000,508000,12,1205,dien-gia-dung
2241935,Cây Nước Nóng Lạnh Sunhouse SHD9601 - Hàng chính hãng,3106.0,7686633533271,992000,1600000,608000,38,454,dien-gia-dung
394854,Máy Vắt Cam Philips HR2738/00 25W - Hàng chính hãng,134.0,1841868476694,635000,999000,364000,36,26,dien-gia-dung
277735852,"Quạt Tích Điện Mini Cầm Tay 638 – Màn Hình LED, 100 Tốc Độ Gió, Pin 4000mAh Siêu Mát - HÀNG CHÍNH HÃNG MINIIN",9.0,1078053579273,157000,157000,0,0,2,dien-gia-dung
277395067,[Bản mới] Nồi chiên không dầu 6.5L SUNHOUSE SHD4030 - Công nghệ Rapid Air giảm tới 80% dầu mỡ - Khoang chiên trong suốt - Hàng chính hãng,8.0,6168490683629,1170000,1910000,740000,39,3,dien-gia-dung
276448859,Máy làm sữa hạt Elmich CBE-8650 - Hàng chính hãng,3.0,2461005985765,1490000,2790000,1300000,47,0,dien-gia-dung
276232394,Nồi nấu nhanh Trường An NĐ39- Hàng chính hãng - Điện gia dụng,6.0,3783150960791,350000,350000,0,0,1,dien-gia-dung
276042548,Bình đun siêu tốc Kangaroo KGWK15I2 - Hàng chính hãng,27.0,3626378271016,184000,245000,61000,25,2,dien-gia-dung
275793114,Ấm siêu tốc Elmich KEE 8456 - Hàng chính hãng,102.0,3471559369045,966000,1500000,534000,36,25,dien-gia-dung
275481664,Máy tỉa lông mũi Enchen EN005 Bỏ túi tiện lợi Dễ dàng làm sạch nhanh - Hàng chính hãng,82.0,6218813401416,79000,129000,50000,39,5,dien-gia-dung
275376592,Nồi cơm điện cuckoo CR-389 1.8L Hàng chính hãng,7.0,1660923656144,436500,450000,13500,3,2,dien-gia-dung
275376207,"[BẢO HÀNH LỖI 1 ĐỔI 1] Cốc hầm, cốc chưng yến đa năng - Sản phẩm được ưa chuộng số 1 trên thị trường có HDSD Tiếng Việt - Hàng chính hãng",23.0,7893224153201,475000,550000,75000,14,6,dien-gia-dung
274106659,Nồi Cơm Điện Tử Mini Philips HD3170/66 - 600W - 0.85 Lít - Hàng Chính Hãng,1.0,2645140770191,985000,1399000,414000,30,0,dien-gia-dung
273905992,Lò vi sóng Toshiba MM-EM25PE(BM) 25 lít - Hàng Chính Hãng,17.0,9183974181233,1860000,2690000,830000,31,1,dien-gia-dung
273609531,Nồi áp suất điện đa năng Elmich 6L PCE 1809OL - Hàng Chính Hãng,74.0,4314728397331,1540000,2990000,1450000,48,15,dien-gia-dung
273374557,"Máy Uốn Tóc, Máy Ép Tóc, Duỗi Tóc Đa Năng Teement, Thiết Kế Với 4 Mức Nhiệt Tùy Chỉnh Phù Hợp Với Nhiều Loại Tóc Khác Nhau Giúp Duỗi Thẳng, Làm Xoăn Tóc , Không Hư Tổn Tóc ,Tạo Kiểu Tóc Thông Minh - Dùng Cho Salon Tóc & Tại Nhà - Hàng Chính Hãng",24.0,3109030009770,220000,220000,0,0,1,dien-gia-dung
263580125,"Ấm đun nước siêu tốc Elmich 1,8L KEE 1778",37.0,1624024819024,825000,1590000,765000,48,3,dien-gia-dung
252913427,"Quạt mini cầm tay REKKY gập gọn phù hợp mang đi du lịch, có đèn led hiển thị chế độ và dung lượng pin- Hàng Chính Hãng",58.0,5956325615868,219000,219000,0,0,11,dien-gia-dung
249296149,Quạt đứng Mitomo FCE-60HE cao cấp không ồn hàng chính hãng,115.0,8756684543813,669000,959000,290000,30,26,dien-gia-dung
215890753,"Combo 2 bộ lọc thô 123 + 2 lõi số 1 (4 lõi số 1, 2 lõi số 2, 2 lõi số 3) cho máy Kangaroo hàng chính hãng",100.0,3413935028019,95000,134000,39000,29,19,dien-gia-dung
214065190,"Máy đánh trứng đánh bọt cafe cầm tay mini Lebenlang LBL4588, 2 tốc độ, sạc pin usb tiện dụng - hàng chính hãng",177.0,8177549745836,399000,659000,260000,39,32,dien-gia-dung
188785423,"Máy Xay Sinh Tố Mini Cầm Tay Sử Dụng Pin Sạc Cổng USB, Máy Xay Mini 6 Lưỡi Siêu Tiện Lợi - Hàng chính hãng MINIIN (Giao màu ngẫu nhiên)",111.0,6153311520217,99000,99000,0,0,18,dien-gia-dung
186134476,"Máy Phun Sương Tạo Ẩm Bear Làm Mát Không Khí, Bộ Lọc Ion Bạc Diệt Khuẩn, Tiết Kiệm Năng Lượng JSQ-C45U1 - Hàng chính hãng",44.0,6539825321670,482000,790000,308000,39,5,dien-gia-dung
180223383, Bàn ủi khô Sunhouse SHD1072  - Hàng Chính Hãng,66.0,2465252467260,165000,165000,0,0,3,dien-gia-dung
172436841,"Máy Hút Bụi Cầm Tay Midea MVC-16T-B (Công Suất 800W, Độ ồn: 84 dB, Bộ lọc Hepa H13, Dây Diện 5m)",52.0,8073982315562,1890000,1890000,0,0,11,dien-gia-dung
126022630,Quạt hút thông gió 2 chiều âm tường Senko Hàng Chính Hãng H150 30W,15.0,9235787248837,274000,274000,0,0,2,dien-gia-dung
105602373,Lon gas chuyên dụng Namilux - HÀNG CHÍNH HÃNG NAMILUX (MP),454.0,7908459236224,33000,33000,0,0,40,dien-gia-dung
82605269,Khay Silicone Dành Cho Nồi Chiên Không Dầu Và Lò Vi Sóng Lock&Lock CKB002 - Hàng Chính Hãng,863.0,1975105891039,280000,435000,155000,36,240,dien-gia-dung
78625780,Quạt điện Senko để bàn tiện lợi cao cấp B1216 màu ngẫu nhiên - Hàng Chính Hãng,81.0,2590256982981,295000,295000,0,0,12,dien-gia-dung
72285990,"Máy Sấy Tóc Cao Cấp Kiểu Dáng Sang Trọng Tinh Tế Công Suất Lớn Chuyên Dụng Tại Nhà và Cho Hair Salon - Máy Sấy Tóc Bổ Sung Ion Dưỡng Ẩm, Làm Mềm Mượt Tóc - Máy Sấy Tóc Cao Cấp Động Cơ Êm Ái, Ổn Định – Chính Hãng VinBuy (Máy sấy tóc)",1631.0,5019644129645,235000,350000,115000,33,462,dien-gia-dung
22526356,Ca nấu mì Daewoo DEN-M550 (0.7L) - Hàng chính hãng,949.0,4960570152034,244000,399000,155000,39,124,dien-gia-dung
13444273,Quạt điều khiển Senko TH-TR1628 - Hàng chính hãng,42.0,9527456314969,520000,520000,0,0,11,dien-gia-dung
11755648,Bếp Đôi Điện Từ Hồng Ngoại Sunhouse SHB8609 (Tổng công suất 3600W) - Hàng chính hãng,3813.0,4804212633751,2450000,3601000,1151000,32,739,dien-gia-dung
11386190,Thiết Bị Lọc Nước Lắp Tại Vòi EF201 - Hàng chính hãng,14.0,6652286232947,2248363,2248363,0,0,4,dien-gia-dung
10597625,Máy Xay Thịt 2 Lưỡi Dao Kép Lock&Lock EJM171 (2 Lít - 300W) - Hàng Chính Hãng,10551.0,5835878787945,1030000,1577000,547000,35,2204,dien-gia-dung
4534531,Máy Làm Sữa Chua Lock&Lock EJY110SLV (1000ml) - Hàng chính hãng,8183.0,2558057366610,428000,658000,230000,35,898,dien-gia-dung
811792,Nồi Cơm Điện Đa Năng Sunhouse SHD8602 (1.8L) – Trắng- Hàng chính hãng,1011.0,1895024501751,460000,714000,254000,36,37,dien-gia-dung
794609,Máy Nướng Bánh Mì Lock& Lock EJB221BLU (730 - 870 W) - Hàng chính hãng,6002.0,5804673216004,700000,1093000,393000,36,884,dien-gia-dung
793322,Bếp Ga Đơn Rinnai RV-150 (G) - Đen- Hãng chính hãng,618.0,2029266507458,388000,388000,0,0,128,dien-gia-dung
393735,Nồi Cơm Điện Midea CM06SA (0.6 Lít) - Hàng Chính Hãng,563.0,1899037507212,529000,529000,0,0,46,dien-gia-dung
392839,Bình Đun Siêu Tốc Philips HD9303 (1.2 Lít) - Hàng chính hãng,3037.0,1795445226991,479000,630000,151000,24,231,dien-gia-dung
276986521,Máy Xay Cafe Mini Cầm Tay Bằng Thép Không Gỉ - Hàng Nhập Khẩu,4.0,2922469397895,125000,125000,0,0,0,dien-gia-dung
276328347,Nồi cơm điện Sunhouse 1.8L SHD8611GR (700W)- Hàng chính hãng,8.0,7378322063076,600000,1100000,500000,45,1,dien-gia-dung
276042569,Nồi lẩu đa năng Kangaroo KG40EH2 - Hàng chính hãng,6.0,6250204472631,574200,776000,201800,26,1,dien-gia-dung
276024660,"Máy cạo râu Enchen Mini 6s, Cạo râu khô & ướt nút cảm ứng, Đầu cạo nổi 28 lưỡi dao kép tự mài - Hàng nhập khẩu",37.0,6212135472996,190000,190000,0,0,11,dien-gia-dung
275646555,Nồi nấu đa năng Ohella Master Multicooker MC01 Hàng chính hãng,2.0,8177195722264,3790000,3790000,0,0,0,dien-gia-dung
275583053,Máy Hút Bụi Cầm Tay Không Dây 9baby - Hàng Chính Hãng,5.0,5509446595472,375000,450000,75000,17,0,dien-gia-dung
275409694,"Lưỡi Thép Dạng Trượt Dùng Để Lau Chùi, Vệ Sinh Bếp Từ, Điện Từ, Bếp Gas Chuyện Dụng PaKaSa Hàng chính hãng",5.0,2168037213753,39000,78000,39000,50,0,dien-gia-dung
274558439,Quạt không cánh để bàn U ULTTY PETIT LIDI - Hàng chính hãng,5.0,1895468137889,1500000,1800000,300000,17,0,dien-gia-dung
274371699,Máy Cạo Râu Mini Xiaomi Enchen MS003 Thiết kế sang trọng và nhỏ gọn mẫu mới 2024- Hàng nhập khẩu,19.0,8973222892245,139000,139000,0,0,4,dien-gia-dung
273891199,Bộ Đèn UV Karofi 6W 2 Chân Cắm Tiệt Trùng An Toàn Và Hiệu Quả Dành Cho Máy Lọc Nước RO - Hàng chính hãng,7.0,4135267759640,122000,185000,63000,34,1,dien-gia-dung
273640582,Máy sấy tóc Elmich HDE-1813 - Hàng Chính Hãng,25.0,9110466557246,279000,480000,201000,42,4,dien-gia-dung
273475078,"Máy Xay Công Nghiệp Máy xay sinh tố đa chức năng, thích hợp để dễ dàng làm rau, trái cây, sinh tố và sữa - Hàng chính hãng",7.0,4706634391069,499000,499000,0,0,3,dien-gia-dung
270231778,"Ấm siêu tốc mini Lebenlang LBL2319, công suất 600W, sôi nhanh trong 4 phút, nhỏ gọn, dễ mang đi du lịch, bảo hành 2 năm - hàng chính hãng",86.0,9573892191071,299000,429000,130000,30,24,dien-gia-dung
263396168,"Quạt hơi nước tích điện Half Horse, xoay 180 pin 2500 mAh, thời gian sử dụng 6 tiếng, hàng chính hãng",12.0,3099674234721,289000,540000,251000,46,1,dien-gia-dung
263274092,"Ấm Đun Siêu Tốc Giữ Nhiệt Bear SB-ST17T 1800W Dung Tích 1,7L Cảm Ứng Dễ Dàng Sử Dụng - Hàng chính hãng",16.0,8431994938157,644000,990000,346000,35,4,dien-gia-dung
262447467,Máy pha cà phê nhỏ giọt Zamboo ZB-55CFD-Hàng Chính Hãng,11.0,1393484382401,550000,550000,0,0,0,dien-gia-dung
252641840,"Quạt Điều Hòa Hơi Nước Mini, Quạt Phun Sương Tạo Ẩm Làm Mát Để Bàn, Hẹn Giờ Thông Minh Tích Hợp Đèn Ngủ - HÀNG CHÍNH HÃNG MINIIN",82.0,1957996978248,199000,199000,0,0,11,dien-gia-dung
213866788,Bàn ủi khô Philips HD1172/01- HÀNG CHÍNH HÃNG,46.0,2199873865502,295000,295000,0,0,10,dien-gia-dung
197674846,Quạt Treo Tường Công Nghiệp 2 Dây SanKyo B4 - Hàng chính hãng,9.0,2652938057779,690000,690000,0,0,1,dien-gia-dung
174085836,Máy Cạo Râu KM-6650 Đa Năng 4 Trong 1 Tích Hợp Pin 1400 mAh Công Suất 3W Kiêm Tông Đơ Cắt Tóc & Máy Tỉa Lông Mũi -HÀNG CHÍNH HÃNG,430.0,1535241478706,175000,350000,175000,50,138,dien-gia-dung
150852025,"Quạt Điện Mini Cầm Tay Tích Điện Damas T9 - Thiết kế với 3 chế độ gió, đèn Led 7 màu siêu đẹp mắt, kiểu dáng nhỏ gọn tiện lợi, có thể cầm tay, để bàn tiện dụng - Hàng Chính Hãng",33.0,8618231736572,179000,350000,171000,49,11,dien-gia-dung
110255220,Ấm đun nước siêu tốc Elmich Smartcook ICS-3859 (1.7 Lít) - Hàng chính hãng,1539.0,3762329844747,341000,579000,238000,41,313,dien-gia-dung
106320899,Quạt đảo trần Asia X16002 có điều khiển từ xa công suất 55W - Hàng chính hãng,63.0,8838837813216,805000,805000,0,0,15,dien-gia-dung
101502997,"Máy Lọc Không Khí Cảm Biến, Tạo Ion Cho Diện Tích 50m2 Nagakawa NAG3502M - Hàng Chính Hãng",0.0,8964107757917,3949000,3949000,0,0,0,dien-gia-dung
72286199,"Máy UỐN, ÉP, LÀ Tóc Đa Năng 3 Trong 1 Cao Cấp Sang Trọng Kiểu Hàn Quốc - Kết Hợp Duỗi, Uốn, Tạo Kiểu Tóc Thông Minh – Dùng Cho Salon Tóc & Tại Nhà – Chính Hãng VinBuy (Tùy Chọn 2 Màu Trắng Đen) ",5071.0,3540078833935,225000,450000,225000,50,1098,dien-gia-dung
58057112,Máy xay sinh tố Philips HR2221/00 (700W) - Hàng Chính Hãng,65.0,5112067724074,1095000,1129000,34000,3,9,dien-gia-dung
50247154,Lõi lọc nước Toshiba F-1643-C1 - Hàng chính hãng,337.0,9501986980023,175000,219000,44000,20,66,dien-gia-dung
36836228,Đèn Sưởi Phòng Nhà Tắm Klopper LH02 (2 Bóng) - Chính Hãng,329.0,2516148005589,250000,250000,0,0,77,dien-gia-dung
36627517,Bếp Hồng Ngoại Lock&Lock EJI421 (2000W) - Hàng Chính Hãng,2457.0,6246640455471,1710000,2421000,711000,29,606,dien-gia-dung
31502012,Nồi Chiên Không Dầu Magic A-802 (4.6 Lít) Đỏ- Hàng Chính Hãng,3288.0,2252185607064,1014000,1990000,976000,49,738,dien-gia-dung
20046513,Quạt treo tường remote Senko Hàng Chính Hãng - TR1428 - Giao màu ngẫu nhiên,77.0,5661128229343,513000,513000,0,0,19,dien-gia-dung
19741056,Nồi kho cá Đạt tường 2.5 lít NKG-2.5L (Hàng chính hãng),32.0,6683451371727,263000,263000,0,0,5,dien-gia-dung
13822764,Lõi Số 3 - 10 PP - 1 Micro Kangaroo K 28 - 1 - Hàng chính hãng,91.0,1273823315319,32000,43000,11000,26,12,dien-gia-dung
7177821,Lõi Lọc Nước Sunhouse Số 1 SHRLL1 - Hàng chính hãng,23.0,3822616266604,46000,46000,0,0,2,dien-gia-dung
3916645,Lò Vi Sóng Sharp R-202VN-S (20L) - Bạc - Hàng chính hãng,765.0,8766098670984,1436000,1690000,254000,15,86,dien-gia-dung
3611017,Bếp Nướng Điện Kangaroo KG699G 2000W - Hàng chính hãng,3194.0,4148436365600,534000,940000,406000,43,303,dien-gia-dung
2745859,Bếp Từ Đôi Hồng Ngoại Cảm Ứng KAFF KF-073IC - Hàng Chính Hãng,6.0,4029353581666,6450000,6450000,0,0,3,dien-gia-dung
650250,Máy Hấp Thực Phẩm Magic Korea A64 (5.0 Lít) - Hàng chính hãng,12648.0,1922553364462,329000,499000,170000,34,1677,dien-gia-dung
576178,Máy Làm Tỏi Đen Tiross TS906 - Màu Bạc - Hàng chính hãng,17.0,2940352970263,1449000,1449000,0,0,1,dien-gia-dung
277809791,Máy xay sinh tố cầm tay 400ml Elmich BLE9215 - Hàng chính hãng,2.0,7689822716705,800000,800000,0,0,0,dien-gia-dung
276448871,Bếp từ đôi Elmich ICE-3496 - Hàng chính hãng,2.0,8371448788041,4064000,9500000,5436000,57,1,dien-gia-dung
275512805,"Máy hút chân không gia đình Elmich VSE-8582, thiết kế nhỏ, gọn nhẹ, thuận tiện cất vào tủ bếp và di chuyển, thao tác đơn giản và có hút hộp riêng  - Hàng chính hãng",14.0,6571559136016,939000,1500000,561000,37,3,dien-gia-dung
275068671,Bếp đôi điện từ Sunhouse SHB82032-EC - Hàng chính hãng,22.0,2480456929061,3560000,5256000,1696000,32,5,dien-gia-dung
273493513,Mâm quạt thay thế cho quạt đứng Senko - Hàng chính hãng,15.0,8237148275516,66000,68000,2000,3,2,dien-gia-dung
273165203,LINH PHỤ KIỆN MÁY ÉP CHẬM KUVINGS HÀN QUỐC-HÀNG CHÍNH HÃNG,0.0,5103584961263,1250000,1250000,0,0,0,dien-gia-dung
272939869,"Máy cạo râu Philips S3608/10 , bảo hành 2 năm",26.0,6186429363151,1159000,1855000,696000,38,4,dien-gia-dung
272555420,Máy làm sữa hạt Elmich CBE 3902 (Mới) - Hàng Chính Hãng,28.0,2367073051209,1990000,3399000,1409000,41,8,dien-gia-dung
271354938,"Nồi điện đa năng Locknlock Electric Multipot EJP124IVY - Tay cầm cách nhiệt - Nắp trong suốt - Chống dính - Đường kính 23cm - Dung tích 3L - 220V, 50Hz, 1000W - Màu ngà - Hàng chính hãng",372.0,2035268334345,1040000,1478000,438000,30,37,dien-gia-dung
263273722,Bộ Bếp Điện Đôi Bear Kèm Nồi Chảo Đa Năng Hấp Luộc Chiên Tiện Lợi Tiết Kiệm Chi Phí Dễ Vệ Sinh SB-BD02N - HÀNG CHÍNH HÃNG,13.0,3070723264599,1008000,1590000,582000,37,0,dien-gia-dung
249483591,"Quạt Cây Đứng Mitomo FCE-60 có điều khiễn từ xa, hẹn giờ hàng chính hãng",56.0,8389532188932,1278000,1278000,0,0,12,dien-gia-dung
249156294,"Máy đánh trứng, máy đánh bọt cafe cầm tay mini Lebenlang LBL4588, 2 tốc độ, sạc pin usb tiện dụng - hàng chính hãng",159.0,1071215022401,399000,659000,260000,39,25,dien-gia-dung
196233680,Máy pha cà phê Bear CF-B15V1 - Hàng chính hãng,15.0,1108120067124,2109000,3390000,1281000,38,1,dien-gia-dung
194473550,Nồi cơm điện tử Nagakawa NAG0142 (1.5L) - 10 chương trình nấu - Hàng chính hãng),2.0,4979738648389,1490000,1490000,0,0,1,dien-gia-dung
188189727,Lõi lọc Philips All-in-One ADD550 dành cho máy lọc nước RO để bàn ADD6910 - Hàng chính hãng,56.0,8907710990421,1899000,2150000,251000,12,6,dien-gia-dung
186741174,"Máy Kẹp Sandwich Cao Cấp Nướng Siêu Nhanh Chỉ 3 Phút, Máy Nướng Bánh Mì Đa Năng Chống Dính Tuyệt Đối, Chiên Trứng, Nướng Thịt - Hàng Chính Hãng",29.0,7207199341628,495000,495000,0,0,8,dien-gia-dung
177482641,Bộ Lọc Hepa Cho Máy Hút Bụi DAMAS XC628 - Hàng chính hãng,4163.0,3558460085327,79000,150000,71000,47,23,dien-gia-dung
162865717,Quạt đứng Kagaroo KG726 - Hàng Chính Hãng,24.0,9618683637225,1089000,1750000,661000,38,3,dien-gia-dung
162822107,Máy Nướng Bánh Mì Sandwich Làm Nóng Thức Ăn Cho Bữa Sáng Đa Năng Dễ Sử Dụng - Hàng Chính Hãng MINIIN,243.0,4241192965370,260000,260000,0,0,33,dien-gia-dung
160686654,"Lõi lọc PGP Pureit Delica lớn/ nhỏ Công suất 7000L, Hàng chính hãng",43.0,6801935385912,776000,800000,24000,3,5,dien-gia-dung
154241416,"Máy hút bụi lau nhà airbot iClean Pro tích hợp tự động giặt Dẻ, 3 công việc trong 1, hút và lau chuyên sâu, hàng chính hãng",14.0,8547704687908,4990000,4990000,0,0,6,dien-gia-dung
105666429,"Bếp điện từ Lock&Lock EJI331 220-240V, 50/60Hz, 2000W –Hàng Chính Hãng",31.0,5264586354154,1299000,2000000,701000,35,10,dien-gia-dung
92024559,MÀNG RO PURIFIM - USA - Hàng chính hãng,9.0,7893377815477,545000,545000,0,0,2,dien-gia-dung
90474488,Bàn Ủi Hơi Nước Cầm Tay Gấp Gọn 1500W - Hàng Nhập Khẩu,150.0,2731561392030,420000,420000,0,0,9,dien-gia-dung
72825272,Máy Hút Bụi Cầm Tay Không Dây Damas XC628 - Chính Hãng,11742.0,5476657224468,439000,850000,411000,48,2556,dien-gia-dung
72549285,Quạt sạc tích điện Honjianda FL 301 - tích hợp đèn LED & cổng USB - Hàng chính hãng,76.0,7026325883640,809000,809000,0,0,20,dien-gia-dung
57660754,"Bộ 4 lõi lọc nước Vasstar số 1,2,3 _HÀNG CHÍNH HÃNG",125.0,1095396381269,225000,225000,0,0,24,dien-gia-dung
43935672,Bàn là Panasonic 317TV (Trắng)   - Hàng nhập khẩu,2.0,2032814665050,449000,449000,0,0,0,dien-gia-dung
36626940,Nồi Chiên Không Dầu Điện Tử Lock&Lock EJF357BLK (5.2 Lít) - Hàng Chính Hãng,24558.0,1698700525412,2285000,5475000,3190000,58,6554,dien-gia-dung
21072910,Quạt Tích Điện Mini YooBao - 6400mAh - Sử Dụng Lên Đến 32h - Hàng Chính Hãng,31.0,2157855187382,266000,266000,0,0,2,dien-gia-dung
20916755,Bàn Ủi Hơi Nước Đứng Bluestone GSB-3941 1800W  - Hàng Chính Hãng,15.0,4186623966315,999000,3399000,2400000,71,2,dien-gia-dung
20659766,Bếp Gas Mini Cao Cấp NaMilux PL-1911PF-Hàng Chính Hãng (Giao Màu Ngẫu Nhiên),17.0,8906239276686,269000,269000,0,0,1,dien-gia-dung
13524648,Bàn ủi Electrolux ESI4017 - Hàng chính hãng,6.0,7639723244465,620000,620000,0,0,2,dien-gia-dung
11824785,Nồi Cơm Điện Kangaroo KG823 (1.2 Lít) - Hàng chính hãng,64.0,6403608566901,656000,1170000,514000,44,21,dien-gia-dung
3577753,Quạt đứng Toshiba F- LSA20(H)VN (60W) - Xám - Hàng chính hãng,1570.0,9350087318538,1147000,1340000,193000,14,270,dien-gia-dung
2138075,Máy Lọc Không Khí Sharp FP-J30E-A (50W)- Hàng chính hãng,5087.0,9011225265120,1980000,2400000,420000,18,1352,dien-gia-dung
1953667,Máy Sấy Tóc Sunhouse SHD2317,19.0,4647137023906,353000,353000,0,0,4,dien-gia-dung
1953527,Máy Sấy Tóc Sunhouse SHD2305 - Xanh,38.0,3915112097374,120000,120000,0,0,11,dien-gia-dung
729875,Quạt Gió Nhỏ Lifan GN-4 - Đen - Hàng Chính Hãng,69.0,1673888726455,172000,172000,0,0,14,dien-gia-dung
392729,Máy Ép Trái Cây Philips HR1811 (300W) - Trắng Xanh - Hàng chính hãng,40.0,1817659204661,1125000,1374000,249000,18,7,dien-gia-dung
277811686,"Quạt Để Bàn Tích Điện Mini 5 Cấp Độ Gió Teement, Dung Lượng Pin Lớn 2000mah Không Tiếng Ồn , Tặng Kèm Cáp Sạc - Hàng Chính Hãng",2.0,7081648482436,220000,220000,0,0,0,dien-gia-dung
277780931,Bàn là hơi nước cầm tay Elmich SIE9161 / SIE9163 / SIE9164 - Hàng chính hãng,1.0,1866710925061,850000,850000,0,0,0,dien-gia-dung
276693386,Quạt Điều Hòa Không Khí Mini Tránh Nóng Mùa Hè Hiệu Quả Hàng Nhập Khẩu,2.0,7992027345554,658000,658000,0,0,1,dien-gia-dung
276546671,Máy Hút Bụi Mini Cầm Tay Nhật Bản - Hàng nhập khẩu,19.0,8863304323342,99000,99000,0,0,3,dien-gia-dung
276235562,Nồi nấu chậm đa năng Bear DDZ-A08T8 0.8L (200W)- Màu xanh dương - Hàng chính hãng,3.0,5076131171277,404000,799000,395000,49,1,dien-gia-dung
275630055,Quạt điện cao cấp Bear SB-QC47K Hàng chính hãng,7.0,3431663299532,1031000,1490000,459000,31,0,dien-gia-dung
275350956,"Quạt phun sương để bàn nhỏ gọn MINI COOL FAN, tiện lợi, có 5 vòi phun sương quạt hơi nước kèm đèn led hẹn giờ cùng 3 chế độ phun sương Hàng chính hãng",3.0,1526357108637,187000,250000,63000,25,1,dien-gia-dung
275128376,"Quạt Để Bàn Tích Điện Mini Cao Cấp Teement,  Tích Hợp Đèn Ngủ Động Cơ Không Tiếng Ồn Pin 1200mah , Điều Chỉnh Lên Xuống 360°, 3 Cấp Độ Gió Siêu Mát Dễ Điều Chỉnh- Hàng Chính Hãng",27.0,7679383994948,270000,270000,0,0,4,dien-gia-dung
274990850,Nồi lẩu Bear SB-NL05F 5L (1500W) - Hàng chính hãng,10.0,9099971426840,695000,1090000,395000,36,1,dien-gia-dung
272617330,"Quạt đứng Toshiba F-LSA10(H)VN, Màu xám, 50W- 5 cánh - Hẹn giờ tắt - Góc đảo gió 85 độ - Hàng chính hãng, bảo hành 12 tháng",14.0,9692208387258,919000,1190000,271000,23,7,dien-gia-dung
272467336,"Máy ép chậm Sunhouse SHD5518, Công suất 150W, Ép mọi loại rau củ quả, Chức năng làm kem trái cây tiện lợi, Hàng chính hãng - Bảo hành 12 tháng",4.0,4310891312054,1259000,1259000,0,0,0,dien-gia-dung
247383845,Nồi lẩu điện mini TEKKIN 1.8L 2 tầng đa năng tặng xửng hấp inox - hàng nhập khẩu,306.0,2427715629679,149000,149000,0,0,15,dien-gia-dung
220661346,Bàn Ủi Hơi Nước Cầm Tay Sokany 3060 Có Thể Gấp Gọn - Hàng Chính Hãng,240.0,5714372567804,439000,439000,0,0,31,dien-gia-dung
197497201,Đế làm nóng đồ uống Bear DRBD-C16J5 - Hàng chính hãng,31.0,3029073019836,496000,520000,24000,5,6,dien-gia-dung
193604081,"Quạt sàn công nghiệp Lifan S-18CN công suất 55W, chân đế kim loại bọc vỏ cao su chắc chắn, sải cánh 45cm - Hàng chính hãng",9.0,1340289463739,621000,621000,0,0,4,dien-gia-dung
188694253,Máy Ép trái Chậm Mini Smartcook JES-3897OL Hàng Chính Hãng,20.0,2105577752455,1000000,2290000,1290000,56,8,dien-gia-dung
185215651,Máy cạo râu Kemei KM-2026,9.0,2687078617236,349000,349000,0,0,2,dien-gia-dung
182558874,Máy tạo kiểu tóc Multi Stlyes 2022 trục long,1.0,4513366133686,15500000,15500000,0,0,0,dien-gia-dung
182134115,Phụ kiện robot hút bụi Ecovacs Deebot OMNI/TURBO X1 - Hàng Chính Hãng,36.0,5594883419145,565000,565000,0,0,5,dien-gia-dung
162841493,Máy cạo râu khô và ướt Philips S1301/02 - Hàng Chính Hãng,178.0,4790223793296,759000,1155000,396000,34,34,dien-gia-dung
155110765,Máy hút bụi DEERMA DX810 - Hàng chính hãng,9.0,8901973937154,799000,799000,0,0,1,dien-gia-dung
135415392,Nồi cơm nắp gài Cuckoo CR- 1713 3 lít - Hàng chính hãng,1.0,3716381454477,2090000,2090000,0,0,0,dien-gia-dung
127046577,Quạt bàn Senko sang trọng cao cấp B1216 màu ngẫu nhiên - Hàng Chính Hãng,450.0,4138856670287,295000,295000,0,0,82,dien-gia-dung
122646060,Bếp Hồng Ngoại Đơn Kangaroo KG20IFP1 (2000W) - Hàng Chính Hãng,1096.0,6155454342894,640000,1010000,370000,37,78,dien-gia-dung
120441829,Cây nước nóng lạnh Toshiba RWF-W1917TV(K) - Hàng chính hãng,2.0,9908186250779,2490000,3800000,1310000,34,1,dien-gia-dung
105186425,Lò Vi Sóng Cơ Sharp R-G225VN-BK (20 Lít) - Hàng Chính Hãng,9.0,5681695209257,1620000,1790000,170000,9,1,dien-gia-dung
74261830,Máy Xay Cà Phê Mini Zamboo ZB-100GR - Hàng Chính Hãng,47.0,5879556824331,389000,389000,0,0,17,dien-gia-dung
72694571,Quạt Đứng USS DCN308 - Hàng Chính Hãng ( Giao màu ngẫu nhiên),10.0,1073177134273,368500,368500,0,0,1,dien-gia-dung
70784089,Tông đơ cạo lông toàn thân Panasonic ER-GK20-K401 - Hàng chính hãng,8.0,7895929666429,1499000,1499000,0,0,0,dien-gia-dung
57983571,Lõi lọc nước Toshiba số 2 F-1686-RO - HÀNG CHÍNH HÃNG,5.0,8562356558267,979000,979000,0,0,2,dien-gia-dung
56492437,Quạt Bàn Đảo 3 Tấc Senko BD1010 - Màu Ngẫu Nhiên - Hàng chính hãng,89.0,3289197043084,345000,345000,0,0,29,dien-gia-dung
38232774,Máy Làm Sữa Chua Và Pho Mát 6 Trong 1 Kuvings KGC-712CB (2.0L) – Màu đỏ - Hàng Chính Hãng,66.0,8236279252082,2190000,2990000,800000,27,15,dien-gia-dung
22526353,Máy hút bụi cầm tay Daewoo DWX-E620P (P) (600W) - Hàng chính hãng,684.0,5599439251893,613000,1090000,477000,44,79,dien-gia-dung
20270627,"Quạt sạc mini xoay góc 720 độ, đế kẹp đa năng hoặc đặt bàn, an toàn cho trẻ với 4 nấc điều chỉnh gió chính hãng YOOBAO F04 - Hàng nhập khẩu",11.0,6947075182245,268890,269890,1000,0,4,dien-gia-dung
16934551,Máy Cạo Râu Mạnh Mẽ Tiện Dụng Phong Cách SCW301U,232.0,5051416169749,130000,130000,0,0,43,dien-gia-dung
1644719,Máy Lọc Nước Pureit Ultima Lọc Nguyên Khối Tích Hợp Công Nghệ RO + UV + MF - Hàng chính hãng,38.0,8803417672967,8100000,12400000,4300000,35,6,dien-gia-dung
790401,Máy Đánh Trứng Daewoo DWHM- 831S (250W) - Hàng chính hãng,521.0,5300634087886,389000,659000,270000,41,50,dien-gia-dung
558110,Máy Làm Bánh Mì Panasonic SD-P104WRA - Chế độ hẹn giờ 13 tiếng - Chức năng ghi nhớ khi mất điện - 13 thực đơn tự động - Hàng chính hãng,4.0,1951040949301,4940000,4940000,0,0,0,dien-gia-dung
533336,Bếp Hồng Ngoại Sunhouse SHD6014Đ - Đen - Hàng chính hãng,82.0,1985805496656,808000,1190000,382000,32,6,dien-gia-dung
447317,Máy Tỉa Lông Mũi Panasonic PAMT-ER-GN30-K453 - Hàng Chính Hãng,395.0,1324533728088,354000,419000,65000,16,93,dien-gia-dung
277589667,Tăm Nước Vệ Sinh Răng Miệng Xiaomi MEO705 Mijia Gen 2 - Hàng nhập khẩu,1.0,3454345343395,986000,986000,0,0,0,dien-gia-dung
277568569,Giá Đựng Inox 24 Xiên Hình Tròn Dọc Cho Nồi Chiên Không Dầu - Chất Liệu Thép Không Gỉ - HÀNG CHÍNH HÃNG MINIIN,12.0,7439553789994,59000,59000,0,0,1,dien-gia-dung
276962350,Máy Ép Tóc Uốn Tóc Duỗi Tóc  Mini Tiện Lợi - Hàng chính hãng (Giao Màu Ngẫu Nhiên),17.0,8063904660307,59000,118000,59000,50,4,dien-gia-dung
276938613,"Quạt phun sương để bàn nhỏ gọn MINI COOL FAN, tiện lợi, có 5 vòi phun sương quạt hơi nước kèm đèn led hẹn giờ cùng 3 chế độ phun sương Hàng chính hãng",1.0,1614759670667,187000,220000,33000,15,0,dien-gia-dung
276640374,"Máy Hút Bụi Cầm Tay Mini Tamashiho Nhật Bản 120W - Lực Hút 9000Pa, Bộ Lọc HEPA, Pin 4000mAh, Đa Chức Năng, HÀNG CHÍNH HÃNG MINIIN",7.0,7513273786702,189050,199000,9950,5,1,dien-gia-dung
276448881,Máy xay sinh tố Elmich BLE-8667 - Hàng chính hãng,1.0,4692602909899,1370000,2490000,1120000,45,0,dien-gia-dung
276229549,Siêu điện 5 lít NK media Tự Ngắt Khi Sôi BH 12 Tháng hàng chính hãng,2.0,7646314482410,245000,245000,0,0,0,dien-gia-dung
276222781,Nồi áp suất điện đa năng cao cấp Masuto 10in1 dung tích 5L HÀNG CHÍNH HÃNG BH 12 THÁNG 1 ĐỔI 1 TẠI NHÀ,1.0,2410097816822,1380000,1380000,0,0,0,dien-gia-dung
275390745,"Quạt trần 6 cánh thương hiệu Klasse - sải cánh 1,47m - Có điều khiển từ xa - Hàng chính hãng",1.0,4485996433837,1790000,1790000,0,0,0,dien-gia-dung
275354604,Máy Nướng Bánh Mì Sandwich Đa Năng Dễ Sử Dụng - Hàng nhập khẩu,2.0,9960774003117,335000,335000,0,0,0,dien-gia-dung
275264614,Máy sấy tóc Dyson Supersonic Copper HD15 Hàng chính hãng,2.0,3644454993114,10500000,10500000,0,0,1,dien-gia-dung
273640530,Máy sấy tóc Elmich HDE-1812 - Hàng Chính Hãng,10.0,5342121734198,291000,415000,124000,30,1,dien-gia-dung
273358160,Máy xay thịt 2 lưỡi dao kép Sunhouse SHD5403 300W - Hàng chính hãng,4.0,4905213347515,434000,434000,0,0,0,dien-gia-dung
198696898,Quạt bàn Senko BD1012 Kem môn - Hàng chính hãng,8.0,6955125004772,320000,420000,100000,24,3,dien-gia-dung
196801285,Máy xay thịt Philips HR1393/00 - Hàng chính hãng,1.0,9793047179284,756000,756000,0,0,0,dien-gia-dung
188131691,"Bút TDS thử nước sạch, Dụng cụ kiểm tra chất lượng nước, độ cứng của nước - Hàng Chính Hãng",34.0,1430953933359,80000,120000,40000,33,6,dien-gia-dung
182736710,Quạt kẹp mini để bàn Yoobao 2500/6400mAh Y-F04 - Hàng chính hãng,11.0,1313291205376,169000,299000,130000,43,1,dien-gia-dung
172373158,"Máy Xay Sinh Tố Cầm Tay Mini Đa Năng 330ML Có Quai Xách  Chính Hãng MINIIN  - Xay Cực Nhanh 9s, An Toàn ",3.0,4616849171816,163000,163000,0,0,0,dien-gia-dung
126309778,Quạt hút thông gió 2 chiều âm tường Senko Hàng Chính Hãng H150 30W,10.0,9641524762984,274000,274000,0,0,2,dien-gia-dung
115972704,"Bộ lõi số 1,2,3,4 K-Pro Series by Scitech (Lõi PP-GAC-CTO-UF) dùng cho máy lọc nước nóng lạnh, máy lọc nước UF - Hàng chính hãng",7.0,7884614810898,250000,250000,0,0,2,dien-gia-dung
115523313,Ly lọc nước 10 inch - Hàng chính hãng,8.0,9489371284551,145000,145000,0,0,4,dien-gia-dung
109563595,Máy pha cà phê Nespresso cầm tay Wacaco Nanopresso - 5 Màu cơ bản - Hàng Chính Hãng - Kèm hộp chống sốc,43.0,5350275226679,2100000,2100000,0,0,22,dien-gia-dung
88962147,Máy Hút Bụi Có Hộc Chứa Philips XB2023/01 (1800W) - Hàng Chính Hãng,121.0,1329533578026,1911000,2749000,838000,30,36,dien-gia-dung
70591134,"Máy Hút Chân Không Không Kén Túi Shineye P290A, Hút Khô và Hút Ướt, Công Suất Mạnh Mẽ 220W, Tặng Kèm 10 Túi Hút Chân Không, Hàng Chính Hãng",416.0,8009059119666,1850000,1850000,0,0,117,dien-gia-dung
55651448,Combo 3 lõi lọc nước số 1 Kangaroo - Hàng chính hãng,126.0,9560278761849,85000,120000,35000,29,18,dien-gia-dung
55386294,"Máy xay thịt công suất 1000W, cối inox 6L Osako OST-1020-hàng chính hãng",34.0,8466871692065,1379000,1379000,0,0,5,dien-gia-dung
52189605,LÕI LỌC TOSHIBA F-1643-RO - hàng chính hãng,78.0,4663551930682,892000,950000,58000,6,24,dien-gia-dung
51227503,Bàn ủi hơi nước Philips GC1756 (2000W) - Hàng chính hãng,14.0,1479328005391,769000,999000,230000,23,4,dien-gia-dung
48962400,Máy Vắt Cam Sharp EJ-J130-ST - Hàng Chính Hãng,0.0,6255255822967,690000,690000,0,0,0,dien-gia-dung
36364168,"Bàn là hơi nước không dây SOKANY 2400W, AJ-2085 - Hàng chính hãng",19.0,5871595860158,549000,549000,0,0,6,dien-gia-dung
32564261,Ấm Đun Nước Hafele T-907B (1.7 Lít) - Hàng Chính Hãng,2.0,1038103081045,790000,790000,0,0,0,dien-gia-dung
21894780,Máy Sấy Tóc SUNHOUSE SHD2308W (1500W) - Hàng chính hãng,281.0,6484285682696,290000,440000,150000,34,20,dien-gia-dung
17492190,Quạt treo 2 dây cao cấp Senko Hàng Chính Hãng - TC16.,6.0,8562443662754,374000,374000,0,0,1,dien-gia-dung
12638220,Máy Sấy Tóc Tiross TS4321,27.0,3173534072823,399000,399000,0,0,3,dien-gia-dung
7389439,Máy Sấy Tóc Philips BHC015/00 - Hàng Chính Hãng,92.0,1783614158341,395000,414000,19000,5,22,dien-gia-dung
4173393,Siêu sắc thuốc Trường Thọ Bát Tiên Rồng Vàng BA-2086 - Hàng Chính Hãng,0.0,5564038430642,268000,268000,0,0,0,dien-gia-dung
2365981,Nồi Cơm Nắp Gài Toshiba RC-18JFM(H)VN (1.8L) - Hàng chính hãng,1018.0,5054513596302,596000,790000,194000,25,138,dien-gia-dung
1007250,Quạt Hút Âm Trần Mitsubishi EX-25SC5T - Hàng Chính Hãng,2.0,1674553402728,980000,980000,0,0,0,dien-gia-dung
900800,Nồi Cơm Điện Tử Kangaroo KG596 (1.5 Lít) - Vàng đồng - Hàng chính hãng,123.0,1896268104173,1060000,2300000,1240000,54,26,dien-gia-dung
466051,Ấm Siêu Tốc Du Lịch Tiross TS1360 0.5L- Tím - Hàng chính hãng,2.0,1792387231526,390000,390000,0,0,0,dien-gia-dung
276003962,Nước tẩy trang bí đao Cocoon 500ml,8337.0,5071456501279,295000,295000,0,0,13,lam-dep-suc-khoe
25108217,Sữa rửa mặt ngăn ngừa mụn Acnes Creamy Wash 100g,123182.0,2658167596560,60000,75000,15000,20,230,lam-dep-suc-khoe
54058503,Sữa rửa mặt dưỡng trắng Hada Labo Perfect White Tranexamic Acid Cleanser 80g,40692.0,7934228375257,82000,97000,15000,15,646,lam-dep-suc-khoe
174071718,"Sữa rửa mặt Hada Labo cho da dầu mụn, da nhạy cảm Hada Labo Acne Care Calming Cleanser 80g",15735.0,2253420980021,89900,99000,9100,9,43,lam-dep-suc-khoe
275969483,Nước sen Hậu Giang (toner) giúp phục hồi cho da rất nhạy cảm Cocoon 310ml,1064.0,1877517580125,295000,295000,0,0,6,lam-dep-suc-khoe
277834595,Dầu Gội Dove Hỗ Trợ Phục Hồi Tóc Hư Tổn 640g,2864.0,5099808018379,380000,380000,0,0,0,lam-dep-suc-khoe
276985434,Sáp khử mùi Enchantuer Sensation 40g,6697.0,6510936912524,84000,84000,0,0,0,lam-dep-suc-khoe
276003895,Tẩy Da Chết Mặt Cà Phê Đắk Lắk Cocoon 150ml,14578.0,1357691612573,164000,165000,1000,1,16,lam-dep-suc-khoe
275970393,Nước dưỡng tóc tinh dầu bưởi Cocoon 140ml - NEW,15428.0,3634454986319,157000,165000,8000,5,20,lam-dep-suc-khoe
1313889,"Kem chống nắng Skin Aqua cho da mụn, dạng sữa dùng hàng ngày Sunplay Skin Aqua Acne Clear Eco Việt Nam SPF 50, PA++++ 25g",8237.0,9725613668911,112000,134000,22000,16,428,lam-dep-suc-khoe
5902685,"Sữa rửa mặt vitamin làm sáng da, mờ sẹo thâm dạng kem Acnes Vitamin Cleanser 100g",109091.0,4767008638425,60000,75000,15000,20,314,lam-dep-suc-khoe
631525,Sữa rửa mặt cải thiện dấu hiệu lão hóa dạng kem Hada Labo Pro-Aging Retinol B3 Cleanser 80g,30918.0,3452217475169,82000,97000,15000,15,471,lam-dep-suc-khoe
275710724,"Kem xả phục hồi tóc Dove Phục Hồi Hư Tổn Công nghệ độc quyền Định Vị Hư Tổn Chính Xác cho tóc suôn mượt, khỏe đẹp 610g",2883.0,7159192130357,159000,186510,27510,15,2,lam-dep-suc-khoe
275085359,Kem Rửa Mặt Dưỡng Ẩm Tối Ưu Hada Labo Advanced Nourish Hyaluron Cleanser (15g),440.0,6331311181537,20000,20000,0,0,0,lam-dep-suc-khoe
252166409,Sữa rửa mặt Simple giúp kiềm dầu và ngừa mụn hiệu quả - cho da mụn nhạy cảm 150ml,2493.0,7627528271994,99500,132000,32500,25,10,lam-dep-suc-khoe
195927144,"[148 Mùi Hương] Tinh Dầu Thơm Phòng Trái Cây Thiên Nhiên - Xông Thơm Phòng, Khử Mùi - Tinh Dầu Đào/ Xoài/ Táo Xanh/ Chuối/ Dưa Hấu/ Dưa Lưới/ Me (20ml)",1691.0,3477824003259,110000,110000,0,0,178,lam-dep-suc-khoe
275970279,Tẩy da chết cơ thể cà phê Dăk Lăk  Cocoon - Hũ 200ml,1597.0,2220589829080,89000,125000,36000,29,11,lam-dep-suc-khoe
10640154,Sữa rửa mặt kiểm soát nhờn ngăn ngừa mụn dạng gel Acnes Oil Control Cleanser 100g,55452.0,1683721181235,60000,75000,15000,20,305,lam-dep-suc-khoe
25107897,Sữa rửa mặt tạo bọt ngăn ngừa mụn Acnes Foaming Wash 150ml,1954.0,7063222770031,73400,84000,10600,13,186,lam-dep-suc-khoe
631034,Sữa rửa mặt dưỡng ẩm tối ưu Hada Labo Advanced Nourish Cleanser 80g,63755.0,3456951245675,74000,87000,13000,15,1241,lam-dep-suc-khoe
630777,"Kem chống nắng Sunplay cực mạnh dạng sữa Sunplay Super Block SPF 81, PA++++ 70g",26724.0,3443333383469,167000,192000,25000,13,415,lam-dep-suc-khoe
188116913,Xà phòng trị mụn lưng và rửa mặt Acnes Washing Bar 75g,17389.0,3160276353620,75000,75000,0,0,14,lam-dep-suc-khoe
182457734,"Túi chườm nóng lạnh PUHA 350ml, túi chườm sưởi ấm giảm đau bụng kinh họa tiết dễ thương",306.0,2269046494960,105000,105000,0,0,54,lam-dep-suc-khoe
117170053,Nước hoa hồng Simple Toner làm dịu và cân bằng độ ẩm cho da - lành tính không chứa cồn 200ml [Chính hãng độc quyền],3760.0,3418243072938,125000,160500,35500,22,247,lam-dep-suc-khoe
114271441,Bộ đôi Kem chống nắng dạng sữa dịu nhẹ cho da nhạy cảm và trẻ em (Anessa Mild Milk 60ml x2),3841.0,5997853731618,1160000,1430000,270000,19,4,lam-dep-suc-khoe
114271269,Bộ đôi Kem chống nắng dạng sữa dưỡng da kiềm dầu bảo vệ hoàn hảo (Anessa Gold Milk 60ml x2),6339.0,7538371546194,1150000,1430000,280000,20,25,lam-dep-suc-khoe
98605258,Bao cao su Durex Jeans Hộp 30 bao,4283.0,2902268436524,279000,500000,221000,44,761,lam-dep-suc-khoe
77305646,Kem chống nắng dạng sữa dịu nhẹ cho da nhạy cảm và trẻ em Anessa Perfect UV Sunscreen Mild Milk For Sensitive Skin SPF 50+ PA++++ 60ml,12091.0,5907987092049,575000,715000,140000,20,38,lam-dep-suc-khoe
20541866,"Dầu gội Selsun chống gàu, sạch gàu & hết ngứa da đầu Selsun Anti-Dandruff Shampoo 50ml",143758.0,5763102118633,52900,59000,6100,10,401,lam-dep-suc-khoe
6874429,Miếng dán mụn giúp giảm mụn sưng viêm Acnes Clear Patch (24 Miếng),68622.0,4184432856513,51000,64000,13000,20,318,lam-dep-suc-khoe
5560235,Gel bôi trơn Durex Play Classic 50ml,27000.0,9440759745486,80000,135000,55000,41,1511,lam-dep-suc-khoe
1672211,Gel bôi trơn Durex Play Warming 100ml,7307.0,5109134653245,167000,194000,27000,14,519,lam-dep-suc-khoe
1672157,Bao cao su Durex Invisible Extra Thin Extra Sensitive 1 Hộp 10 Bao,11379.0,6898690858292,225000,304000,79000,26,1501,lam-dep-suc-khoe
1672153,Bao cao su Durex Performa 12 bao,9823.0,9559459896647,224000,300000,76000,25,1491,lam-dep-suc-khoe
1634983,Phim Thấm Dầu Acnes Oil Remover Film 50 Tờ,23809.0,2209674920654,69000,69000,0,0,114,lam-dep-suc-khoe
1634981,"Giấy thấm dầu kiểm soát nhờn, ngừa mụn Acnes Oil Remover Paper 100 tờ",109029.0,3595469546314,32000,33000,1000,3,261,lam-dep-suc-khoe
1537315,Gel bôi trơn Durex K-Y Jelly 50g - KY Jelly,3211.0,5809255960573,83000,98000,15000,15,449,lam-dep-suc-khoe
796867,Bao cao su Durex Invisible Extra Thin Extra Sensitive 1 Hộp 3 Bao,14819.0,6375951331676,80000,80000,0,0,624,lam-dep-suc-khoe
767101,Bao cao su Durex Kingtex 12 bao,67811.0,3470412766745,112300,196000,83700,43,1472,lam-dep-suc-khoe
632680,"Dầu gội Selsun chống gàu, sạch gàu & hết ngứa da đầu Selsun Anti-Dandruff Shampoo 100ml",424908.0,3469267168798,86900,99000,12100,12,1625,lam-dep-suc-khoe
580690,Lăn Khử Mùi Cao Cấp Enchanteur Charming 50ml - 1012044,55339.0,3892317306633,72100,95000,22900,24,3,lam-dep-suc-khoe
385582,Bao cao su Durex Fetherlite Hộp 12 Bao,27818.0,1327050429148,192500,370920,178420,48,219,lam-dep-suc-khoe
385477,Bao cao su Durex Fetherlite Ultima Hộp 12 Bao,15409.0,1329671613418,219000,802800,583800,73,367,lam-dep-suc-khoe
275970806,Dầu gội bưởi Cocoon 310ml,575.0,5630818448079,265000,265000,0,0,4,lam-dep-suc-khoe
277047204,Sữa Rửa Mặt Sen Hậu Giang Cocoon 140ml,305.0,6834338258028,194000,195000,1000,1,1,lam-dep-suc-khoe
276862669,Dung dịch chống muỗi dạng phun sương Remos Mentholatum hương Sả Chanh 70ml,658.0,2963963181946,40000,40000,0,0,0,lam-dep-suc-khoe
22052317,Kem Rửa Mặt Tút Sáng Từ Đất Sét Trắng Oxy White Complete (100g),24235.0,6588652141875,81900,82000,100,0,168,lam-dep-suc-khoe
277020768,Sữa Rửa Mặt Simple Dưỡng Ẩm Cho Da Dạng Gel 150ml Water Boost Micellar Facial Gel Wash,1788.0,4112438692780,132000,132000,0,0,0,lam-dep-suc-khoe
276348907,[100 Cái 6A] Thùng/Combo Khẩu Trang Y Tế Kháng Khuẩn Chống Nắng 6A  An Tâm -10 Túi/100 Cái,150.0,8412179290703,82000,95000,13000,14,9,lam-dep-suc-khoe
276130541,Nước dưỡng tóc tinh dầu bưởi Cocoon 310ml,96.0,1716864761888,293000,304688,11688,4,1,lam-dep-suc-khoe
275967914,Sữa rửa mặt dạng Gel bí đao rửa mặt Cocoon 310ml,1366.0,5970545571885,294000,300000,6000,2,9,lam-dep-suc-khoe
274948742,"[MỚI] Kem tẩy lông Veet cho da nhạy cảm 50g, công thức Pure cải tiến",3350.0,7260847445872,82000,120000,38000,32,15,lam-dep-suc-khoe
274506630,Ủ tóc cao cấp FINO Premium Touch 230g,23611.0,9084021459087,151000,219000,68000,31,3,lam-dep-suc-khoe
248684066,Kem chống nắng cho da dầu mụn Acnes Blemish Control Sunscreen 50g,1889.0,2803961872314,129000,155000,26000,17,7,lam-dep-suc-khoe
1313891,Xịt khử mùi chiết xuất thiên nhiên Refre Natural Green Tea Hương Trà Xanh (30ml),996.0,2395204997538,62400,68000,5600,8,87,lam-dep-suc-khoe
176672117,Sữa rửa mặt ngăn ngừa mụn dạng gel Acnes Gentle Wash 100g,3355.0,8683541917200,67500,75000,7500,10,44,lam-dep-suc-khoe
273598230,Máy Tăm Nước Không Dây LocknLock Cordless Oral Irrigator ,11202.0,6358535348509,907000,1263000,356000,28,1988,lam-dep-suc-khoe
270446089,Bộ travel size cho nam sạch sâu toàn diện Oxy Deep Travel Set (Kem rửa mặt 25g + Dầu gội 50g + Sữa tắm 50g),58.0,9052772405208,94000,94000,0,0,0,lam-dep-suc-khoe
263795519,Xịt chống muỗi Rohto Mentholatum Remos Hương Lavender 150ml,642.0,3881535262587,58000,70000,12000,17,15,lam-dep-suc-khoe
197922834,"Tinh dầu Cà Phê Homer 100ml - Tinh Dầu Xông Thơm Phòng, Thư Giãn, Khử Mùi - Tinh dầu Sả Chanh/ Vỏ Quế/ Cam Ngọt/ Oải hương/ Ngọc Lan Tây/ Tràm Trà/ Bưởi Ngọt",848.0,2333003222567,70000,70000,0,0,81,lam-dep-suc-khoe
195937919,"[148 Mùi Hương] Tinh Dầu Thơm Phòng Trái Cây Thiên Nhiên Nhiệt Đới - Khử Mùi, Xông Thơm Phòng - Tinh Dầu Đào/ Chuối/ Táo Xanh/ Mơ/ Me/ Xoài/ Dưa Lưới/ Dưa Hấu (100ml)",810.0,4218299073522,275000,275000,0,0,69,lam-dep-suc-khoe
186288869,Bộ đai chườm nóng thảo dược giảm đau đầu gối dùng điện - Hapaku,548.0,7384245333100,907000,955000,48000,5,106,lam-dep-suc-khoe
171564906,"Dầu gội Selsun chống gàu, sạch gàu & hết ngứa da đầu Selsun Anti-Dandruff Shampoo 250ml",12610.0,8977034180896,194000,223000,29000,13,450,lam-dep-suc-khoe
161256063,"Sữa tắm cho nam sạch sâu, khử mùi cơ thể Oxy Deep Shower",532.0,8126365257485,143000,159000,16000,10,58,lam-dep-suc-khoe
161256062,Dầu gội cho nam sạch sâu giảm ngứa Oxy Deep Shampoo,504.0,4195087522068,69100,77000,7900,10,79,lam-dep-suc-khoe
153599393,Son lì dạng thỏi Flawsome Creamy Lip Stain (2g),1487.0,4269031820418,180000,180000,0,0,298,lam-dep-suc-khoe
153597872,Son thỏi dưỡng môi trang điểm chất son satin Lip On Lip Glowy Satin 2.2g,717.0,5452746728151,151000,174000,23000,13,68,lam-dep-suc-khoe
149467412,"Tinh Dầu Ngọc Lan Tây Homer 100ML - Tinh Dầu Thiên Nhiên Nhập Khẩu Nguyên Chất Giúp Giảm Stress, Khử Khuẩn và Xua Đuổi Côn Trùng, Sử Dụng Hiệu Quả với Máy Xông Tinh Dầu",1047.0,5382080942820,85000,85000,0,0,54,lam-dep-suc-khoe
149460253,"Tinh Dầu Oải Hương Homer 100ML - Tinh Dầu Lavender Thiên Nhiên Nhập Khẩu Nguyên Chất Giúp Giảm Stress, Khử Khuẩn và Xua Đuổi Côn Trùng, Sử Dụng Hiệu Quả với Máy Xông Tinh Dầu",592.0,3726079666984,85000,85000,0,0,59,lam-dep-suc-khoe
117147635,Sữa rửa mặt Simple giúp da sạch thoáng & không chứa xà phòng 150ml [CHÍNH HÃNG ĐỘC QUYỀN],28994.0,1371859953494,109000,132000,23000,17,584,lam-dep-suc-khoe
95127416,"Tinh Dầu Cam Ngọt Homer 100ml - Chính Hãng, Đạt Chuẩn Kiểm Định Cao Cấp - Tinh Dầu Xông Thơm Phòng, Thư Giãn, Khử Mùi hiệu quả",1426.0,4442752002570,90000,90000,0,0,58,lam-dep-suc-khoe
91566964,Chỉ nha khoa SGS nhập khẩu Hàn Quốc - 840D hương bạc hà,239.0,5720837648675,35000,70000,35000,50,26,lam-dep-suc-khoe
68491597,Dầu gội ngăn rụng tóc 50 Megumi Hair Fall Control Shampoo,2517.0,1628969773668,145000,170000,25000,15,226,lam-dep-suc-khoe
14423711,Tấm thảo dược thay thế của đai chườm lưng cắm điện - Hapaku,329.0,7160914455990,127000,127000,0,0,45,lam-dep-suc-khoe
12504675,Sữa tắm Enchanteur Delightful (650g),2589.0,8571747229808,169000,222000,53000,24,6,lam-dep-suc-khoe
2738475,Bộ 3 Hộp Silcot Bông Trang Điểm (bông tẩy trang) Nhật Bản (82 Miếng/Hộp),56.0,1646370110605,115000,115000,0,0,6,lam-dep-suc-khoe
2123245,Sữa Rửa Mặt Mịn Và Săn Chắc Da Senka Perfect Whip Collagen In 120G - [4901872462087],108943.0,3634879170983,91900,150000,58100,39,54,lam-dep-suc-khoe
1687623,Kem chống muỗi Rohto Metholatum Remos Hương Lavender 70g,2626.0,2956610150254,28300,29000,700,2,239,lam-dep-suc-khoe
1672155,Bao cao su Durex Kingtex 3 bao,24324.0,9694736411257,36000,55000,19000,35,592,lam-dep-suc-khoe
1313871,"Kem chống nắng Sunplay cực mạnh dạng sữa Sunplay Super Block SPF 81, PA++++ 30g",55839.0,4314609909401,93900,108000,14100,13,283,lam-dep-suc-khoe
631959,Kem mờ sẹo và thâm dạng gel Acnes Scar Care 12g,6691.0,3455837237605,75500,82000,6500,8,380,lam-dep-suc-khoe
470430,"Kem Dưỡng Giảm Mụn, Ngừa Thâm, Thông Thoáng Lỗ Chân Lông La Roche-Posay Effaclar Duo+ 40ml",79.0,1337548148130,287000,287000,0,0,14,lam-dep-suc-khoe
385654,Bao cao su Durex Performa 3 bao,3864.0,1320958553045,67000,79000,12000,15,607,lam-dep-suc-khoe
385615,Bao cao su Durex Pleasuremax Hộp 12 Bao,2833.0,1324765746584,198000,268000,70000,26,462,lam-dep-suc-khoe
275971957,"Combo 2 Dầu Gội Clear Sạch Gàu Dầu Gội Sạch Gàu Mát Lạnh Bạc Hà 10X Sức Mạnh Đánh Bay Gàu, Ngứa, Vi Khuẩn 1.4kg",14.0,7772824146763,578000,740000,162000,22,2,lam-dep-suc-khoe
275970264,Tẩy da chết cơ thể cà phê Dăk Lăk  Cocoon - Túi refill 600ml,1112.0,1205650618047,293000,325000,32000,10,7,lam-dep-suc-khoe
275969510,Bơ dưỡng thể cà phê Dak Lak 200ml,7.0,2877425122622,201563,201563,0,0,1,lam-dep-suc-khoe
275926329,Tắm Gội 2 trong 1 Romano Vip 650g,742.0,4588986631033,183000,186000,3000,2,3,lam-dep-suc-khoe
275893746,"Cân điện tử thông minh 365 Selection WS1 / WS2 - Đo 18 chỉ số cơ thể, Màn hình led hiển thị - HÀNG CHÍNH HÃNG",4.0,1133888541623,590000,590000,0,0,0,lam-dep-suc-khoe
275066051,"[MỚI] Gel bôi trơn Durex Classic gốc nước - Bao bì mới, cải tiến công thức thêm mượt mà, 50ML/chai",71.0,1965934844750,83000,98000,15000,15,0,lam-dep-suc-khoe
273201159,[300 Cái Khẩu Trang KF94] Thùng Khẩu Trang Y Tế Kháng Khuẩn KF94 An Tâm- 4 Lớp,721.0,3495082524113,189000,229000,40000,17,94,lam-dep-suc-khoe
273188043,Phấn nước trang điểm dưỡng da GLAMRR Q LONG WEAR DD CUSHION by Gilaa (1 lõi x 13g),73.0,5114753826004,385000,525000,140000,27,13,lam-dep-suc-khoe
271970659,Máy Massage Lưng PHILIPS PPM4501 Trang bị 12 đầu massage riêng biệt 4 chế độ massage - Hàng chính hãng,10.0,2295544710116,2690000,2690000,0,0,2,lam-dep-suc-khoe
270688219,Nước nhỏ mắt cấp ẩm & bổ sung nước mắt nhân tạo V.Rohto DryEye 13ml,1565.0,7643390151152,61300,64000,2700,4,27,lam-dep-suc-khoe
263795517,Xịt chống muỗi cho bé từ 6 tháng tuổi hương khuynh diệp Rohto Mentholatum Remos Baby Spray 70ml,325.0,1670772165808,63000,76000,13000,17,4,lam-dep-suc-khoe
257857032,Bộ 4 Đầu Bàn Chải Điện LocknLock,1715.0,5824076535520,151000,252000,101000,40,304,lam-dep-suc-khoe
193879341,"Gel bôi trơn Feelex Lubricant mát lạnh, ấm nóng, siêu trơn - Lọ 250ml",5261.0,7373059130513,109000,109000,0,0,761,lam-dep-suc-khoe
186270101,Bộ đai chườm nóng thảo dược giảm đau vai gáy dùng điện - Hapaku,935.0,3658613856488,945000,995000,50000,5,152,lam-dep-suc-khoe
185396832,"Kệ , Tủ Mỹ Phẩm Trang Điểm Để Bàn Có Gương Nhiều Ngăn - Hàng Chính Hãng ",21.0,7105991609749,136850,206000,69150,34,4,lam-dep-suc-khoe
179980125,Combo 2 Nước Rửa Tay Lifebuoy Bảo Vệ Vượt Trội 10 Giúp Sạch Khuẩn Và Bảo Vệ Vượt Trội Khỏi 99.9% Vi Khuẩn Tốt Nhất Chai 450g,10225.0,7267646207754,156000,156000,0,0,136,lam-dep-suc-khoe
179953046,Sữa Rữa Mặt Xmen 100g - Đa tác dụng,186.0,3879955853058,82000,82000,0,0,34,lam-dep-suc-khoe
163716188,<7cái / HỘP> Khẩu trang trẻ em 3D cao cấp - có nhiều hoạ tiết bắt mắt và nhiều màu sắc ngầu nhiên -  Doctor K  - AN TÂM SỬ DỤNG,152.0,8100629846700,39000,39000,0,0,10,lam-dep-suc-khoe
121314816,Kem dưỡng ngày giảm thâm nám & sáng da Eucerin Spotless Brightening SPF30 50ml,41.0,2643592606048,490000,929000,439000,47,8,lam-dep-suc-khoe
91120320,Sữa tắm cho da nhạy cảm Eucerin pH5 Washlotion 1000ml,43.0,3402497463983,349000,499000,150000,30,3,lam-dep-suc-khoe
81517203,"Máy Massage Mặt Làm Đẹp Da 5 in 1 Photon Nóng Và Lạnh EMS Giúp Nâng Cơ Mặt, Rửa Sạch Sâu, Tăng Cường Hấp Thụ Và Khóa Giữ Tinh Chất Dưỡng Da Kèm Máy Massage Mắt Loại Quầng Thâm ",310.0,8421100520479,1388000,1388000,0,0,116,lam-dep-suc-khoe
70662253,Kem Chống Nắng Không Màu Kiểm Soát Dầu La Roche-Posay Anthelios XL Dry Touch Gel-Cream SPF 50+ UVB & UVA (50ml),1031.0,4484346490897,364000,560000,196000,35,298,lam-dep-suc-khoe
68832828,Cân Sức Khỏe Điện Tử LocknLock ENC516BLK Dùng Trong Gia Đình - 180kg,1797.0,1489296278208,478000,702000,224000,32,406,lam-dep-suc-khoe
63165307,Kem Hỗ Trợ Làm Mờ Sẹo Dermatix Ultra 15g,1157.0,7605007825354,370000,370000,0,0,298,lam-dep-suc-khoe
51542699,Kem chống nắng dạng gel dưỡng sáng nâng tông & hiệu chỉnh sắc da Anessa Brightening UV Sunscreen Gel SPF50+ PA++++ 90g,3148.0,6843467417585,575000,575000,0,0,35,lam-dep-suc-khoe
51540051,Kem chống nắng dạng sữa dưỡng da kiềm dầu bảo vệ hoàn hảo Anessa Perfect UV Sunscreen Skincare Milk SPF 50+ PA++++ 60ml,4722.0,5944012574973,609000,715000,106000,15,132,lam-dep-suc-khoe
45317173,Nước Rửa Tay Gốc Thực Vật Peace Mass (Thuộc nhóm Sản phẩm Lành tính / Hữu cơ/ Sinh học) Chai 340ml,3275.0,9919698734627,39000,39000,0,0,59,lam-dep-suc-khoe
38549639,Bộ Sữa Rửa Mặt và Tẩy Tế Bào Chết Dành Cho Da Mụn Eucerin ProAcne Solution Cleansing Gel 200ml,142.0,4325952104603,606000,758000,152000,20,33,lam-dep-suc-khoe
25108019,Gel chấm mụn đầu trắng và đầu đen Acnes Sealing Jell 18g,5398.0,7588549571715,65400,72000,6600,9,333,lam-dep-suc-khoe
22052322,Sữa rửa mặt cho nam Oxy sạch sâu giảm nhờn dạng kem có hạt massage Oxy Deep Wash 100g,58615.0,4019768556724,73000,86000,13000,15,245,lam-dep-suc-khoe
14115539,Nước tẩy trang SENKA A.L.L. CLEAR WATER Micellar Formula White 230ml,30251.0,8621265053987,95900,125000,29100,23,291,lam-dep-suc-khoe
6430923,Lăn khử mùi chiết xuất thiên nhiên Refre Natural,2580.0,1631857977352,55000,68000,13000,19,221,lam-dep-suc-khoe
2775387,Bao Cao Su Sagami Xtreme Super Thin (10 Cái / Hộp),1058.0,2081082615199,98000,98000,0,0,97,lam-dep-suc-khoe
2042227,Bao cao su Durex Invisible Extra Thin Extra Lubricated 1 Hộp 10 Bao,7958.0,4365264739322,242000,330000,88000,27,1098,lam-dep-suc-khoe
2042221,Gel bôi trơn Durex Play Strawberry 100ml,3954.0,1672580728927,167000,194000,27000,14,426,lam-dep-suc-khoe
1325569,Combo 3 Cặp Nút Tai Chống Ồn 3M 1290 - Xanh,295.0,7183506255600,56260,56260,0,0,18,lam-dep-suc-khoe
542967,Dầu Xả Pantene Ngăn Rụng Tóc Chai 650ml,1039.0,9207039920403,129000,165000,36000,22,0,lam-dep-suc-khoe
525522,Sữa Tắm Nước Hoa Enchanteur Charming 650g,19845.0,9200349440111,147000,222000,75000,34,18,lam-dep-suc-khoe
385614,Bao cao su Durex Pleasuremax Hộp 3 Bao,4908.0,1324180088559,56000,522000,466000,89,201,lam-dep-suc-khoe
385574,Durex Gel Bôi Trơn Play Massage 2 - in- 1 200ml,3104.0,1323498445351,266000,317000,51000,16,560,lam-dep-suc-khoe
277775740,Dung dịch chống muỗi dạng phun sương Rohto Mentholatum Remos Hương Lavender 70ml,350.0,4074169953184,42000,42000,0,0,0,lam-dep-suc-khoe
276522882,Khẩu Trang Y Tế Kháng Khuẩn Cao Cấp An Tâm - 4 Lớp - 50 Cái/Hộp,130.0,9896724439143,29000,48000,19000,40,1,lam-dep-suc-khoe
275706052,[DORCO GIFT] DORCO TG-II - Dao Cạo Râu Hàn Quốc 2 Lưỡi - 2 Cây Dao Cạo Tiện Lợi,99.0,1493829376859,25000,25000,0,0,0,lam-dep-suc-khoe
274964902,Máy tăm nước LocknLock ENR154WHT - Kèm 4 đầu tăm - Dung tích 250ml - Màu trắng,95.0,8130901886277,1020000,1380000,360000,26,15,lam-dep-suc-khoe
274948725,"[MỚI] Kem tẩy lông Veet cho da nhạy cảm, hộp lớn 100g tiết kiệm, công thức Pure cải tiến",181.0,3182460501977,145000,166000,21000,13,9,lam-dep-suc-khoe
274675848,Kem Đánh Răng Marvis Whitening Mint 85ml,86.0,7467030238182,189000,279000,90000,32,5,lam-dep-suc-khoe
273952811,"Bộ Đôi Kem Dưỡng Chống Lão Hóa Da Ngày Và Đêm Pond's Age Miracle giúp mờ đốm nâu, nếp nhăn với 50X Hexyl-Retinol 45g x 2",8026.0,5189947579427,608000,760000,152000,20,776,lam-dep-suc-khoe
273532971,Máy tăm nước LocknLock ENR146WHT - Dung tích 190ml - Màu trắng,303.0,9488003409084,1030000,1440000,410000,28,48,lam-dep-suc-khoe
273386945,"Bao Cao Su Durex Invisible Siêu Mỏng, Size 52 mm, Hộp 16 Bao Mới Ra Mắt - Hộp Lớn Siêu Tiết Kiệm",37.0,8302387991939,329000,485000,156000,32,0,lam-dep-suc-khoe
273167960,"Máy Massage Mắt Hình Chiếc Bút Chống Thâm Quầng, Chống Đau Mỏi Mắt Mini Giúp Trẻ Đẹp (Chọn Màu Sắc) (Hàng Chính Hãng)",24.0,1106552870638,24000,24000,0,0,1,lam-dep-suc-khoe
270185520,"Tinh Dầu Nguyên Chất 24Care 50ml - Tinh Dầu Xông Thơm Phòng Giúp Giảm Căng Thẳng, Thư giãn, Đuổi Muỗi và Khử Mùi - Tinh dầu Sả Chanh/ Cam Ngọt/ Oải hương/ Ngọc Lan Tây/ Tràm Trà/ Bưởi Ngọt/ Vỏ Quế",2056.0,6768015732935,215000,215000,0,0,1,lam-dep-suc-khoe
263795515,Xịt chống muỗi Rohto Mentholatum Remos Hương Sả Chanh 150ml,586.0,4122348065944,67300,70000,2700,4,11,lam-dep-suc-khoe
260844985,"Kem Làm Mờ Sẹo Thâm, Sẹo Rỗ, Sẹo Lõm Scar Esthetique của Rejuvaskin - thương hiệu hỗ trợ trị sẹo Hoa Kỳ",9717.0,5726405910537,400000,420000,20000,5,1576,lam-dep-suc-khoe
252355782,"Miếng dán massage xung điện mini cổ vai gáy, cơ bắp tay toàn thân, 10 chế độ massage chế độ sạc pin tiện dụng",24.0,6406184922335,35000,35000,0,0,0,lam-dep-suc-khoe
212219580,"Bàn Chải Đánh Răng Điện Locknlock ENR346 - DC3.7V, Trọng Lượng 235g, Sạc Không Dây",6167.0,2723615974165,1040000,1664000,624000,38,1784,lam-dep-suc-khoe
191680827,Kem chống nắng nâng tông kiềm dầu innisfree Tone Up No Sebum Sunscreen EX SPF 50+ PA++++ 60 mL (New 2023),1536.0,5820787492792,373000,450000,77000,17,144,lam-dep-suc-khoe
167926077,Đông trùng hạ thảo Kingdom Herb chính hãng loại thượng hạng sấy thăng hoa hộp 10 gram (tặng bình nước thủy tinh cao cấp),301.0,3306658250421,465000,869000,404000,46,47,lam-dep-suc-khoe
158399593,"[CHÍNH HÃNG] Một thùng 300 CÁI khẩu trang 4 lớp KF94 kháng khuẩn, chống bụi mịn, công nghệ 4D Hàn Quốc",8412.0,8305837791336,210000,320000,110000,34,1632,lam-dep-suc-khoe
152709665,Máy Tăm Nước Cầm Tay - Tăm Nước Vệ Sinh Răng Miệng Oral Irrigator - Bản Quốc Tế Chuẩn Châu Âu,381.0,8217748076955,169000,169000,0,0,81,lam-dep-suc-khoe
140107223,Sữa dưỡng thể Vaseline Healthy White UV Lightening Body Lotion 725ml,118.0,3882346043582,165000,165000,0,0,22,lam-dep-suc-khoe
134591513,Lăn khử mùi dành cho nam Aquaselin 50ml,1059.0,9188158520903,290000,290000,0,0,97,lam-dep-suc-khoe
133245970,Bộ 2 đầu bàn chải điện P/S - Sạch Sâu,5309.0,5988384160444,192000,200000,8000,4,438,lam-dep-suc-khoe
118209733,Kem dưỡng đêm giảm thâm nám & sáng da Eucerin Spotless Brightening 50ml,52.0,8311237793351,490000,929000,439000,47,9,lam-dep-suc-khoe
117147637,"Sữa rửa mặt Simple giúp cấp ẩm, da trông khỏe và mịn màng - cho da khô nhạy cảm 150ml [CHÍNH HÃNG ĐỘC QUYỀN] [MỚI]",8967.0,9277076017940,101000,132000,31000,23,226,lam-dep-suc-khoe
102513190,"Viên Uống Dầu Cá Bổ Não, Sáng Mắt, Tăng Miễn Dịch Healthy Care Fish Oil 1000mg Omega 3 hỗ trợ tăng cường miễn dịch, bổ xương khớp,  mắt và thần kinh nuôi dưỡng làn da căng mịn, ẩm mượt",568.0,4338788230708,399000,450000,51000,11,94,lam-dep-suc-khoe
91604685,Kem chống nắng kiềm dầu & ngừa mụn Eucerin Sun Dry Touch SPF50+ 50ml,50.0,4867890646937,265000,549000,284000,52,4,lam-dep-suc-khoe
90135780,"Tinh Dầu Sả Chanh TOKIMORI Xuất Khẩu Nhật Bản (50ml) 100% Thiên Nhiên, An Toàn Cho Trẻ, Xông Phòng, Khử Mùi, Kháng Khuẩn, Đuổi Muỗi, Giải Cảm",2901.0,3703637586524,119000,218000,99000,45,628,lam-dep-suc-khoe
86539325,"Combo 6 Băng vệ sinh thảo dược Doctor Care, BVS ban ngày 24cm siêu khô thoáng cả ngày dài",895.0,7700595870431,168500,198000,29500,15,151,lam-dep-suc-khoe
73574991,"Dego Pharma - Dầu gội sạch vảy gàu mảng trắng, hết ngứa chiết xuất thiên nhiên từ vỏ cây Zizyphus, sản xuất theo tiêu chuẩn và dưới sự giám sát của công ty dược phẩm Châu Âu (80ml)",2034.0,4933848780208,258000,258000,0,0,233,lam-dep-suc-khoe
72759100,Bao cao su Ôm sát Siêu mỏng Powermen Kéo dài thời gian quan hệ cho Nam ( Size 49mm),201.0,9088898043164,120000,120000,0,0,24,lam-dep-suc-khoe
51559883,Bộ đôi Kem chống nắng dạng sữa dưỡng da kiềm dầu bảo vệ hoàn hảo (Anessa Gold Milk 60ml + Gold Milk 20ml),9153.0,2172451224446,760000,1000000,240000,24,238,lam-dep-suc-khoe
51542411,Kem chống nắng dạng gel dưỡng ẩm bảo vệ hoàn hảo Anessa Perfect UV Sunscreen Skincare Gel SPF50+ PA++++ 90g,1443.0,1347957788148,516000,575000,59000,10,28,lam-dep-suc-khoe
46643670,"Cho máy Oral-B Braun,  Bộ 4 đầu bàn chải đánh răng điện - Trẻ em, cho mọi loại máy - EB10A",286.0,3982892817904,88000,88000,0,0,62,lam-dep-suc-khoe
32237380,Kem dưỡng ban đêm Sắc Ngọc Khang dưỡng sáng và mờ thâm nám 30g,563.0,7019229689302,276000,276000,0,0,121,lam-dep-suc-khoe
25738219,Floslek Sữa Rửa Mặt Dạng Gel Cho Da Nhờn Mụn Anti Acne Bacterial Face Cleansing Gel 200ml,223.0,8279611570840,396000,396000,0,0,47,lam-dep-suc-khoe
22052325,Sữa rửa mặt cho nam Oxy sạch sâu mát lạnh dạng kem Oxy Perfect Wash 100g,65103.0,2615865075643,70000,82000,12000,15,94,lam-dep-suc-khoe
22052319,Sữa rửa mặt cho nam Oxy sạch sâu giảm mụn kiểm soát nhờn dạng kem Oxy Total Anti Acne 100g,19988.0,5100275865894,75000,86000,11000,13,250,lam-dep-suc-khoe
11949005,[24 cái] Bộ 2 hộp bao cao su Innova Đen - Kéo dài thời gian | Hộp 12 cái,3259.0,7257232626529,175000,175000,0,0,378,lam-dep-suc-khoe
10071383,Sữa Tắm Lifebuoy Detox Và Sạch Sâu Khỏi Bụi Mịn Pm2.5 Detox Bảo Vệ Khỏi Vi Khuẩn Gây Mụn Cơ Thể Matcha & Khổ Qua Chai 800G,0.0,5054707209810,177000,177000,0,0,1541,lam-dep-suc-khoe
8959289,Tinh chất chống nắng nâng tông Skin Aqua Tone up Lavender cho da tối màu & da vàng Sunplay Skin Aqua Tone Up UV Essence Lavender SPF 50+ PA++++ 50g,21910.0,7332466162606,161000,199000,38000,19,1417,lam-dep-suc-khoe
276852843,"[Mới] Bao cao su Durex 001 Siêu Mỏng, Hộp 3 Bao Mới Ra Mắt",42.0,2565475395401,300000,300000,0,0,0,lam-dep-suc-khoe
276291891,[MUA 2 TẶNG 1]Bodymist unisex - xịt thơm toàn thân lưu hương lâu 6h tự tin đi học đi chơi BODYMISS 30ml (chai),29.0,9875731595381,40000,48000,8000,17,2,lam-dep-suc-khoe
276157877,[MỚI] Bộ 5 gói khẩu trang chống nắng Unicharm UV Mask 5 miếng,30.0,9527885387577,95000,95000,0,0,1,lam-dep-suc-khoe
274317383,Sữa tắm hương nước hoa innisfree My Perfumed Body Cleanser 330ml,81.0,2052364781162,243000,310000,67000,22,7,lam-dep-suc-khoe
273825296,Sữa Tắm Selsun Fungi Shower 150 ml,151.0,6759589389726,94900,119000,24100,20,9,lam-dep-suc-khoe
273711622,Sữa Rửa Mặt Tạo Bọt Chiết Xuất Tơ Tằm Trắng Senka Perfect Whip 120g - 14839,92089.0,6575559634814,83900,125000,41100,33,8,lam-dep-suc-khoe
273455565,Lăn Ngăn Mùi NIVEA Pearl & Beauty Ngọc Trai Quyến Rũ (50ml) - 83735,129146.0,9014944597152,81000,92000,11000,12,8,lam-dep-suc-khoe
273402112,Sữa rửa mặt giúp làm sạch sâu dành cho da dầu CeraVe Foaming Cleanser,482.0,8742389092996,451000,455000,4000,1,23,lam-dep-suc-khoe
273069954,Súng Massage Cầm Tay Cao Cấp Philips PPM7323 - Hàng chính hãng,93.0,5294897679239,790000,790000,0,0,13,lam-dep-suc-khoe
214088657,Sữa Dưỡng Thể NIVEA Extra Bright Dưỡng Sáng Da | Mịn Da (350 ml),16072.0,2365798696665,129000,147000,18000,12,9,lam-dep-suc-khoe
196857628,"Tinh Dầu Kiwi Homer 100ml - Tinh Dầu Xông Thơm Phòng, Thư Giãn Khử Mùi - Tinh Dầu Trái Cây Thiên Nhiên",104.0,3210641018636,90000,90000,0,0,10,lam-dep-suc-khoe
196857071,"Tinh Dầu Táo Xanh Homer 100ml - Tinh Dầu Xông Thơm Phòng, Thư Giãn Khử Mùi - Tinh Dầu Trái Cây Thiên Nhiên",109.0,1258049355444,400000,400000,0,0,11,lam-dep-suc-khoe
196855083,"Tinh Dầu Me Homer 100ml - Tinh Dầu Xông Thơm Phòng, Thư Giãn Khử Mùi - Tinh Dầu Trái Cây Thiên Nhiên",152.0,2777746185432,80000,80000,0,0,14,lam-dep-suc-khoe
196851276,"Tinh Dầu Khóm Homer 100ml- Tinh Dầu Xông Thơm Phòng, Thư Giãn Khử Mùi- Tinh Dầu Trái Cây Thiên Nhiên",155.0,7311553791539,130000,130000,0,0,16,lam-dep-suc-khoe
196463350,"Tinh Dầu Nho Homer 100ml - Xông Thơm Phòng, Thư Giãn Khử Mùi - Tinh Dầu Trái Cây Thiên Nhiên",207.0,6642114996714,320000,320000,0,0,11,lam-dep-suc-khoe
152015621,"Cho máy Oral B Braun Cross Action EB50A, Bộ 4 đầu bàn chải đánh răng điện đánh tan mảng bám Minh House",245.0,2635583226300,95000,95000,0,0,42,lam-dep-suc-khoe
133245977,Bộ 2 đầu bàn chải điện P/S - Trắng Răng Tự Nhiên,1429.0,3157231781953,183000,200000,17000,9,197,lam-dep-suc-khoe
114458769,"Máy nâng cơ mặt, Giảm nhăn, Tăng sinh collagen, Công nghệ Nhật Bản 2021 Cổ thiên nga",286.0,4594870875806,950000,950000,0,0,60,lam-dep-suc-khoe
108535251,Bao cao su Sagami 002 - Siêu mỏng - Non Latex - Hộp 6 chiếc,1762.0,2890375808291,218000,300000,82000,27,130,lam-dep-suc-khoe
75946733,Combo Cà phê đắk lắk Tẩy da chết Body cocoon 200ml + Tẩy da chết Mặt cocoon 150ml,53.0,3624195858368,210000,210000,0,0,14,lam-dep-suc-khoe
74935088,Tinh Chất Ngừa Thâm Mụn THE ORDINARY Niaciaminde 10% + Zinc 1%,24.0,4610992474695,235000,235000,0,0,4,lam-dep-suc-khoe
73607516,Sữa Rửa Mặt Dịu Nhẹ Cetaphil Gentle Skin Cleanser 500ml,2048.0,4319777170288,406000,406000,0,0,481,lam-dep-suc-khoe
73276050,Nước Tẩy Trang Bí Đao Cocoon 500ml,425.0,2487760333926,295000,295000,0,0,117,lam-dep-suc-khoe
71672934," Kem Dưỡng Phục Hồi, Làm Dịu Da La Roche Posay Cicaplast Baume B5 (100ml)",480.0,2626027669747,549000,650000,101000,16,133,lam-dep-suc-khoe
53485600,Dầu Gội TSUBAKI Phục Hồi Ngăn Rụng Tóc 490ml,507.0,2679604965237,213000,289000,76000,26,63,lam-dep-suc-khoe
48594251,Essence Chống Nắng Màng Nước Dưỡng Ẩm Biore UV Aqua Rich Watery Essence SPF50+/PA++++ 85G,260.0,7607518413938,259000,259000,0,0,56,lam-dep-suc-khoe
33597680,Son dưỡng môi hiệu chỉnh ửng hồng tự nhiên Lipice Sheer Color,3592.0,8797402994724,69900,81000,11100,14,232,lam-dep-suc-khoe
30157357,Nước bí đao cân bằng da (Winter melon toner) Cocoon 140ml,413.0,2796249087343,195000,195000,0,0,118,lam-dep-suc-khoe
13325863,Sữa chống nắng nâng tông Skin Aqua Tone up Lavender cho da tối màu & da vàng Sunplay Skin Aqua Tone Up UV Milk Lavender SPF 50+ PA++++ 50g,12008.0,9302965055936,159000,199000,40000,20,789,lam-dep-suc-khoe
12478881,"Dầu Gội hỗ trợ điều trị Gàu Mảng, Vảy Nến Ducray Kertyol P.S.O Shampoo (125ml)",927.0,2109279882473,350000,350000,0,0,87,lam-dep-suc-khoe
12053893,"Lăn Khử Mùi Etiaxil Détranspirant Traitement Aisselles Peaux Sensibles 15ml (Dành cho da hỗn hợp, da nhạy cảm)",3942.0,9968340521221,218000,218000,0,0,469,lam-dep-suc-khoe
10099734,Tinh Dầu Massage Dưỡng Ẩm Toàn Thân Từ Olive Dalan D’Olive Reparative Body Oil 200ml,616.0,9944187698081,179000,300000,121000,40,86,lam-dep-suc-khoe
5522507,Nước tẩy trang sạch thoáng Senka A.L.L.Clear Water Fresh 230ml,23090.0,6542553720393,95900,150000,54100,36,180,lam-dep-suc-khoe
4485287,"Vớ y khoa gối Hỗ Trợ Điều Trị suy giãn tĩnh mạch chân JOBST Relief chuẩn áp lực 20-30mmHg (màu da, hở ngón) (tất y khoa)",717.0,8050461584795,650000,750000,100000,13,136,lam-dep-suc-khoe
1313885,"Kem chống nắng Skin Aqua dưỡng trắng, kiểm dầu, dùng hàng ngày dạng sữa Sunplay Skin Aqua Clear White Eco Việt Nam SPF50, PA++++ 25g",38175.0,2763978377755,105000,130000,25000,19,496,lam-dep-suc-khoe
631498,Kem dưỡng cải thiện lão hóa Hada Labo Pro-Aging Retinol B3 Cream 50g,7104.0,3451054668291,250000,295000,45000,15,620,lam-dep-suc-khoe
525572,Sữa Tắm Nước Hoa Enchanteur Romantic 650g,3487.0,9205783781714,121000,222000,101000,45,8,lam-dep-suc-khoe
385568,Bao cao su Durex Fetherlite Hộp 3 Bao,956.0,1329585482032,59000,67000,8000,12,146,lam-dep-suc-khoe
385469,Bao cao su Durex Fetherlite Ultima Hộp 3 bao,5336.0,1320071228080,64000,120000,56000,47,164,lam-dep-suc-khoe
277544216,"Viên sủi chuyển hoá chất béo Balporo BBae Hàn Quốc, hỗ trợ giảm cân, dưỡng da sáng mịn, phân phối độc quyền bởi BBae Lab",14.0,6717848198913,336000,499000,163000,33,10,lam-dep-suc-khoe
276131589,Combo Khăn Ướt Cồn LET-GREEN Diệt Khuẩn 50 Miếng/Bao,199.0,9194683968235,36000,36000,0,0,26,lam-dep-suc-khoe
275970825,Dầu gội bưởi Cocoon giúp giảm gãy rụng và làm mềm tóc 500ml,1856.0,8040796544175,394000,395000,1000,0,5,lam-dep-suc-khoe
274169579,Tẩy Tế Bào Chết Da Đầu Aromatica Chiết Xuất Hương Thảo 165ml,22.0,1861428246955,290000,468000,178000,38,4,lam-dep-suc-khoe
273962326,[100 Cái 6D ] Thùng Khẩu Trang Y Tế Kháng Khuẩn 6D An Tâm - 10 Túi/100 Cái.,433.0,3257162141374,82000,95000,13000,14,37,lam-dep-suc-khoe
273424624,"Nước nhỏ mắt dưỡng ẩm ẩm, giảm khô mắt chuyên sâu Rohto Dry Aid 10ml",72.0,6238945896539,97900,115000,17100,15,5,lam-dep-suc-khoe
273250656,CHÌ KẺ CHÂN MÀY INNISFREE AUTO EYEBROW PENCIL 0.3G,296.0,2653386741435,101000,109000,8000,7,21,lam-dep-suc-khoe
272195229,Kem Dưỡng Ban Đêm Olay Regenerist Retinol24 Tái Tạo Da Night Moisturiser 50g,35.0,9772549623831,399000,549000,150000,27,6,lam-dep-suc-khoe
270977248,Sữa Tắm Lifebuoy Matcha & Khổ Qua Detox Da Khỏi Vi Khuẩn Gây Mụn 800g,113.0,3271163849449,159000,214000,55000,26,9,lam-dep-suc-khoe
270688221,Nước nhỏ mắt giữ ẩm & bổ sung khoáng chất V.Rohto Mineral Tear 13ml,847.0,8091172372475,57100,64000,6900,11,22,lam-dep-suc-khoe
269895644,Nước Súc Miệng Listerine Gum Care Giúp Nướu Chắc Khỏe Vị Gừng Thảo Mộc 750ml,188.0,4707957708746,169000,169000,0,0,7,lam-dep-suc-khoe
263108710,Dưỡng Chất Chống Nắng L'Oreal Paris Uv Defender Serum Protector Invisible Fluid 50ml,5.0,2563038424863,225000,225000,0,0,1,lam-dep-suc-khoe
253188398,"Hộp 50 que thử đường huyết On Call Plus, mỗi hộp 2 lọ 25 que thử chính hãng ACON",48.0,8903330073687,156000,295000,139000,47,2,lam-dep-suc-khoe
247998045,Sữa tắm hương hoa sen Tesori D’ Oriente Lotus Flower 500ml,1070.0,9520837955685,255000,255000,0,0,233,lam-dep-suc-khoe
197960229,Perspirex for Men Maximum - Lăn khử mùi và ngăn tiết mồ hôi loại mạnh,344.0,3190370353363,330000,330000,0,0,48,lam-dep-suc-khoe
184518312,"Collagen HeiHwa Dạng nước 1.500mg Collagen Tripeptide nhập khẩu từ Hàn Quốc, hấp thu nhanh giúp đẹp - Hộp 5 chai 30ML",65.0,5991824731580,450000,450000,0,0,6,lam-dep-suc-khoe
179717789,Miếng dán mụn giúp giảm mụn sưng viêm Acnes Clear Patch (48 Miếng),527.0,9379932318825,105000,105000,0,0,34,lam-dep-suc-khoe
155622131,Khẩu trang Unicharm Nhật 3D mask 3 lớp hộp 100 cái,94.0,8194236361414,259000,259000,0,0,10,lam-dep-suc-khoe
136666870,Dầu Gội PANTENE Chai 650ml/900ml/1.2L/1.8L,2340.0,2482963473832,207000,225000,18000,8,29,lam-dep-suc-khoe
132081941,Mặt Nạ Ngủ Dưỡng Ẩm Và Tăng Khả Năng Tự Vệ Của Da Phiên Bản Cải Tiến LANEIGE Water Sleeping Mask EX,2148.0,9672582374878,300000,310000,10000,3,231,lam-dep-suc-khoe
123929183,"[Đo nhanh , Chính Xác Trong 1 Giây] Nhiệt kế hồng ngoại đo trán Microlife FR1MF1 - Thương Hiệu Thụy Sĩ ",341.0,5436833026185,788000,788000,0,0,57,lam-dep-suc-khoe
105821846,"Tinh Dầu Treo Xe Homer 7ML - Khử Mùi Xe Hơi, Treo Thơm Phòng, Treo Tủ - Tinh dầu treo Sả chanh/ Bạc Hà/ Quế",1805.0,5439340267338,190000,190000,0,0,144,lam-dep-suc-khoe
88206705,Dầu gội hà thủ ô ngăn ngừa tóc bạc sớm Thorakao 400ml,207.0,3106550993864,94000,94000,0,0,21,lam-dep-suc-khoe
74974343,Đai Gối Hơi Đỡ Cổ Massage Hỗ Trợ Điều Trị Kéo Dãn Đốt Sống Cổ KUNBE ( Bóng Kim Loại ),51.0,1604603680660,165000,165000,0,0,9,lam-dep-suc-khoe
70661243,Gel rửa mặt tạo bọt làm sạch & giảm nhờn cho da dầu nhạy cảm La Roche-Posay Effaclar Purifying Foaming Gel (400ml),180.0,3863294215669,449000,535000,86000,16,33,lam-dep-suc-khoe
66786807,Trunature Ginkgo Biloba 340 Viên hàng Mỹ - Mẫu 2020,320.0,4781333990973,480000,480000,0,0,57,lam-dep-suc-khoe
60684152,"Dầu Gội Hà Thủ Ô 2in1 Dành Riêng Cho TÓC BẠC Và RỤNG TÓC Cocayhoala Chai Lớn 450g Tiết Kiệm Hơn 1,5 lần",44.0,1850367368492,219000,219000,0,0,9,lam-dep-suc-khoe
52639277,[Combo 3 Tặng 1 Cho Độ Tuổi Từ 5-20] TPBVSK hỗ trợ Tăng Chiều Cao NuBest Tall,469.0,1017110554193,3270000,3270000,0,0,130,lam-dep-suc-khoe
50699261,Nước tẩy trang Công Nghệ Micella Bioderma Sebium H2O - 500ml,2122.0,9310119220857,429000,525000,96000,18,482,lam-dep-suc-khoe
49217739,Kem dánh răng crest 3D white 158g,608.0,3897359868637,130000,130000,0,0,90,lam-dep-suc-khoe
25074713,Phấn phủ kiềm dầu dạng bột innisfree No Sebum Mineral Powder 5g,10629.0,2229024331138,130000,180000,50000,28,1127,lam-dep-suc-khoe
17483106,[Chai 100ml] Dầu nóng Hàn Quốc xoa bóp massage Antiphlamine,142.0,3570731959764,115000,115000,0,0,5,lam-dep-suc-khoe
10298023,Saffron nhụy hoa nghệ tây Kingdom Herb Iran chính hãng loại thượng hạng hộp 1 gram,3678.0,8316144550762,298000,519000,221000,43,690,lam-dep-suc-khoe
7777247,Mặt Nạ Tóc Cao Cấp Phục Hồi Hư Tổn TSUBAKI (180g),8777.0,2366077487020,222000,350000,128000,37,91,lam-dep-suc-khoe
2984005,Dầu Gội Xả Hoa Bưởi Thorakao (400ml),693.0,4726910784644,69000,69000,0,0,80,lam-dep-suc-khoe
1600039,Combo 6 Băng Vệ Sinh Diana Siêu Thấm Siêu Mỏng 0.1 (Gói 8 Miếng),1220.0,4979964479213,106000,144000,38000,26,99,lam-dep-suc-khoe
1313903,Dung dịch dưỡng trắng da chống thâm nám Melano CC Whitening Lotion 170ml,1545.0,9893529726602,206000,300000,94000,31,162,lam-dep-suc-khoe
472708,Dầu Tắm Gội 2 Trong 1 Dành Cho Nam Romano Classic (650g),43291.0,9206255043255,153000,209000,56000,27,14,lam-dep-suc-khoe
409945,Thực Phẩm Chức Năng Viên Uống Sữa Ong Chúa Costar Royal Jelly 1450mg - Hộp 365 Viên,54.0,1322834293359,556000,556000,0,0,14,lam-dep-suc-khoe
389598,Bao Cao Su Sagami Original 0.02 - Hộp 12 Gói,26.0,1325367805761,415000,415000,0,0,0,lam-dep-suc-khoe
275030214,Găng Tay Y Tế Size M Không Bột Nitrile Màu Đen TTGLOVES (100 chiếc),114.0,9926609466399,85000,85000,0,0,5,lam-dep-suc-khoe
274095477,The Collagen Shiseido Dạng Nước Dễ Hấp Thụ (Hộp 10 Chai) - Hỗ Trợ Đẹp Da - Nhập Khẩu Chính Ngạch Có Tem Phụ Tiếng Việt,8.0,9644461812211,499000,499000,0,0,0,lam-dep-suc-khoe
273455549,Lăn Ngăn Mùi NIVEA Fresh Energy Tươi Mát Sức Sống (50ml) - 83754,43664.0,5146845958700,70000,79000,9000,11,1,lam-dep-suc-khoe
271448069,Dầu Gội Head&Shoulders Bạc Hà Mát Lạnh Chai 1200ml ,62.0,3780759085791,326000,326000,0,0,11,lam-dep-suc-khoe
270977246,Sữa Tắm Lifebuoy Bảo Vệ Khỏi Vi Khuẩn Cica & Muối Hồng 800g,65.0,5169401912315,174000,234000,60000,26,8,lam-dep-suc-khoe
270105685,"Bao cao su Feelex Bigdot Gân Gai Bi lớn nhiều gel bôi trơn, Hộp 1 bcs",604.0,6637575867972,24000,24000,0,0,16,lam-dep-suc-khoe
269984049,Sữa Tắm Johnson's PH 5.5 Hạnh Nhân 750ml,302.0,3330705698096,187000,187000,0,0,19,lam-dep-suc-khoe
263647851,Hộp 144 chiếc_Bao cao su eros dùng gia đình - khách sạn mỏng trơn - nhiều gel bôi trơn - dùng tiết kiệm,14.0,3220929671137,199000,199000,0,0,0,lam-dep-suc-khoe
263108877,Sữa Chống Nắng Cực Mạnh Sunplay Super Block SPF81 70g,29.0,8907939535227,139000,185000,46000,25,2,lam-dep-suc-khoe
263108630,Nước Hoa Hồng Không Mùi Dear Klairs Dưỡng Ẩm Da Và Làm Mềm Da Supple Preparation Unscented 180ml,0.0,7967923957748,255000,399000,144000,36,0,lam-dep-suc-khoe
262875109,Sữa Rửa Mặt Cetaphil Gentle Skin Cleanser 500ml,65.0,1434516492094,378000,414000,36000,9,10,lam-dep-suc-khoe
262048995,[ Mua 10 tặng 2 ] Mặt nạ dưỡng da Dermal tinh chất Q10 23gram,13.0,4159657044572,14000,14000,0,0,0,lam-dep-suc-khoe
260847275,Gel Ngăn Ngừa Sẹo và Làm Giảm Sẹo Lồi/ Sẹo Phì Đại Rejuvasil của Rejuvaskin,1851.0,5760701816742,410000,460000,50000,11,319,lam-dep-suc-khoe
248539375,"Miếng Massage Xung Điện Cổ Vai Gáy, Bắp Tay, Lưng Bằng Sung Điện đỡ đau Nhức Hiệu Qủa -Máy mat sa thân hình 10 Chế Độ - HÀNG CHÍNH HÃNG MINIIN",37.0,5400017076290,79000,79000,0,0,2,lam-dep-suc-khoe
230038805,Tinh chất chống lão hóa 3 hoạt chất Laneige Perfect Renew 3X Signature Serum 40ml,84.0,3838128879460,1760000,1950000,190000,10,9,lam-dep-suc-khoe
203176045,Kem dưỡng cấp ẩm Neutrogena Hydro Boost Hyaluronic Acid Water Gel 50G,81.0,5845384742273,289000,389000,100000,26,9,lam-dep-suc-khoe
198560707,"Bao cao su Feelex 3in1 gân gai, nhiều gel bôi trơn, kéo dài thời gian quan hệ",1988.0,9660188496894,139000,139000,0,0,208,lam-dep-suc-khoe
186253037,"Bao cao su Feelex Superthin siêu mỏng, nhiều gel bôi trơn, hương thơm - Hộp 30bcs",1896.0,3005934526754,209000,209000,0,0,222,lam-dep-suc-khoe
176048170,"Thực phẩm bảo vệ sức khỏe Thảo mộc cải thiện cân nặng Slimming Care X3 ( số 2) hộp 15 viên - dành cho người béo lâu năm, cơ địa chai lì",376.0,2571460226190,395000,395000,0,0,35,lam-dep-suc-khoe
140537792,Sữa rửa mặt Hatomugi hạt ý dĩ,189.0,6688155975881,45000,45000,0,0,49,lam-dep-suc-khoe
108535201,Bao cao su Sagami White box - Có gai - Hộp 10 chiếc,10.0,7745361246645,110000,110000,0,0,0,lam-dep-suc-khoe
108535196,Bao cao su Sagami Superthin - Mỏng - Kiểu truyền thống - Hộp 10 chiếc,14.0,4262918350172,135000,135000,0,0,0,lam-dep-suc-khoe
101947387,"Cho máy Oral B Braun, bộ 4 Đầu Bàn Chải đánh răng điện thay thế MIHOCO EB18-P New   ,  phá tan mảng bám, cho răng trắng sáng",44.0,1947146088294,88000,88000,0,0,11,lam-dep-suc-khoe
89441903,[HỘP - FAMAPRO 4D] - Khẩu trang y tế kháng khuẩn cao cấp Famapro 4D tiêu chuẩn KF94 (10 cái/ hộp),8113.0,7318990164333,49500,49500,0,0,739,lam-dep-suc-khoe
77986600,Kem dưỡng trắng dạng gel giúp cải thiện thâm sạm Melano CC Whitening Gel 100g,0.0,5882228860942,350000,350000,0,0,100,lam-dep-suc-khoe
76184280,Bộ bao da dụng cụ 16 món cắt móng,61.0,7750542588766,81000,81000,0,0,11,lam-dep-suc-khoe
76158697,"Combo 2 Chai xịt tinh dầu bưởi kích mọc tóc, giảm rụng tóc Pomelo Tabaha 120ml cho tóc dày và dài hơn gấp 2 đến 3 lần",889.0,2881003145282,150000,150000,0,0,160,lam-dep-suc-khoe
75345584,Dầu Gội Head&Shoulders Dành Cho Da Đầu Ngứa Chai 1200ml,68.0,7311027043561,306000,326000,20000,6,23,lam-dep-suc-khoe
74547395,Kem Chống Nắng Không Màu Kiểm Soát Dầu La Roche-Posay Anthelios XL Dry Touch Gel-Cream SPF 50+ UVB & UVA (50ml) - TẶNG MÓC KHÓA,102.0,4282705653927,590000,590000,0,0,30,lam-dep-suc-khoe
73341488,Bàn chải kẽ răng loại L 5cái/vỉ nhập khẩu Hàn Quốc,208.0,4425053851700,40000,80000,40000,50,10,lam-dep-suc-khoe
63511644,Cân điện tử bluetooth phân tích chỉ số cơ thể Kachi MK223 - Màu đen - Hàng chính hãng,1285.0,3912864041440,229000,399000,170000,43,270,lam-dep-suc-khoe
53507455,Bộ Đôi TSUBAKI Phục Hồi Ngăn Rụng Tóc (490ml/chai),9126.0,1153050596616,308000,430000,122000,28,147,lam-dep-suc-khoe
51542236,Kem chống nắng dạng xịt dưỡng da bảo vệ hoàn hảo Anessa Perfect UV Sunscreen Skincare Spray SPF 50+ PA++++ 60g,123.0,2468148633838,389000,455000,66000,15,19,lam-dep-suc-khoe
50699284,Nước tẩy trang Công Nghệ Micella Bioderma Sensibio H2O - 500ml,4411.0,9245747571258,429000,525000,96000,18,849,lam-dep-suc-khoe
16180578,Sữa Rửa Mặt Dịu Nhẹ Cho Da Nhạy Cảm Physiogel Daily Moisture Therapy Dermo-Cleanser 150ml,757.0,6742344228804,200000,200000,0,0,105,lam-dep-suc-khoe
8142301,Bấm Móng Kềm Nghĩa B-902,1409.0,9973799401857,52000,52000,0,0,260,lam-dep-suc-khoe
907522,Viên uống bổ mắt Lutein Rohto V5 ( Hộp 30 viên),3420.0,3562077958891,389000,485000,96000,20,447,lam-dep-suc-khoe
638369,Kem Chống Nắng Không Màu Kiểm Soát Dầu La Roche-Posay Anthelios XL Dry Touch Gel-Cream SPF 50+ UVB & UVA (50ml),117.0,3454910402534,335000,335000,0,0,25,lam-dep-suc-khoe
631952,Seum VItamin C 10% dưỡng trắng mờ thâm sạm Acnes Lab C10 serum 15ml,1644.0,3459816283041,336000,365000,29000,8,133,lam-dep-suc-khoe
630778,"Kem chống nắng Skin Aqua dưỡng trắng, kiểm dầu, dùng hàng ngày dạng sữa Sunplay Skin Aqua Clear White Eco Việt Nam SPF50, PA++++ 55g",39456.0,3444163701492,188000,227000,39000,17,502,lam-dep-suc-khoe
276823440,Dầu gội Romano hương nước hoa Grandiose 650ml,533.0,8478409646358,145000,209000,64000,31,2,lam-dep-suc-khoe
276284205,"Nước hoa hồng Evoluderm se khít lỗ chân lông, dưỡng ẩm & làm sạch 250ml",25.0,5151058513881,93100,195000,101900,52,1,lam-dep-suc-khoe
275588395,Tẩy Tế Bào Chết Rosette Dưỡng Sáng Da Gommage Bright Peel 180G,16.0,3176641449141,185000,185000,0,0,2,lam-dep-suc-khoe
275141143,Găng Tay Y Tế Size L Không Bột Nitrile TTGLOVES Màu Trắng (100 Chiếc),29.0,5571142459040,95000,95000,0,0,3,lam-dep-suc-khoe
274746094,"[UV MASK] Khẩu trang y tế 5 lớp UV Famapro chống nắng hiệu quả với form rộng hơn,che chắn tốt hơn",39.0,6563051221026,79000,79000,0,0,3,lam-dep-suc-khoe
274496443,Bộ dụng cụ lấy ráy tai - móc ráy tai Thanh Sơn 8 món kèm hộp nhựa,39.0,2962361818481,49000,49000,0,0,2,lam-dep-suc-khoe
273531931,  Combo 4 băng vệ sinh Kotex đêm dạng quần cỡ M/L (2 miếng/Gói),200.0,6175931577306,99000,140000,41000,29,13,lam-dep-suc-khoe
271956453,Sữa Tắm Trắng Da Hoa Trà Weilaiya Niacinamide Shower Gel - Hương nước hoa ngọt ngào 450ml,13.0,3014011175034,350000,350000,0,0,0,lam-dep-suc-khoe
270846005,Canxi 600mg và Vitamin D3 Kirkland cho xương và răng - QuaTangMe Extaste,1205.0,7529772222860,599000,599000,0,0,172,lam-dep-suc-khoe
263079919,[Full series] Kem đánh răng Marvis Fluoride Toothpaste Cao Cấp Italy 85ml - Hàng chính hãng,270.0,7711276067662,185000,185000,0,0,15,lam-dep-suc-khoe
253242116,"Hộp 50 Que Thử Đường Huyết Sinocare Safe-Accu Kèm 50 Kim Chích Máu, Chuẩn Chính Hãng, Date Dài",36.0,7492525776444,78900,99000,20100,20,6,lam-dep-suc-khoe
215910941,"Thùng khẩu trang 5d SHB pro mask nguyên thùng, 5d mask hàn quốc cao cấp",90.0,7791939363749,43900,77900,34000,44,12,lam-dep-suc-khoe
206906133,"Bao cao su Feelex Performance siêu mỏng, kéo dài thời gian quan hệ - Hộp 10 bcs",1064.0,6856671750921,139000,139000,0,0,46,lam-dep-suc-khoe
203214625,Đầu bàn chải thay thế bàn chải điện P/S S100 PRO (Set 2 cái) - Hàng chính hãng,204.0,4292928034249,159000,250000,91000,36,20,lam-dep-suc-khoe
198324072,Dầu gội Matrix gội là đen - gội là nâu,70.0,6134248716620,27000,27000,0,0,3,lam-dep-suc-khoe
195332327,"Cân Sức Khỏe Điện Tử Omron HN-289 Cảm Biến Thông Minh, Mặt Kính Cường Lực Chịu Tải Trọng Tốt",7.0,5475249252982,595000,1050000,455000,43,1,lam-dep-suc-khoe
194946999,"Nhíp Lấy Ráy Tai Chuyên Dụng Có Đèn, Hộp Đựng ( Tặng Kèm Pin) - Chính Hãng GROFA",41.0,9464332476900,69000,69000,0,0,1,lam-dep-suc-khoe
170491702,[VIDEO]-Bộ dụng cụ ráy tai/ ngoáy tai cao cấp 6 món kèm bao da kiêm móc khóa- CHỌN MẪU- Dụng cụ ráy tai thông minh cho người lớn và trẻ em,211.0,3843582076718,39000,39000,0,0,33,lam-dep-suc-khoe
137020448,"Hộp 25 Que Thử Đường Huyết Accu-Chek Guide Date Xa, NK Chính Ngạch, Tem Niêm Phong, Tem Phụ TV",224.0,6126932271486,269000,299000,30000,10,23,lam-dep-suc-khoe
125722009,Combo bếp đốt thảo mộc bồ kết + 500gr sả + 10 viên nến,25.0,6157474985156,125000,125000,0,0,6,lam-dep-suc-khoe
106032438,Tinh chất giảm thâm nám & dưỡng sáng Eucerin Spotless Brightening Booster Serum 30ml,27.0,7323569681495,1021000,1459000,438000,30,3,lam-dep-suc-khoe
105621214,Bộ Bao Cao Su Durex Kingtex 3 Hộp 12 Bao,1714.0,7548218239188,340000,555000,215000,39,268,lam-dep-suc-khoe
100265407,Cao Gừng Nghệ Đỏ Thanh Lăn Tan Mỡ 180ml,40.0,4593805597035,180000,180000,0,0,8,lam-dep-suc-khoe
90683425,Bao Cao Su Durex Jeans,4310.0,9201345828533,40000,50000,10000,20,654,lam-dep-suc-khoe
83319137,Bộ 3 bàn chải Colgate chăm sóc nướu ( màu ngẫu nhiên ),44.0,2627761638749,42100,54000,11900,22,2,lam-dep-suc-khoe
52280564,"Kem chống nắng nâng tông Skin Aqua Tone up Mint Green cho da trắng có khuyết điểm đỏ, dạng sữa Sunplay Skin Aqua Tone Up UV Milk Mint Green SPF 50+ PA++++ 50g",4922.0,4593951262420,173000,199000,26000,13,705,lam-dep-suc-khoe
48290415,Kem chống nắng Skin1004 Madagascar Centella Air-fit Suncream Plus 50ml,88.0,5492813487010,229000,320000,91000,28,15,lam-dep-suc-khoe
45371117,Sữa Rửa Mặt ST Beauty Làm Sạch Da Chuyên Sâu - Giúp Thải Độc Tố Hiệu Quả ,118.0,1933523452782,139000,139000,0,0,22,lam-dep-suc-khoe
45319677,Bao cao su Durex Sensual Strawberry hộp 3 bao,3079.0,3582880477945,44000,52000,8000,15,429,lam-dep-suc-khoe
35921478,"Túi Chườm Nóng Lạnh Giảm Đau, Hạ Sốt( Giao Màu Ngẫu Nhiên)",27.0,8650009787024,29900,50000,20100,40,3,lam-dep-suc-khoe
24752546,Sáp Dưỡng Ẩm Vaseline 100% Pure Petroleum Jelly 368g,516.0,8438683132374,145000,145000,0,0,100,lam-dep-suc-khoe
15456663,"Titan Gel phiên bản Gold giới hạn giúp tăng kích thước, kéo dài thời gian, tăng ham muốn cho nam giới (hàng chuẩn Nga)",360.0,5457541102703,290000,290000,0,0,31,lam-dep-suc-khoe
7965804,Bao cao su Sagami Miracle fit hộp 10 cái,67.0,1810694230619,73900,99000,25100,25,2,lam-dep-suc-khoe
3074967,Dầu Gội Bồ Kết Thorakao (750ml),564.0,1947629289067,54000,54000,0,0,54,lam-dep-suc-khoe
2579159,Máy đo huyết áp tự động bắp tay Omron JPN600,356.0,1115110576204,1835000,2105000,270000,13,112,lam-dep-suc-khoe
1529993,Xịt Khử Mùi Dưỡng Trắng Hương Nước Hoa Refre Whitening Sweetie Hương Ngọt Ngào (30ml),918.0,1163374914768,57800,65000,7200,11,107,lam-dep-suc-khoe
1313897,Lotion dưỡng ẩm cao cấp - Siêu cấp ẩm cho da căng mượt Hada Labo Gokujyun Premium Hydrating Lotion (170ml),2570.0,9090592587349,256000,320000,64000,20,384,lam-dep-suc-khoe
1081764,Dầu tẩy trang dưỡng ẩm Hada Labo Advanced Nourish Hyaluron Cleasing Oil 200ml,3461.0,3573495314558,226000,266000,40000,15,284,lam-dep-suc-khoe
631519,Serum chấm mụn chuyên biệt cho da mụn ở tuổi trưởng thành Acnes 25+ Facial Serum 20ml,2528.0,3455346676292,105000,115000,10000,9,258,lam-dep-suc-khoe
284446,Thuốc nhuộm dưỡng tóc phủ bạc thảo dược Bigen Nhập Khẩu 100% Nhật Bản Speedy Color Cream 80ml dạng kem ,3488.0,1331677168700,246000,266000,20000,8,430,lam-dep-suc-khoe
277605022,"Cân Điện Tử Bluetooth Thông Minh Đo Lượng Mỡ Và Nước Trong Cơ Thể, Tính Chỉ Số BMI Trọng Tải 180kg Giao Màu Ngẫu Nhiên",2.0,7287347321472,84000,99000,15000,15,0,lam-dep-suc-khoe
276252266,[MUA 1 TẶNG 1]Bodymist Nam Nữ Toàn Thân Lưu Hương 6 Giờ - Nước Hoa Hẹn Hò BODYMISS 105ml (Chai),30.0,2990811100776,129000,129000,0,0,5,lam-dep-suc-khoe
274411196,[100 Cái 5D] Thùng Khẩu Trang Y Tế Kháng Khuẩn 5D An Tâm -100 Cái/10 Túi.,108.0,8908797260877,58000,80000,22000,28,9,lam-dep-suc-khoe
273786732,Dầu Gội OGX Thick & Full Bổ Sung Biotin Collagen Cho Tóc 385ml,34.0,4607270956862,207000,295000,88000,30,6,lam-dep-suc-khoe
263108966,Kem Chống Nắng Nâng Tông Senka Perfect UV Essence SPF50+ PA++++ 50g,48.0,4526391873710,145000,209000,64000,31,6,lam-dep-suc-khoe
263108584,Kem Dưỡng Cấp Ẩm Senka Deep Moist Gel Cream Chuyên Sâu Dạng Gel 50g,116.0,2164987319045,209000,209000,0,0,3,lam-dep-suc-khoe
263080011,[Chính hãng] Kem đánh răng Marvis Toothpaste tuýp 25ml Italy 7 hương vị classic,25.0,1137697441164,59000,59000,0,0,4,lam-dep-suc-khoe
262393225,"Khẩu Trang Cao Cấp Perfetta Pinnakle, Form 3D thời trang, 3 Lớp Kháng Khuẩn, Quai Đeo Thun Bông, Lớp Trong Mềm Mịn (30 cái/hộp)",112.0,5782173406893,88159,88159,0,0,6,lam-dep-suc-khoe
253313765,Kem Dưỡng Thể Trắng Da Chống Nắng Ban Ngày Pretty Skin Body Glutathione V10 Alpha Arbutin Body Lotion 250ml tặng móc khóa,5.0,7046474983771,325000,325000,0,0,0,lam-dep-suc-khoe
248684056,Giấy thấm dầu trà xanh Acnes Oil Remover Paper Green Tea 100 tờ,6858.0,1134931325138,37900,40000,2100,5,9,lam-dep-suc-khoe
247287157,Kem dưỡng trắng dạng gel Hada Labo Perfect White Tranexamic Acid Cream 50g,963.0,9636042008973,216000,270000,54000,20,23,lam-dep-suc-khoe
213926146,Nước Súc Miệng Hỗ Trợ Giảm Hôi Nhiệt Miệng Ngừa Sâu Răng Hiệu Quả Dùng Được Cho Người Lớn Và Trẻ Nhỏ Cỏ Mềm 500ml,17.0,9029312229971,120000,120000,0,0,0,lam-dep-suc-khoe
207753056,Phim Thấm Dầu Acnes Oil Remover Film 100 Tờ,981.0,5977348970251,110000,110000,0,0,3,lam-dep-suc-khoe
204771516,Tăm chỉ nha khoa Okamura (90 cây/gói),33.0,6926253370936,42000,42000,0,0,3,lam-dep-suc-khoe
202702736,Bộ Đầu Bàn Chải Điện Halio Sonic Whitening Electric Toothbrush,126.0,6650920514175,285000,400000,115000,29,14,lam-dep-suc-khoe
198058535,"Đai lưng cột sống Genky, hỗ trợ thoát vị, thoái hóa, đau lưng",501.0,4783937401982,300000,300000,0,0,70,lam-dep-suc-khoe
196338826,Tinh Dầu Hoa Anh Thảo Hỗ Trợ Cân Bằng Nội Tiết Tố Blackmores Evening Primrose Oil Lọ 190 Viên,23.0,7548668935070,873000,969000,96000,10,4,lam-dep-suc-khoe
185591382,Hộp mặt nạ dưỡng trắng chuyên sâu Hada Labo Premium Whitening Serum Mask 115g (hộp 5 miếng x 23g/ miếng),189.0,2412448794981,171000,220000,49000,22,18,lam-dep-suc-khoe
162844540,Cao Nám Insam DR CELL 20g,17.0,5063603645203,950000,950000,0,0,3,lam-dep-suc-khoe
162196352,Kem Dưỡng Ẩm Dành Cho Da Dầu Và Da Hỗn Hợp Laneige Water Bank Blue HA Cream Oily 50ml,368.0,1230203643017,980000,1100000,120000,11,79,lam-dep-suc-khoe
159887721,Tinh chất dưỡng trắng da Lá House Astalock Concentrated Essence 15ml/30ml,160.0,4361318353900,945000,945000,0,0,17,lam-dep-suc-khoe
140537772,(Hàng Chính Hãng) Dầu gội phủ bạc Komi Nhật(có tem chống giả),177.0,3273589244099,650000,650000,0,0,22,lam-dep-suc-khoe
115129321,"SỮA DƯỠNG THỂ CHỐNG NẮNG, DƯỠNG ẨM VÀ LÀM SÁNG DA HATOMUGI SPF50+ PA++++ ",38.0,4458302481984,99000,99000,0,0,10,lam-dep-suc-khoe
111223249,"Khăn Lau SÁT KHUẨN BỀ MẶT SARAYA SARACIDE SANITIZING WIPES - Hộp 80 cái (Sử dụng trong Y TẾ và SINH HOẠT hằng ngày, Phân loại TTBYT: 421/190000031/PCBPL-BYT)",14.0,5621192535915,216000,216000,0,0,1,lam-dep-suc-khoe
102751945,Dầu gội Head&shoulders Clinical Strength Proven Relief 400ml - USA,267.0,4548140203001,409000,409000,0,0,36,lam-dep-suc-khoe
75336610,Máy massage mặt – Máy massage mặt đa năng 5 IN 1 - Máy điện di tinh chất - Máy đẩy tinh chất - MASSAGE MẶT + LÀM SẠCH + TRẺ HÓA – Pin 1200mA - Chăm sóc da mặt đa năng- HDSD Tiếng Việt,115.0,2024923908708,494000,494000,0,0,24,lam-dep-suc-khoe
68491719,"Dầu xả ngăn rụng tóc, dưỡng tóc 50 Megumi Hair Fall Control Conditioner",1793.0,6652612817220,99000,250000,151000,60,53,lam-dep-suc-khoe
59242883,"Kem Dưỡng Ẩm Philo Soft Moist 24 Cấp Ẩm Dành Cho Các Loại Da Khô, Vảy Nến, Làm Mịn Da 100g",28.0,2909084458029,200000,200000,0,0,1,lam-dep-suc-khoe
48579668,"Bao cao su Sagami Original 0.02 cao cấp, siêu mỏng (Hộp 12 chiếc)",62.0,5360531303571,412000,412000,0,0,1,lam-dep-suc-khoe
45150752,Xịt mũi viêm xoang thảo dược Rohto Nosewash 35ml,1317.0,7360666575223,54900,58000,3100,5,103,lam-dep-suc-khoe
37545731,Bột Khử Mùi Wings-Up Khử Mùi Hôi Chân Hôi Nách Ngăn Tiết Mồ Hôi Hôi Khử Mùi Giày Không Mùi An Toàn Từ Thiên Nhiên Cỏ Mềm 25g,1762.0,6583276215124,115000,115000,0,0,270,lam-dep-suc-khoe
35031098,"Son thỏi dưỡng môi trang điểm, cho môi căng mọng Lip On Lip Water Color",2273.0,6984275757798,110000,138000,28000,20,277,lam-dep-suc-khoe
33761260,Bao Cao Su Kéo Dài Thời Gian Quan Hệ và Có Gai Innova Đen - Hộp 3 Cái,3553.0,3592781323708,39000,39000,0,0,230,lam-dep-suc-khoe
23257530,NƯỚC SÚC MIỆNG KIN GINGIVAL NGĂN NGỪA VIÊM NƯỚU 250ML,1840.0,9173288966090,138000,138000,0,0,199,lam-dep-suc-khoe
13447578,Bộ 10 Mặt Nạ Dưỡng Da Hồng Sâm 3W Clinic (23 ml/miếng),10.0,4724538356601,55000,55000,0,0,0,lam-dep-suc-khoe
8142305,Bấm Móng Kềm Nghĩa B-904,58.0,8553111371917,58000,58000,0,0,5,lam-dep-suc-khoe
6493141,Xịt thơm miệng Beauty Formulas Fresher Breath Spray 15ml - hương bạc hà ​​​​​​​,10.0,5649152719658,62000,62000,0,0,0,lam-dep-suc-khoe
4424813,Thực Phẩm Chức Năng Tảo Xoắn Spirulina Nhật Bản Hộp 2200 Viên,453.0,7803237458131,324000,324000,0,0,60,lam-dep-suc-khoe
568830,Sữa Rửa Mặt Tạo Bọt Chiết Xuất Tơ Tằm Trắng Senka Perfect Whip 120g - 14839,20250.0,1333982668142,97900,108900,11000,10,568,lam-dep-suc-khoe
568659,Mặt Nạ Ngủ Cho Môi Laneige Lip Sleeping Mask Berry 8g,23189.0,1339434882487,209000,220000,11000,5,2510,lam-dep-suc-khoe
270483515,"Bộ 2 Gương cầu lồi ô tô Hàng Xuất Khẩu Mỹ, tráng bạc dày công nghệ gương Bỉ TÂM LUÂN Chổi lau tẩm dầu - Hàng chính hãng",1169.0,3517221016485,85000,100000,15000,15,225,o-to-xe-may-xe-dap
269901175,"Dây cáp kéo xe ô tô, dây kéo cứu hộ xe ô tô thép chuyên dụng chắc chắn trọng tải 5 tấn, 7 tấn, phụ kiện xe hơi Tâm Luân",13.0,5129301376027,179000,250000,71000,28,2,o-to-xe-may-xe-dap
153938489,Bộ ốp gương chiếu hậu cho Toyota Corolla Cross vân Carbon cap cấp,1.0,4651528851231,378000,378000,0,0,0,o-to-xe-may-xe-dap
276236726,"Cáp cứu hộ, dây kéo xe hơi chất liêu vải dù, dây cáp kéo xe ô tô dài 4 mét, dây kéo cứu hộ xe 5 tấn",3.0,9696230592108,139000,200000,61000,31,0,o-to-xe-may-xe-dap
260939338,"Gối tựa đầu xe ô tô cao su non, gối tựa lưng ô tô cao cấp kê cổ tựa lưng ghế ô tô, massage vai gáy phụ kiện xe hơi Tâm Luân",207.0,1739749748644,181000,300000,119000,40,34,o-to-xe-may-xe-dap
277037423,"Bút xóa vết xước ô tô xe máy xe điện, Bút xoá vết trầy xước dăm cho ô tô xe máy xe điện",33.0,8243203107985,21000,21000,0,0,3,o-to-xe-may-xe-dap
276963234,Ô Che Nắng Bên Trong Kính Lái Ô Tô - Dù Che Nắng Ô Tô Kính Lái Bảo Vệ Nội Thất Bên Trong Chống Bạc Màu- Hàng Chính Hãng,9.0,8224043188992,127330,196000,68670,35,1,o-to-xe-may-xe-dap
276152436,Xe máy điện VinFast EVO 200,42.0,9873901281688,25900000,25900000,0,0,12,o-to-xe-may-xe-dap
276031340,"Chai Xịt Tẩy Rỉ Sét WD-40 Multi-Use Product Dầu Chống Rỉ Bôi Trơn, Chống Ẩm, Vệ Sinh Làm Sạch Đa Năng Bảo Dưỡng Xe, Đồ Dùng Gia Đình - Hàng Chính Hãng",59.0,6607362951300,89000,120000,31000,26,12,o-to-xe-may-xe-dap
275993179,Nước hoa Ô tô Cao Cấp BullSone Grasse Diffuser 105ml - Hàng Chính Hãng - Đa dạng mùi hương 2024,28.0,7112230394556,269000,420000,151000,36,7,o-to-xe-may-xe-dap
182830496,Thảm taplo xe ô tô da carbon Tâm Luân chống nắng và chống nóng không thấm nước (26 dòng xe - đời xe),41.0,4573524834558,199000,300000,101000,34,14,o-to-xe-may-xe-dap
13352486,Bọc vô lăng ô tô da bò thật - dập vân cá sấu nổi bắt mắt - AZ-140 - Màu ghi,24.0,5950891628430,268000,268000,0,0,5,o-to-xe-may-xe-dap
219138799,"Ô che nắng ô tô gấp gọn, tấm che nắng kính lái ô tô xe hơi chống nóng kính trước chống tia cực tím UPF 50+ TÂM LUÂN Chổi lau tẩm dầu - Hàng chính hãng",1306.0,1228420020851,159000,300000,141000,47,260,o-to-xe-may-xe-dap
153938234,Ốp nội thấy trang trí nội thất Honda City 2021 vân Titan,2.0,5361797846428,388000,388000,0,0,1,o-to-xe-may-xe-dap
274805949,Thảm lót cốp xe ô tô Subaru Outback 2015-2017 nhãn hiệu Macsim chất liệu TPV hàng loại 2,0.0,8800554520006,990000,990000,0,0,0,o-to-xe-may-xe-dap
275327375,"Dụng cụ bơm hơi bánh xe đạp chân đa năng mini tiện dụng dùng cho xe đạp, xe máy",13.0,7009514440633,119000,119000,0,0,2,o-to-xe-may-xe-dap
275315533,"Bơm hợp kim nhôm loại đạp chân dùng cho xe đạp, xe máy, ô tô, tặng kèm kim bơm banh",4.0,6393209670210,210000,210000,0,0,0,o-to-xe-may-xe-dap
275230314,Bộ dụng cụ vá lốp khẩn cấp - Vít vá lốp không săm - combo 10 vít vá lốp,42.0,8693165918776,35000,35000,0,0,8,o-to-xe-may-xe-dap
275205820,Bạt trùm xe máy vải dù cao cấp 220cm x 115cm - Hàng chính hãng,44.0,3951316959866,179000,239000,60000,25,7,o-to-xe-may-xe-dap
274597343,"Bơm Hơi Hợp Kim Dùng Chân Cho Xe Máy , Xe Đạp NHONOR - Hàng Chính Hãng ( Tặng Kèm Kim Bơm Banh Và Bơm Thú Hơi ) ",133.0,2893200889137,161840,240000,78160,33,25,o-to-xe-may-xe-dap
274801779,Thảm lót cốp xe ô tô Nissan Terra New 2018 - nay - nhãn hiệu Macsim chất liệu TPV hàng loại 2,0.0,4647830792854,990000,990000,0,0,0,o-to-xe-may-xe-dap
274819242,Thảm lót cốp xe ô tô Hyundai Kona 2018-đến nay nhãn hiệu Macsim chất liệu TPV cao cấp màu đen (DT007-1),0.0,9206882104807,990000,990000,0,0,0,o-to-xe-may-xe-dap
274806114,"Thảm lót cốp xe ô tô HYUNDAI TUCSON 2015+ nhãn hiệu Macsim chất liệu TPV cao cấp màu đen, (093)",0.0,6300501921630,990000,990000,0,0,0,o-to-xe-may-xe-dap
274818851,Thảm lót cốp xe ô tô SĐ Mazda CX30 nhãn hiệu Macsim chất liệu TPE cao cấp màu đen,0.0,1159977984592,1600000,1600000,0,0,0,o-to-xe-may-xe-dap
274686316,Thảm lót sàn xe ô tô KIA K5 2022 - chất liệu TPE thương hiệu Macsim màu đen,0.0,5377813967522,1650000,1650000,0,0,0,o-to-xe-may-xe-dap
274480882,"Túi Đựng Điện Thoại , Đồ Cá Nhân Treo Đầu Xe Máy Nhiều Mẫu GroFa",58.0,2348201378508,121000,121000,0,0,9,o-to-xe-may-xe-dap
274480712,"Túi Treo Đầu Xe Máy, Treo Ghi Đông Chống Giật Mất Điện Thoại, Xem Google Map, Chứa Đồ Tiện Lợi PaKaSa",0.0,1976430520684,226000,226000,0,0,11,o-to-xe-may-xe-dap
273411392,Gạt Mưa Cao Su BOSCH Clear Advantage - Móc Chữ U - Xương Mềm - Đủ Size | Chuyên Dành Cho Xe Châu Á,11.0,3099446750672,144000,144000,0,0,0,o-to-xe-may-xe-dap
254148303,"Miếng Dán Phản Quang Cảnh Báo Ban Đêm Cho Oto, Xe Máy, Xe Đạp",357.0,6483783394613,2850,3000,150,5,6,o-to-xe-may-xe-dap
249029665,Thẻ thu phí tự động VETC - Thẻ thu phí không dừng VETC (Hàng chính hãng),658.0,1890276515307,120000,120000,0,0,49,o-to-xe-may-xe-dap
205188355,"Khóa Đĩa Cao Cấp US ARMY, Khóa Đĩa Xe Máy Hú Báo Động Chống Trộm, Chống Cắt Dành Cho Xe Máy, Xe Điện, Xe Đạp... - HÀNG CHÍNH HÃNG",200.0,4494078441003,226000,498000,272000,55,38,o-to-xe-may-xe-dap
182740851,Túi vải dây rút Royal đựng mũ bảo hiểm dáng balo đeo xinh xắn,60.0,6627981992455,30000,30000,0,0,1,o-to-xe-may-xe-dap
174217849,Nano chống tụ nước kính ô tô senfineco 9945,111.0,5552762631728,200000,200000,0,0,25,o-to-xe-may-xe-dap
167209871,"Tấm che nắng kính lái xe hơi, bạt chắn nắng cách nhiệt cho ô tô - Hàng Chính Hãng",666.0,9257702326072,185250,195000,9750,5,112,o-to-xe-may-xe-dap
166059231,Tem chữ 150 150i dành cho xe Honda Sh 2020-2022,42.0,9383383859440,99000,99000,0,0,8,o-to-xe-may-xe-dap
164458921,"Bọc khóa smartkey dành cho Honda Lead, Airblade, Vision 2022, Vario 160, Winner X Bezen Classic",262.0,8567895195774,59000,59000,0,0,66,o-to-xe-may-xe-dap
162592325,Chốt Cài Dây An Toàn Ô Tô Loại Cao Cấp VIP Cho Các Dòng Xe,32.0,9570540539581,38000,38000,0,0,1,o-to-xe-may-xe-dap
156224243,"Tấm Lưới Đệm Tựa Lưng, Đệm Ghế Ô Tô, Ghế Văn Phòng - Matxa Thư Giãn Cột Sống Chống Mỏi Lưng - Hangf Loại 1 Chính Hãng MINIIN",131.0,5865141409485,59000,59000,0,0,22,o-to-xe-may-xe-dap
155563234,Bơm xe đạp xe máy Kiotool thế hệ mới đồng hồ chính xác nhẹ hơi khỏe,183.0,8720737978171,185000,185000,0,0,54,o-to-xe-may-xe-dap
146241256,"Bọc khóa smartkey dành cho Honda PCX, Sh và Sh mode 2021- 2022",288.0,7599491789907,69000,69000,0,0,73,o-to-xe-may-xe-dap
102387065,Đèn xe đạp thể thao KIOTOOL siêu sáng có còi pin sạc usb led T6 chống nước - Đèn còi xe đạp có 3 chế độ sáng còi to,2263.0,7154070549036,84000,84000,0,0,516,o-to-xe-may-xe-dap
97764143,Chổi lau rửa xe hơi ô tô chuyên dụng có thể rút gọn kéo dài có túi đựng (Xám-Tím-Xanh),25.0,9303747585018,60000,60000,0,0,2,o-to-xe-may-xe-dap
96018406,Phiếu Mua Xe Máy Honda Dũng Tiến Sài Gòn,337.0,1132982699612,20000000,20000000,0,0,94,o-to-xe-may-xe-dap
74858683,Mũ Bảo Hiểm 1/2 Đầu Napoli Haley N120 Nhiều Màu - Freesize 54cm – 58cm,113.0,9595337349119,178000,178000,0,0,23,o-to-xe-may-xe-dap
57983642,Dung Dịch Vệ Sinh Sên / Xích Voltronic IX69-K Chain Cleaner 600ml,149.0,3145856904069,185000,185000,0,0,41,o-to-xe-may-xe-dap
48890249,Thanh Gạt mưa Bosch Clear Advantage - Hàng chính hãng,585.0,5162055978712,168000,280000,112000,40,133,o-to-xe-may-xe-dap
35878236,Nước Rửa Xe Sumo 1000 ml Mới Chai Vuông Rửa Xe Chuyên Dụng Bảo Vệ Màu Sơn Chăm Sóc Xe Ô tô Mô tô Tay Ga Gắn Máy Bóng Loáng Như Mới Chống Gỉ Sét Hàng Việt Nam Chất Lượng Cao,256.0,8259778037066,54900,54900,0,0,51,o-to-xe-may-xe-dap
32970127,Băng keo cường lực 3M 4229P (Đỏ) 24mmx10m,279.0,2886139570120,140000,142000,2000,1,43,o-to-xe-may-xe-dap
3261211,Mũ bảo hiểm nửa đầu GRS A737K,956.0,3471784692465,268800,268800,0,0,155,o-to-xe-may-xe-dap
2923469,Chai xịt vệ sinh tẩy keo băng dính nhựa đường cho ô tô xe máy Getsun 450ml (Trắng),144.0,4520860829390,72000,72000,0,0,19,o-to-xe-may-xe-dap
2250775,Bộ Combo Vệ Sinh Dưỡng Sên Xe Máy Thunder (Giao màu ngẫu nhiên),169.0,1618659478270,119000,119000,0,0,55,o-to-xe-may-xe-dap
1254673,Nước Rửa Kính Xe Ô Tô Đậm Đặc Liqui Moly 1519 (250ml),82.0,7396775626440,159000,159000,0,0,8,o-to-xe-may-xe-dap
1219669,Dung Dịch Chống Bám Nước Trên Kính Xe 3M (200ml),554.0,9024594337053,165000,165000,0,0,79,o-to-xe-may-xe-dap
892527,"Dung Dịch Tẩy Keo, Nhựa Đường 3M 08987 (425 g)",908.0,9727270208097,155000,155000,0,0,137,o-to-xe-may-xe-dap
270677877,"Khăn lau xe ô tô đa năng microfiber xám không để lại bụi vải, không để lại vệt nước, khổ to, không phai màu TÂM LUÂN Chổi lau tẩm dầu - Hàng chính hãng",1125.0,7883058112536,35000,50000,15000,30,89,o-to-xe-may-xe-dap
274762566,"Bạt phủ ô tô xe hơi vải dù oxford cao cấp 3 lớp tráng bạc bền đẹp chống nắng mưa,bạc trùm chùm kín bảo vệ xe oto4,5,7chỗ",10.0,4772043110545,385000,385000,0,0,0,o-to-xe-may-xe-dap
277372263,"Tẩu Sạc Nhanh Xe Ô Tô TÍCH HỢP DÂY Sạc Type C, Lightning 100W | Hiển Thị Thông Số Sạc, Dây Rút Chống Rối, 4in1",10.0,4003218709286,419000,419000,0,0,1,o-to-xe-may-xe-dap
277356567,Bộ Đổi nguồn 220v sang 12v Chân Tẩu 10A-120w - Hàng Nhập Khẩu,7.0,2144480155690,195000,195000,0,0,0,o-to-xe-may-xe-dap
277261282,"Nước hoa ô tô Duke chính hãng nhập khẩu 50ml - 100% chiết xuất từ thiên nhiên chống say xe, khử mùi",5.0,7157019854915,195000,195000,0,0,1,o-to-xe-may-xe-dap
276933040,"Máy Bơm Lốp Xe Chống Ồn 80W Màn Mình Kỹ Thuật Số DELI Có Dây - Bơm Lốp Ô Tô, Xe Máy, Bóng",3.0,1253830343388,359000,646200,287200,44,1,o-to-xe-may-xe-dap
276854528,Chổi Vệ Sinh Rửa Xe Ô Tô - Cây Lau Nhà Đặc Biệt Dạng Ống Lồng Ba Phần | Dụng Cụ Rửa Xe Làm Sạch Bằng Sợi Chenille,29.0,8078215801100,150000,150000,0,0,3,o-to-xe-may-xe-dap
137672159,"Keo dán đa năng Scotch 3M siêu dính, siêu bền, keo trong suốt tính thẩm mỹ cao, keo loãng mau khô, dễ sử dụng AD113",25.0,1857011207324,25000,25000,0,0,8,o-to-xe-may-xe-dap
276626995,Xe Máy Honda Vision 2025 - Phiên Bản Thể Thao,18.0,2358079101829,37364000,37364000,0,0,6,o-to-xe-may-xe-dap
276111745,"Mũ Bảo Hiểm Xe Đạp MTB Điều Chỉnh Cho Nam/Nữ, họa tiết carbon FTTK-01 nhiều màu, chất liệu xốp EPS - Thiết Kế Thể Thao, an toàn, nhẹ, thoáng khí, vành tháo rời cho xe đạp MTB - Mai Lee",11.0,4319330453490,155820,159000,3180,2,2,o-to-xe-may-xe-dap
275975610,Mũ Bảo Hiểm Napoli Nửa Đầu NS [CHÍNH HÃNG] [FREESHIP] - Nón Bảo Hiểm Màu Sơn Nhám 1/2 NS - Đủ Màu,68.0,3189831884402,129900,200000,70100,35,6,o-to-xe-may-xe-dap
275271442,"Dụng cụ bơm hơi bánh xe đạp chân đa năng mini dùng cho xe đạp, xe máy ",15.0,6031828774376,180000,180000,0,0,1,o-to-xe-may-xe-dap
275270832,Xe máy Honda Air Blade 125 Tiêu Chuẩn 2025,24.0,9426678575535,45820000,45820000,0,0,10,o-to-xe-may-xe-dap
275049269,Chân Xoay Kính Gương CNC 360 và kính AB Winner vân Carbon gắn nhiều loại xe máy hàng chất lượng tốt....,27.0,4727915055388,85000,85000,0,0,1,o-to-xe-may-xe-dap
274667535,"Bơm lốp KO DÂY Suitu, bơm ô tô, bơm xe máy, bơm xe đạp Suitu, pin sạc siêu khỏe 6000Mah,- SẠC USB tiện lợi",18.0,9954071125419,465000,465000,0,0,4,o-to-xe-may-xe-dap
273934237,Chổi cọ rửa xe hơi ô tô cầm tay- Hàng chính hãng ,3.0,5671217742993,39000,78000,39000,50,1,o-to-xe-may-xe-dap
259513943,"Nước rửa kính xe ô tô THACO CASF dùng cho xe TOYOTA, MAZDA, KIA - Không cần pha - Tiêu chuẩn Nhật Bản",399.0,3401588112351,55000,55000,0,0,22,o-to-xe-may-xe-dap
252062396,Xe Máy Honda LEAD 125cc 2025 - Phiên Bản Đặc Biệt,87.0,4185031166821,48459000,48459000,0,0,33,o-to-xe-may-xe-dap
195748292,Găng Tay Leo Núi Chống Trượt Naturehike NH21FS035 Mỏng Nhẹ,28.0,7130620438487,160000,160000,0,0,1,o-to-xe-may-xe-dap
193568479,Đèn xe đạp Kiotool thế hệ mới nhiều chế độ sáng chống nước,187.0,8404514106757,125000,125000,0,0,31,o-to-xe-may-xe-dap
187183943,Phiếu Mua Hàng Xe Máy Honda Phát Tiến,757.0,2283548549081,20000000,20000000,0,0,227,o-to-xe-may-xe-dap
186743659,[1 chiếc] Gương Xe Đạp Chiếu Hậu Giá rẻ 8 cm Cho Xe Đạp Thể Thao Địa Hình 360 Độ Giúp Đạp Xe An Toàn Mai Lee,254.0,8976963246691,25683,25683,0,0,27,o-to-xe-may-xe-dap
184987595,[An Toàn] Lót Bọc Chân Chống Xe Máy KhoNCC Hàng Chính Hãng - Cao Su Chống Trầy Nền Nhà - Kèm 2 Dây Rút - Chất Liệu Dày Dặn Bền Đẹp - KK-BCCXM,1111.0,8275119027692,3000,6000,3000,50,67,o-to-xe-may-xe-dap
153960176,"Bọc khóa smartkey dành cho Honda SH, SHmode mode, PCX Bezen Armor",36.0,7107593385375,79000,79000,0,0,13,o-to-xe-may-xe-dap
145148997,"Xịt dưởng đen bóng lốp ô tô, xe máy can 4.5 lít",102.0,2413283829582,178000,178000,0,0,19,o-to-xe-may-xe-dap
109123711,Bạt Phủ Áo Trùm Xe Máy Vải Dù Che Mưa Nắng Thời Tiết Khắc Nghiệt Loại Lớn Cho Dòng Xe Tay Ga - Xe Số Thông Dụng,462.0,9709585690199,137000,220000,83000,38,105,o-to-xe-may-xe-dap
95306035,Xe đạp địa hình Thống Nhất MTB 26-07 (Tặng kèm chắn bùn trước và sau) - Hàng chính hãng,34.0,2378087405370,3750000,3750000,0,0,17,o-to-xe-may-xe-dap
75705805,Combo bảo dưỡng sên Megacools rửa sên 500ML+dưỡng sên 300ml  tặng bàn chải vệ sinh sên,235.0,9189484444294,150000,150000,0,0,91,o-to-xe-may-xe-dap
74448331,Bạt Phủ Áo Trùm Xe Máy Vải Dù Che Mưa Nắng Thời Tiết Khắc Nghiệt Loại Lớn Cho Dòng Xe Tay Ga - Xe Số Thông Dụng - KhoNCC-BatPhuXeMay (Nhiều Màu),1606.0,8843230027452,139000,188000,49000,26,429,o-to-xe-may-xe-dap
63818025,"Chai xịt chống chuột, đuổi chuột chuyên dụng 3M 3M-RRC tặng kèm 1 lá thơm mùi ngẫu nhiên",530.0,7463876387973,175000,175000,0,0,81,o-to-xe-may-xe-dap
58911643,"Combo 2 túi thơm cà phê khử mùi, treo xe hơi (130gram x2 - chọn lựa 3 loại túi)",986.0,6616518363861,64000,64000,0,0,178,o-to-xe-may-xe-dap
55193006,Mũ bảo hiểm 3/4 Bulldog POM đủ màu,62.0,1158143664487,1276000,1276000,0,0,23,o-to-xe-may-xe-dap
55129703,Mũ Bảo hiểm nửa đầu Bulldog Pug đủ màu,66.0,7260113313043,788000,788000,0,0,21,o-to-xe-may-xe-dap
51697825,Lọ Xịt Khử Mùi Nội Thất Ô Tô Hương Cà Phê Hàn Quốc,90.0,6626023166611,63000,63000,0,0,13,o-to-xe-may-xe-dap
50819880,"Bơm xe đạp, xe máy xách tay siêu nhẹ, áp suất 120 PSI, thân hợp kim siêu bền, hỗ trợ cả van Mỹ và van Pháp, bơm được cho tất cả các loại xe đạp bao gồm xe đua, xe địa hình, xe đạp đường trường, thương hiệu Wheel Up - Hàng chính hãng ",2309.0,1883861365827,95000,138000,43000,31,396,o-to-xe-may-xe-dap
14656137,Nhớt Xe Số Motul H-Tech 100 4T 10W40 12x1l Vn (1L),260.0,8393327382280,219000,219000,0,0,52,o-to-xe-may-xe-dap
12633806,Mũ bảo hiểm 3/4 M139,21.0,1871935270528,499000,499000,0,0,7,o-to-xe-may-xe-dap
11781042,Khóa đĩa xe máy zcon,51.0,9756864125656,109000,109000,0,0,13,o-to-xe-may-xe-dap
6866413,Keo dán đa năng siêu dính Scotch-Weld 20g 3M PR100,14.0,1480893130784,133000,133000,0,0,4,o-to-xe-may-xe-dap
277351409,ƯU ĐÃI MŨ BẢO HIỂM HỌA TIẾT NÓN SƠN,5.0,7060731131000,350000,700000,350000,50,0,o-to-xe-may-xe-dap
276452835,"Dây Câu Bình Ắc Quy Lõi Đồng, Cáp sạc khởi động ô tô cứu hộ LOẠI DÀI 4M 2000MAP ",8.0,9795178094353,99000,99000,0,0,0,o-to-xe-may-xe-dap
276316044,"Quây chống chuột - Rào chắn chuột ô tô 4-5-7 chỗ và bán tải loại cao cấp, có lưới inox chống cắn",15.0,1394494339044,890000,890000,0,0,2,o-to-xe-may-xe-dap
276311616,"Bơm xe đạp chân bỏ cốp xe, thiết kế nhỏ gọn vừa cốp xe máy các loại, sử dụng cho xe máy, xe đạp, bóng...",2.0,9913875995193,120000,120000,0,0,0,o-to-xe-may-xe-dap
276308212,"Xe đạp Thống Nhất thể thao GN06-24, 26, 27inch 2.0 - Hàng chính hãng (Phù hợp với người cao từ 1m35 trở lên)",6.0,7474597241681,2550000,2550000,0,0,1,o-to-xe-may-xe-dap
276109996,Xe máy Honda LEAD 2025,5.0,2785274295518,40400000,40400000,0,0,0,o-to-xe-may-xe-dap
276065026,"Bảng Ghi Số Điện Thoại Ô Tô, Thẻ Đỗ Xe Hiển Thị Số Điện Thoại Gắn Taplo Xe Hơi,Ô Tô Tiện Lợi Biển Trên Giúp Người Đi Đường Dễ Dàng Liên Hệ Với Bạn Khi Cần Thiết Hiện",19.0,5090630558250,60000,60000,0,0,2,o-to-xe-may-xe-dap
275361680,"Chổi quét bụi vệ sinh nội thất xe oto làm sạch khe hở điều hòa xe hơi lông mềm mịn, bàn chải cọ mini lau sạch ôtô, máy tính",38.0,3179320197633,45000,45000,0,0,4,o-to-xe-may-xe-dap
275271615,"Bộ Dụng Cụ Sửa Chữa Xe Đạp Cầm Tay, Bộ Lục Giác Đa Năng",25.0,7183046144209,65000,65000,0,0,2,o-to-xe-may-xe-dap
274568109,"Khóa Chữ U Chống Trộm Xe Máy, Xe Đạp Chất Liệu Thép Chống Cắt",54.0,5623490519047,37000,45000,8000,18,1,o-to-xe-may-xe-dap
274408295,Bọc vô lăng ô tô da Nappa cao cấp sang trọng thoáng khí cầm chắc tay thiết kế phù hợp với các loại xe - Hàng Nhập Khẩu,26.0,2011165368781,189000,189000,0,0,9,o-to-xe-may-xe-dap
274362581,"Vỏ Bọc lót yên xe đạp thể thao thoáng khí ESL-01 với bọt biển mềm dày, 1 cỡ size 28x18 cm cho xe đạp địa hình/ xe đạp đua đường trường",12.0,2780254739993,150861,153940,3079,2,1,o-to-xe-may-xe-dap
273304231,Móc treo đồ trên xe ô tô kiêm giá đỡ điện thoại gắn lưng ghế xe hơi - phụ kiện ô tô Tâm Luân,165.0,2539584062537,31000,50000,19000,38,8,o-to-xe-may-xe-dap
253396889,"Sáp Thơm ô tô Cao Cấp - Sáp Cốc Logo Hãng Xe Khử Mùi,Tạo Mùi Thơm Trên Xe ",5.0,4922391893297,139000,139000,0,0,0,o-to-xe-may-xe-dap
242084712,Tấm che nắng kính lái ô tô 3 lớp che nắng giảm nhiệt cho xe ô tô miDoctor,25.0,1235573750948,55000,55000,0,0,2,o-to-xe-may-xe-dap
207642148,"Thiết bị đo áp suất lốp và đo độ mòn gai lốp xe Michelin M2210 - Sạc USB, có đèn led, nhỏ gọn",3.0,5566962170655,599000,599000,0,0,0,o-to-xe-may-xe-dap
205803191,"Khóa Dây Mật Khẩu US ARMY, Khóa Dây Mật Khẩu Mini, Khóa Chống Trộm Xe Đạp, Xe Máy, Khóa Bảo Vệ Mũ Bảo Hiểm, Hành Lý - HÀNG CHÍNH HÃNG",153.0,1274482056798,89000,178000,89000,50,35,o-to-xe-may-xe-dap
198728114,Nón Bảo Hiểm Thể Thao Dành Cho Trẻ Em Fornix M1 - S - Từ 2 Đến 9 Tuổi,11.0,3473827818177,310000,310000,0,0,2,o-to-xe-may-xe-dap
191314279,"Caltex TCP 75ml - phụ gia xăng buồng đốt, kim phun xe máy",28.0,9928497783336,79000,79000,0,0,4,o-to-xe-may-xe-dap
189675472,"Thảm Đỡ Điện Thoại Gắn Taplo Ô Tô,  Thảm Taplo Đa Năng Chống Trượt Kiêm Giá Đỡ Điện Thoại Trên Xe Hơi, Thảm Đặt Taplo Ô Tô",79.0,1767548225469,40000,40000,0,0,12,o-to-xe-may-xe-dap
184080370,"Bơm Xe Đạp , Bơm Xe Máy Nhỏ Gọn Mini KIOTOOL Xách Tay Siêu Nhẹ, Áp Suất 120 PSI Hỗ Trợ Cả Van Mỹ và Van Pháp - Hàng Chính Hãng",356.0,7614144586624,78000,78000,0,0,72,o-to-xe-may-xe-dap
169828262,"BẠT TRÙM / TẤM PHỦ TẤT CẢ CÁC LOẠI XE MÁY KÍCH THƯỚC 220x115cm , LÀM TỪ VẢI DÙ 2 DA CAO CẤP ,BỀN ,ĐẸP , CHỐNG MƯA , NẮNG",24.0,1736114073612,130000,130000,0,0,5,o-to-xe-may-xe-dap
161904013,Dầu nhớt xe máy MOTUL H-TECH 100 4T 10W40 1L,29.0,5636885723905,219000,219000,0,0,7,o-to-xe-may-xe-dap
124992544,Nhớt Tổng Hợp Cho Xe Máy Motul H Tech 100 4T 10W40 Có Chiêt Lẻ,93.0,8441360382873,225000,225000,0,0,21,o-to-xe-may-xe-dap
117598706,"Nước làm mát động cơ xe ô tô (màu xanh) Maxcool Standard 4L, 1L, 0,5 lít",116.0,5697078985795,22000,22000,0,0,19,o-to-xe-may-xe-dap
109580095,Nước rửa kính lái chuyên dụng ô tô [5 Lít],949.0,8796578062667,199000,235000,36000,15,194,o-to-xe-may-xe-dap
108968070,"Xịt dưỡng cao su, gioăng cửa ô tô Silicone Spray Senfineco 9990",64.0,8081492196458,210000,210000,0,0,9,o-to-xe-may-xe-dap
95730662,"Bộ 2 gương cầu lồi 3 cm chiếu hậu xóa điểm mù xe hơi, ô tô, xe tải tăng độ an toàn, xoay 360 độ cố định( GCH01)",5.0,5507703146621,50000,50000,0,0,0,o-to-xe-may-xe-dap
94702864,"Khử mùi xe ô tô, khử mùi xe hơi nano bạc Nano Xclean For Car 500ML AHT Corp - chai xịt diệt khuẩn khử mùi ô tô, mùi hải sản, mùi ẩm mốc, mùi hôi khó chịu không gian nội thất xe ô tô - công nghệ nano an toàn, thân thiện",300.0,5482322355019,121000,165000,44000,27,43,o-to-xe-may-xe-dap
91390896,"Bình xịt vệ sinh nội thất ô tô dưỡng bóng ghế da, taplo, cao su, nhựa sần D-20",62.0,8538309075488,210000,210000,0,0,8,o-to-xe-may-xe-dap
83429308,Bộ 2 gương cầu lồi gắn kính chiếu hậu xe hơi và xe máy,40.0,3238385518485,30000,30000,0,0,6,o-to-xe-may-xe-dap
75550675,"(An Tâm) Búa Cứu Hộ Đa Năng 7 Trong 1 KhoNCC Hàng Chính Hãng - Với Nhiều Tiện Ích Khác - Có Đầu Nhọn Đập Kính Xe Hơi Khi Thủy Kích, Cháy Nổ - KDHS-BUADN-580",12.0,1090326123995,176000,176000,0,0,3,o-to-xe-may-xe-dap
56650569,Mũ Bảo Hiểm ¾ Napoli Sh2 Ruby Thời Thượng Nhiều Màu Cá Tính Free Size (55-58cm),56.0,1040319419338,247500,247500,0,0,11,o-to-xe-may-xe-dap
56364315,"Tấm Bạt Che Nắng Kính Ô Tô, Xe Hơi Cao Cấp Có Cách Nhiệt",131.0,1854063683163,100000,100000,0,0,31,o-to-xe-may-xe-dap
55797442,"Bộ 6 tấm bạc che nắng phản quang ô tô, Bạt che nắng ô tô gấp gọn tiện lợi, ngăn tia UV nhập thái lan familydecor",11.0,2209596353905,145000,145000,0,0,1,o-to-xe-may-xe-dap
38354744,NƯỚc RỬa Xe KhÔng ChẠm VÀ RỬa Khoang ĐỘng CƠ Ekokemika Italy Bio 45 - (5l) - Hàng Chính Hãng,78.0,6293320249622,1010000,1010000,0,0,17,o-to-xe-may-xe-dap
25933443,Bộ 2 Gối Tựa Đầu Ô Tô - Gối Chống Mỏi Cổ Trên Xe Hơi AZONE - Màu Chỉ Đỏ,82.0,9298941558006,120000,120000,0,0,19,o-to-xe-may-xe-dap
5483493,Dung dịch vệ sinh nội thất xe Sonax 321200 500ml,21.0,9285948886089,173000,190000,17000,9,1,o-to-xe-may-xe-dap
3856963,Kính Bulldog Eagle,20.0,3609385449625,232000,232000,0,0,10,o-to-xe-may-xe-dap
787926,Mũ Bảo Hiểm GRS A102K - Xanh Nhám Line Xanh,42.0,1598659844070,279000,279000,0,0,14,o-to-xe-may-xe-dap
276797183,Mũ bảo hiểm có kính NÓN SƠN chính hãng CKT-ĐO356,2.0,7664240559156,595000,850000,255000,30,0,o-to-xe-may-xe-dap
276557785,"Sơn Bạc Mạ Crom Sơn Xịt Mạ TAIKOMI Sáng Bóng 350ml Chai Sơn Mạ Siêu Bóng Làm Mới Ô tô Xe Máy, Vật Dụng Trang Trí",8.0,6662250087638,46150,65000,18850,29,1,o-to-xe-may-xe-dap
276001319,Mũ Bảo Hiểm 3/4 Napoli [CHÍNH HÃNG][FREESHIP] - Nón Bảo Hiểm Napoli SH N099 - Đủ Màu - Viền Đồng,1.0,2571135729306,254900,450000,195100,43,0,o-to-xe-may-xe-dap
275997734,Mũ Bảo Hiểm Napoli Sơn Carbon Nửa Đầu N088 [CHÍNH HÃNG] [FREESHIP] - Nón Bảo Hiểm NS 1/2 Sơn Nhám Cao Cấp Chống Trầy,26.0,9925704195712,154900,220000,65100,30,2,o-to-xe-may-xe-dap
275987413,Nước hoa Ô tô Cao Cấp BullSone Grasse Blue 100ml - Hàng Chính Hãng - Đa dạng mùi hương ,5.0,2122042092392,269000,400000,131000,33,0,o-to-xe-may-xe-dap
275931660,Dung dịch bọt vệ sinh làm sạch nội thất Ô tô Da - Nỉ  3M  290g,15.0,7335313621634,205000,205000,0,0,0,o-to-xe-may-xe-dap
275925124,Gối Tựa Đầu Tựa Lưng Cao Cấp Chính Hãng OFFICE CHILL Combo Gối Tựa Lưng Tựa Cổ Ô Tô Ghế Văn Phòng Chất Liệu Cao Su Bảo Hành 90 Ngày,24.0,9156438694226,100000,100000,0,0,3,o-to-xe-may-xe-dap
275886378,"Nước rửa xe bọt tuyết chuyên dụng Car Shampoo Hando 5L cho ô tô, xe máy",8.0,2596498533252,129000,129000,0,0,1,o-to-xe-may-xe-dap
275692742,Mũ Bảo Hiểm Fullface AGU A138 Tem - Hàng Chính Hãng Bảo Hành 12 Tháng - Sản Phẩm Thời Trang Và Cao Cấp,2.0,3467868725915,590000,590000,0,0,0,o-to-xe-may-xe-dap
275386744,Lốp (Vỏ) đặc không săm xe đạp Fixed Gear Single Speed 700x23C (23-622),3.0,2374813062853,115000,115000,0,0,1,o-to-xe-may-xe-dap
275320526,"Khăn Lau Xe Hơi Ô Tô THẾ HỆ MỚI Cao Cấp Gia Dụng Đa Năng Siêu Thấm Microfiber, Không rụng lông",30.0,6481793725601,18000,18000,0,0,3,o-to-xe-may-xe-dap
275045433,"Kem Tẩy Ố, cặn Canxi, Mốc Kính Xe Hơi 3M- Tẩy sạch  inox, thép, các vật dụng nhà tắm Creme Cleanser Limpiador EnCrema  946ml",31.0,9565010969854,250000,250000,0,0,2,o-to-xe-may-xe-dap
274072014,"Giá đỗ xe đạp chân chóng cố định chữ U móc đỏ giúp dựng đứng xe đạp để sửa chữa/ bảo dưỡng, khung kim loại, móc nhựa ABS (1 cỡ có điều chỉnh) - Mai Lee",18.0,7141069158548,139000,139000,0,0,3,o-to-xe-may-xe-dap
273979987,Xe Máy Honda FUTURE 125 FI 2024 - Phiên Bản Cao Cấp,14.0,6001477191326,37061000,37061000,0,0,4,o-to-xe-may-xe-dap
273311338,Xe máy Honda SH Mode 125cc 2024 - Tiêu chuẩn,7.0,3197118257068,60370000,60370000,0,0,1,o-to-xe-may-xe-dap
273309323,Xe Máy Honda SH Mode 2024 - Phiên Bản Thể Thao,22.0,1366388761387,67667000,67667000,0,0,7,o-to-xe-may-xe-dap
272350817,Xe máy Honda VISION 2025,5.0,5582478449290,33100000,33100000,0,0,0,o-to-xe-may-xe-dap
250970554,Xe đạp thể thao TEKKO G1 20 inch - xe đạp gấp đôi - gấp khung tiện lợi,4.0,9156881334596,3550000,3550000,0,0,2,o-to-xe-may-xe-dap
207947665,Đèn hậu xe đạp Kiotool pin sạc 4 chế độ sáng,237.0,2962487715780,45000,45000,0,0,38,o-to-xe-may-xe-dap
194794101,Mũ bảo hiểm xe máy trẻ em Andes 181S có kính âm an toàn cho trẻ có vòng đầu từ 48-51cm,6.0,5205141035093,405000,450000,45000,10,2,o-to-xe-may-xe-dap
192474425,"Xà bông rửa xe đậm đặc kết hợp tăng cường độ bóng sơn 2in1 1 lít PN39000W - Làm sạch bụi bẩn, bùn đất, dầu mỡ, dưỡng tăng độ bóng sơn, đậm đặc 1:60",25.0,6657449862178,175000,175000,0,0,2,o-to-xe-may-xe-dap
174847496,Bộ 2 Móc Treo Sau Ghế Ô Tô Tiện Lợi,8.0,8283024867040,35000,35000,0,0,1,o-to-xe-may-xe-dap
140579235,"""XE ĐẠP TRẺ EM ROYALBABY SHUTTLE 14''",13.0,8765677154541,3590000,3590000,0,0,6,o-to-xe-may-xe-dap
122436826,Chắn bùn xe đạp thể thao Kiotool trước sau đầy đủ phụ kiện chắc chắn,197.0,6063842479640,45000,45000,0,0,56,o-to-xe-may-xe-dap
117219775,Bộ Dưỡng Sên Xe Máy Maxima Chain Guard Và Chai Rửa Sên Voltronic IX69 Kèm Bàn Chải 3 Mặt Tiện Dụng,15.0,3933287345415,35000,35000,0,0,4,o-to-xe-may-xe-dap
91471480, Túi đeo hông chống nước đi xe máy GIVI RWB04,17.0,8851997215878,448000,448000,0,0,4,o-to-xe-may-xe-dap
77917419,"Bơm xe máy KIO-02 Phiên bản Xanh - Bơm xe đạp chân - Bơm đạp chân 2 ống đa năng - Bơm hơi đạp chân mini Xe Đạp, Xe Máy, Xe Ô tô, Xe Hơi Đa Năng Dễ Dàng Xếp Gọn thân hợp kim siêu bền, hỗ trợ cả van Mỹ và van Pháp Thương hiệu KIOTOOL",887.0,2511590261185,225000,225000,0,0,257,o-to-xe-may-xe-dap
76029583,Mũ Bảo Hiểm 1/2 Bulldog Pug - Hàng Chính Hãng,10.0,5139967129938,788000,788000,0,0,3,o-to-xe-may-xe-dap
69745996,"Biển Báo Phản Quang Tam Giác Xếp Gọn Cảnh Báo Từ Xa Nguy Hiểm Cho Xe Ô tô, Xe Hơi, Xe Tải, Xe Container Rơ-móc Giúp Dừng Đỗ Đậu Xe An Toàn Mai Lee",207.0,8419947812362,65500,65500,0,0,31,o-to-xe-may-xe-dap
68763501,"Túi Treo Sườn Xe Đạp Dài K-01ML Phom Mềm Gắn Sườn Xe,  vải Oxford chống mài mòn, chống Nước, 1 Ngăn - Mai Lee",318.0,8224429082481,109000,109000,0,0,95,o-to-xe-may-xe-dap
65115756,NƯỚC RỬA XE BỌT TUYẾT Ô TÔ [5 Lít],32.0,1920185942577,209000,239000,30000,13,9,o-to-xe-may-xe-dap
58213358,CẦN GẠT MƯA 3 KHÚC Ô TÔ CAO CẤP DENSO JANPAN ,172.0,4293530456447,260000,260000,0,0,56,o-to-xe-may-xe-dap
48563503,"Ví Da Đựng Đăng Kiểm, bảo hiểm, Giấy Tờ Cho Ô tô in Logo Honda",5.0,1057895838545,68000,68000,0,0,1,o-to-xe-may-xe-dap
38640207,"Thảm sàn, lót sàn cao su không mùi Cao cấp dành cho xe Chevrolet Trailblazer",1.0,7908855952839,858000,858000,0,0,0,o-to-xe-may-xe-dap
24865306,Mũ bảo hiểm GRS A368K,126.0,6350206699800,369000,369000,0,0,38,o-to-xe-may-xe-dap
22230660,DUNG DỊCH BẢO VỆ VÀ TĂNG CƯỜNG ĐỘ BÓNG  Sealing Wax Protection,4.0,4292758188420,859000,859000,0,0,0,o-to-xe-may-xe-dap
13772793,Chai xịt phủ bóng ô tô tạo hiệu ứng chống bám nước CERAMIC WAX MEGUIARS - G190526 - 768ML,29.0,1399817620129,605000,605000,0,0,9,o-to-xe-may-xe-dap
10189174,Mũ bảo hiểm lật hàm M179,11.0,8051294523852,549000,549000,0,0,3,o-to-xe-may-xe-dap
1378123,Găng Tay Chống Cắt 3M Cấp Độ 5 Cut Resistant Gloves,199.0,7145723559152,126000,126000,0,0,35,o-to-xe-may-xe-dap
232014,Mũ Bảo Hiểm Nửa Đầu Có Kính GRS A737K Nhám,251.0,1189294872452,279000,279000,0,0,38,o-to-xe-may-xe-dap
277286283,Mũ bảo hiểm có kính NÓN SƠN chính hãng CKT-TM448,1.0,1772563870720,595000,850000,255000,30,0,o-to-xe-may-xe-dap
276349241,"Bơm xe đạp, xe máy có đồng hồ",8.0,3118806886459,155000,185000,30000,16,0,o-to-xe-may-xe-dap
275932063,Chai xịt bảo vỏ(lốp)cao su- mâm xe SPRAY TIE – PN39042E ( Dòng cao cấp) - 400ML,1.0,7151903140526,410000,410000,0,0,0,o-to-xe-may-xe-dap
275931876,Chai xịt bảo dưỡng sơn Spray Wax – PN39034E ( Dòng cao cấp) - 400ml NK Thailan,4.0,9513042341160,280000,280000,0,0,0,o-to-xe-may-xe-dap
275711929,Mũ Bảo Hiểm Fullface AGU A138 Trơn - Tặng Túi Vải - Hàng Chính Hãng Bảo Hành 12 Tháng - Sản Phẩm Thời Trang Và Cao Cấp,4.0,9295101518851,520000,520000,0,0,2,o-to-xe-may-xe-dap
275605681,"Yên xe đạp Không mũi trước công thái học PU-667, mềm rộng dày, chống sốc 26x21x6 cm Da PU phù hợp xe đạp/ xe đạp điện/ xe mtb - Mai Lee",3.0,6102986257192,224420,229000,4580,2,0,o-to-xe-may-xe-dap
275603508,Mũ Bảo Hiểm Trẻ Em 1/2 V&S VS01K -  Hàng Chính Hãng Bảo Hành 12 Tháng - Sản Phẩm Thời Trang Và Cao Cấp,2.0,3343714683783,200000,200000,0,0,2,o-to-xe-may-xe-dap
275128617,Bộ 2 Móc Treo Xe Đạp Giúp Nâng Xe Đạp/ Vật Dụng Kim Loại Chịu Lực Treo Tường,2.0,2904866792412,115000,115000,0,0,1,o-to-xe-may-xe-dap
274805464,"Mỡ Bò Bôi Trơn Nhập Khẩu PALCO CHASSIS - Mỡ Bôi Trơn Khung Gầm Xe Tải, Kháng Nước, Bám Dính Tốt, Xô 5kg-18kg",4.0,6026402554789,95000,95000,0,0,1,o-to-xe-may-xe-dap
274370630,Xe Tay Ga TVS Callisto 110cc Nhập Khẩu,1.0,7786863756748,26500000,26500000,0,0,0,o-to-xe-may-xe-dap
274125909,Nước rửa kính ô tô chính hãng THACO 2 lít,266.0,6986489312035,110000,110000,0,0,26,o-to-xe-may-xe-dap
271758962,"Dầu nhớt tra xích dododios dành cho xe máy xe đạp - Dầu Máy Làm Trơn Ổ Khóa, Máy Móc, Quạt Điện - Công Thức Không Mùi - Hàng chính hãng",38.0,4218162904760,29000,29000,0,0,3,o-to-xe-may-xe-dap
271378946,Sáp Thơm  ÔTô MICHELIN Khử Mùi Xe Hơi Cao Cấp - Michelin Organic Can Air Freshener (Hàng Chính Hãng)-mùi hương jet Black ,1.0,5957368211586,109000,199000,90000,45,0,o-to-xe-may-xe-dap
257779781,Mũ bảo hiểm lỗ thông gió phiên bản mới NÓN SƠN chính hãng MP-TR102,4.0,4840210750324,595000,850000,255000,30,2,o-to-xe-may-xe-dap
253197587,Máy bơm lốp xe ô tô Xiaomi 70Mai air compressor Lite TỰ NGẮT độ ồn thấp mã lực lớn - có hiển thị áp suất,93.0,6513634359250,659000,659000,0,0,18,o-to-xe-may-xe-dap
251525299,Vè Che Mưa Xe Toyota Veloz Cross 2022-23 Đen Thái Dày Cao Cấp,8.0,5097164218866,264000,264000,0,0,2,o-to-xe-may-xe-dap
231319561,Dầu Tra Sên Xích Xe Đạp 60ml-Cylion Giúp Bảo Dưỡng Bôi Trơn Xe (dạng nước) kèm khăn lau CYLION,32.0,2437711607383,77420,79000,1580,2,4,o-to-xe-may-xe-dap
225171842,"Máy Bơm Ô tô, Xe hơi Đa Năng Michelin 12266 - Hàng Chính Hãng",416.0,8173287924690,1250000,1250000,0,0,113,o-to-xe-may-xe-dap
213988341,"Đệm giường ô tô, nệm ghế sau xe hơi cao cấp - Đệm ô tô treo hàng ghế sau không bơm hơi tiện lợi thiết kế sang trọng",4.0,8816167100228,890000,890000,0,0,0,o-to-xe-may-xe-dap
213964639,"Lót Ghế Hạt Gỗ Ô Tô Phối Da Cao Cấp Libai - Lót Ghế Xe Hơi Chống Nóng, Thoáng Khí, Massage Lưng, Bảo Vệ Da Ghế Xe",11.0,5183006777364,348000,348000,0,0,1,o-to-xe-may-xe-dap
199902089,"TRỤC LÓT BEN NÂNG CHỐNG ĐỨNG SAU R15, MT15",5.0,7249623232069,309000,309000,0,0,2,o-to-xe-may-xe-dap
180371795,Nón bảo hiểm xe đạp Giro Caden II,4.0,7634428379000,1800000,1800000,0,0,0,o-to-xe-may-xe-dap
165703913,Thảm lót sàn cao su cho xe Vios 2019-2021 cao cấp,10.0,8845001023794,466000,466000,0,0,3,o-to-xe-may-xe-dap
119718975,"Bình Ắc Quy Khô LONG 12V-9AH WP1236W dùng cho ups, lưu điện cửa cuốn, lưu điện máy tính, loa kéo",25.0,7670292162916,319000,319000,0,0,6,o-to-xe-may-xe-dap
96013931,Ví đựng giấy tờ xe ô tô dành cho hãng xe Mercedes - Benz,1.0,3472193061032,38000,38000,0,0,1,o-to-xe-may-xe-dap
85805262,Bạt Phủ Xe Ô Tô 5 chỗ Sedan Tráng Nhôm Cao Cấp,25.0,3584991913374,278000,278000,0,0,2,o-to-xe-may-xe-dap
83809831,Bao da chìa khóa Ducati Diavel 1260S - CHÍNH HÃNG KHACTEN.COM,2.0,4617335195819,400000,400000,0,0,1,o-to-xe-may-xe-dap
69139354,Phủ nano kính xe ô tô 3M 200Ml (Tặng kèm khăn + găng tay Nilong),391.0,3787304091435,165000,165000,0,0,104,o-to-xe-may-xe-dap
68877509,Dụng Cụ Kìm (Kềm) Cắt Mở Đóng Dây Sên Xích Xe Đạp Thể Thao Mini Tiện Lợi Nhanh Chóng Mai Lee,99.0,8611005030873,49000,49000,0,0,24,o-to-xe-may-xe-dap
66088714,Xịt Dưỡng Sên Voltronic M50-K Ceramic Chain Lube (400ml),195.0,5462045873363,290000,290000,0,0,70,o-to-xe-may-xe-dap
59436625,Đèn Đuôi LED Xe Đạp Thông Minh Cảnh Báo Ban Đêm Có Cảm Biến Chuyển Động Và Báo Đèn Khi Phanh Xe Chống Nước Sạc Điện USB MAILEE - Hàng Chính Hãng,94.0,9669800763419,198817,198817,0,0,32,o-to-xe-may-xe-dap
55581781,Bóng Đèn Bosch P21/5W 12V 21/5W 2 Tim (Hộp 10 Bóng),11.0,1613172542170,188000,188000,0,0,2,o-to-xe-may-xe-dap
54779162,Chai xịt làm bóng và bảo dưỡng lốp xe ô tô Sonax 235300 dung tích 400 ml,28.0,1942851646930,280000,280000,0,0,7,o-to-xe-may-xe-dap
54456859,"Bộ chia tẩu sạc ô tô, xe hơi nhãn hiệu Hoco Z34",46.0,1557581734194,169000,169000,0,0,15,o-to-xe-may-xe-dap
7255931,Mũ bảo hiểm nửa đầu lưỡi trai GRS A760,330.0,7707160671769,265000,265000,0,0,94,o-to-xe-may-xe-dap
3665433,Dung dịch chống bám nước kính xe 3M Glass Coat Windshield 3M 08889 LT 200ml,579.0,2005000918148,159000,159000,0,0,121,o-to-xe-may-xe-dap
2730177,Sáp thơm ôtô thiên nhiên tiện ích Acana 130g (hương dứa),54.0,1364555819654,53000,53000,0,0,7,o-to-xe-may-xe-dap
1378119,Bộ 4 Khẩu Trang Bảo Hộ Lọc Bụi Vi Khuẩn 3M 9001,362.0,4936286216117,79000,79000,0,0,51,o-to-xe-may-xe-dap
1254641,Dung Dịch Tăng Chỉ Số Octan Cho Xăng Bluechem Octane Booster (250ml),55.0,3572253645088,250000,250000,0,0,5,o-to-xe-may-xe-dap
511348,Che Chống Nắng Phản Quang Tròn Hando,13.0,1587284711925,62000,62000,0,0,1,o-to-xe-may-xe-dap
277303877,Mũ Bảo Hiểm Nửa Đầu EGO E-20,1.0,3730989536164,734000,1468000,734000,50,1,o-to-xe-may-xe-dap
277286237,Mũ bảo hiểm có kính NÓN SƠN chính hãng CKT-XH474,2.0,4770025079881,552500,850000,297500,35,1,o-to-xe-may-xe-dap
276962340,Tấm Che Nắng Kính Xe Hơi Và Gương Chiếu Hậu 145x120cm PaKaSa - Hàng Chính Hãng ,5.0,8765721391603,120190,184000,63810,35,0,o-to-xe-may-xe-dap
276310663,Máy Hút Kiêm Thổi Bụi Cầm Tay GOODYEAR GY-2651 Siêu Mini Sạc Điện Thông Minh - Nhập Khẩu Chính Hãng,3.0,3725118963096,912000,912000,0,0,2,o-to-xe-may-xe-dap
276044059,"Gương Cầu Lồi Mini Xoay 360 Độ | Gương Cầu Lồi Mini Dán Gương Xe Ô Tô Tăng Tầm Nhìn, Hạn Chế Điểm Mù, An Toàn Hơn Khi Tham Gia Giao Thông",12.0,5834101125310,45000,45000,0,0,0,o-to-xe-may-xe-dap
275896280,"Bạt Che Nắng Kính Lái Xe Ô Tô | Bạt Che Nắng Kính Lái Trước Loại Lớn Có Chụp Tai Gương, Chống Tia UV, Cách Nhiệt Cực Tốt, Bảo Vệ Nội Thất Xe Khỏi Tác Hại Từ Môi Trường",4.0,5076604743239,180000,180000,0,0,2,o-to-xe-may-xe-dap
275732263,AS - NÓN BẢO HIỂM PROTECT  SIZE L,59.0,3692260370752,277000,277000,0,0,1,o-to-xe-may-xe-dap
275687098,Mũ Bảo Hiểm Trẻ Em 1/2 V&S VS03KB Hàng Chính Hãng Bảo Hành 12 Tháng Sản Phẩm Thời Trang Và Cao Cấp,2.0,3643903332815,200000,200000,0,0,0,o-to-xe-may-xe-dap
275604041,Mũ Bảo Hiểm Trẻ Em 1/2 V&S VS03KB - Hàng Chính Hãng Bảo Hành 12 Tháng - Sản Phẩm Thời Trang Và Cao Cấp,4.0,7300430211339,180000,180000,0,0,2,o-to-xe-may-xe-dap
275354500,"Miếng bọc yên xe đạp thể thao êm ái,chống trượt,có dây rút điều chỉnh - Hàng chính hãng",24.0,8352189819640,59000,59000,0,0,3,o-to-xe-may-xe-dap
275083958,Film dán Nano chống nước mưa Baseus Rainproof Film 0.15mm dùng cho kính hậu xe ô tô SGFY-C- Hàng chính hãng,6.0,5610328596092,99000,99000,0,0,2,o-to-xe-may-xe-dap
274599591,"Bộ Tay đề, tay phanh Shimanô điều chỉnh tốc độ cho xe đạp thể thao 3 tốc và 7 tốc",15.0,1955728928250,53000,53000,0,0,5,o-to-xe-may-xe-dap
274443082,"Bạt trùm xe máy ,áo phủ xe máy vải dù cao cấp ,dày 2 mặt chống thấm ,chống nhiệt tối ưu ,bảo vệ xe khỏi mưa , nắng ",3.0,8025048982454,159000,159000,0,0,0,o-to-xe-may-xe-dap
273428487,"Kính vỡ lại lành, Keo dán kính ô tô phục hồi vết nứt rạn như mới mà khồng cần thay thế",8.0,8564491970664,128000,128000,0,0,1,o-to-xe-may-xe-dap
271730686,đèn xe đạp xi nhan không dây siêu nhậy lắp cột yên XN01 - Hàng chính hãng dododios,16.0,9119213177766,151000,151000,0,0,5,o-to-xe-may-xe-dap
244317933,Lọc nhớt Mitsubishi Triton 2.4L 2015-2023 - C415J,2.0,3995148920367,125000,125000,0,0,0,o-to-xe-may-xe-dap
217541244,"Bạt trùm xe Hyundai Tucson vải dù oxford cao cấp , áo bạt phủ oto xe hơi trùm che kín che nắng,mưa",1.0,6588161226355,348000,348000,0,0,0,o-to-xe-may-xe-dap
215738865,"Combo Gối Tựa Đầu Và Tựa Lưng Ô Tô Tích Hợp Massage 6 Chế Độ, Gối Tựa Cao Su Non, Giảm Đau Mỏi Cổ Vai Cột Sống - Sairui",13.0,9205386342089,529000,529000,0,0,1,o-to-xe-may-xe-dap
205239005,Bao da bảo vệ chìa khóa xe Mazda 3 2020 kèm móc đeo Inox,2.0,9514445147240,145000,145000,0,0,0,o-to-xe-may-xe-dap
173604033,Bạt Phủ Bảo Vệ Kính Lái Và Gương Xe Chống Nắng Cho Xe Ô tô,2.0,1131902929620,220000,220000,0,0,0,o-to-xe-may-xe-dap
162533012,Bộ vè che mưa đen dành cho xe CRUZE 2015-2021 chất liệu DÀY và BỀN,3.0,8737576814697,324000,324000,0,0,0,o-to-xe-may-xe-dap
158297707,Dầu Nhớt MiennamPetro Mars Europa 4T 10W-40 API SN JASO MA2 800ml Bảo Vệ Động Cơ Xe Máy 4 Thì Và Tiết Kiệm Nhiên Liệu,3.0,9215842536717,102000,102000,0,0,0,o-to-xe-may-xe-dap
155592495,"Máy Sạc Bình Ắc Quy LEKIMA 12V 12A - 24V 6A, Sạc Pin Lithium, Khử Sunfat, Sạc Ắc Quy Xe Máy Ô Tô Thông Minh Tự Ngắt Khi Đầy, MẪU MỚI 2021",6.0,2980532087903,752688,752688,0,0,1,o-to-xe-may-xe-dap
146583537,Lưới Tựa Lưng Ghế Ô Tô Cao Cấp giá tốt,2.0,6575020402944,126000,126000,0,0,0,o-to-xe-may-xe-dap
120294323,Chai Xịt Phủ Chống Chuột Xe Ô Tô 3M Rodent Repellant Coating 89797 250gr,36.0,5786619542640,255000,255000,0,0,5,o-to-xe-may-xe-dap
111463442,Thảm Taplo Da Carbon Toyota Corolla Cross 2020 2021 Loại 1 chuẩn theo xe ,15.0,6094134111899,239000,239000,0,0,2,o-to-xe-may-xe-dap
92983313,"Tượng Phong Thuỷ Ngựa Vàng Đính Đá Cao Cấp - Tượng Mã Đáo Thành Công Trang Trí Bàn Làm Việc, Ô Tô ",6.0,8308539734049,355000,355000,0,0,2,o-to-xe-may-xe-dap
85803879,Bao carbon chìa khóa ô tô dành cho Toyota Corolla Cross nhựa ABS vân Carbon kèm móc đeo INOX,10.0,2234164551344,148000,148000,0,0,2,o-to-xe-may-xe-dap
72909461,Bộ Ốp Tay Cửa Dành Cho Ô Tô Outlander 2016 2017 2018 2019 2020 Vân Cacbon,2.0,7694918038779,162800,162800,0,0,1,o-to-xe-may-xe-dap
58618778,Bình Xịt Vệ Sinh Ghế Da Ô Tô - Đồ Da Flamingo,552.0,3196655984103,46800,46800,0,0,113,o-to-xe-may-xe-dap
53308205,Hộp Túi Treo Khung Gắn Sườn Trước Xe Đạp Có Giá Đỡ Đựng Điện Thoại Màn Hình Cảm Ứng Dưới 6.5 Inch Chống Thấm Nước Mai Lee Cycling - Hàng Chính Hãng,943.0,2422081795220,204800,204800,0,0,266,o-to-xe-may-xe-dap
42687611,Combo 2 Trang Trí Bọc Dây An Toàn FOCUS F-X01A Màu Kem,6.0,3897810436863,135000,135000,0,0,3,o-to-xe-may-xe-dap
31239782,Mũ Bảo Hiểm Royal 3/4 kính âm,63.0,3961827596374,499000,499000,0,0,21,o-to-xe-may-xe-dap
17967585,Thẻ Ghi Số Điện Thoại  Kiêm Giá Để Điện Thoại Trên Taplo Ô Tô - Tặng 1 lọ tinh dầu Sả treo xe,1.0,5704861754120,76000,76000,0,0,0,o-to-xe-may-xe-dap
16420415,Thẻ Ghi Số Điện Thoại Cho Xe Hơi (ô tô) Milliken NL-3107,8.0,3431077321403,100000,100000,0,0,2,o-to-xe-may-xe-dap
3523595, Sáp thơm ô tô hương vani – Areon Ken Vanilla (NHẬP KHẨU BULGARIA),64.0,1010002880646,269000,269000,0,0,16,o-to-xe-may-xe-dap
2937179,Nước rửa xe máy ô tô cao cấp DELUXE Getsun 2L ,26.0,3557668708696,138000,138000,0,0,4,o-to-xe-may-xe-dap
1338747,Combo 2 Móc Treo Đa Năng Trên Ô Tô CIND S2215W,72.0,8056529893823,53000,53000,0,0,8,o-to-xe-may-xe-dap
1254665,Phụ Gia Súc Béc Dầu Cao Cấp Liqui Moly Super Diesel Additive 1806 (250ml),17.0,8096940776886,165000,165000,0,0,2,o-to-xe-may-xe-dap
1237321,Xi Đánh Bóng Cana Car Cream,5.0,4729208341789,70000,70000,0,0,1,o-to-xe-may-xe-dap
276079374,Ruột DELI Tire 700x19/23c gắn xe đạp đua,1.0,3651471820537,50000,50000,0,0,1,o-to-xe-may-xe-dap
275852378,Bộ Vá Săm Xe Đạp Đầy Đủ 13 Chi Tiết - Vá Xe Đạp Chuyên Dụng,7.0,1938659467674,19900,19900,0,0,0,o-to-xe-may-xe-dap
275723775,"SIÊU HOT - Coi hu 3 tieng,coi bao dong,Còi Hú 3 Chế Độ Cho Ôto, Xe Máy 206407",2.0,4426554857055,127500,127500,0,0,1,o-to-xe-may-xe-dap
275548415,"Ốp Chìa Khóa KIA Soluto, Seltos, Cerato, Sorento, Rondo 3 Nút Chất Liệu Hợp Kim, Kèm Móc Treo Cao Cấp - Hàng Nhập Khẩu",1.0,3361784061988,239000,239000,0,0,1,o-to-xe-may-xe-dap
275282172,"Tượng ngựa mạ vàng có vòng tròn pha lê đựng nước hoa trang trí không gian xe hơi, bàn làm việc",2.0,3258070110627,270000,270000,0,0,1,o-to-xe-may-xe-dap
274682766,Thảm lót sàn xe ô tô Toyota Wigo 2023 Nhãn hiệu Macsim chất liệu nhựa TPE cao cấp màu đen,2.0,9575415632523,1815000,1815000,0,0,1,o-to-xe-may-xe-dap
274679877,Bánh phụ xe đạp trẻ em có đèn LED sáng (gồm cả bộ 2 bánh + chân sắt + không có chuông),8.0,3169919750110,70000,70000,0,0,1,o-to-xe-may-xe-dap
273279336,Miếng dán băng keo nano trong suốt dán cửa xe gương chiếu hậu bảo vệ chống trầy xe giảm chấn giảm ồn Legaxi,1.0,6468913081068,52000,52000,0,0,0,o-to-xe-may-xe-dap
271957015,Phụ gia nhớt súc rửa động cơ cao cấp Liqui Moly 2427,1.0,9122158922913,229000,229000,0,0,0,o-to-xe-may-xe-dap
271146135,"Bạt phủ xe ô tô Toyota Corolla Cross chất liệu vải dù oxford cao cấp, áo trùm xe ô tô 5 chỗ corolla cross , bạc phủ ",1.0,5441824828388,408000,408000,0,0,0,o-to-xe-may-xe-dap
269964033,"Quạt mini để trên xe ô tô quạt gắn taplo, cửa gió điều hoà xe hơi có đèn led cổng usb tiện lợi - hàng chính hãng",8.0,1861370732050,104940,104940,0,0,2,o-to-xe-may-xe-dap
252650960,Mũ bảo hiểm xe máy 1/2 Rona haly luxury kèm kính phi công viền đồng cao cấp chính hãng,7.0,7919884304492,270000,450000,180000,40,1,o-to-xe-may-xe-dap
247799992,"Nước rửa kính - Dung dịch đổ kính Ô tô  Xglass Nano, Cleaner loại 3,2 lít - Ekokemika",5.0,1100367675008,60000,60000,0,0,1,o-to-xe-may-xe-dap
244316055,"️ Bộ dây vòi xịt nước rửa xe, tưới cây , tăng áp 3 lần, loại 20m 206701-2 đầu đồng,cút đồng+ mở chai",1.0,4077945865698,418341,418341,0,0,0,o-to-xe-may-xe-dap
219458023,"Chai xịt Toyo làm sạch, bóng, mới đồ da, Bóng Gỗ, Da Salon, Ghế Da 500ml",10.0,6517343731022,70000,70000,0,0,1,o-to-xe-may-xe-dap
213970307,"Thảm sàn, Thảm lót sàn xe Hyundai CRETA 2022 2023 cao su đúc, vân tổ ong, không mùi, MẪU NISSIN",2.0,9448512730275,478000,478000,0,0,1,o-to-xe-may-xe-dap
210274891,"Đệm hơi ô tô, nêm hơi cho xe ô tô cao cấp, loại dày dặn, Tặng kèm bơm điện 2 gối và miếng vá dự phòng",1.0,4669419732968,354000,354000,0,0,1,o-to-xe-may-xe-dap
188691082,Bình Xịt Bọt Vệ Sinh Ghế Da Nội Thất Ô Tô  - Chai Xịt Bọt Vệ Sinh Flamingo Dung Tích 650ml CARZONE.TOP,5.0,5421643490196,55000,55000,0,0,0,o-to-xe-may-xe-dap
186162583,"Thảm lót sàn ô tô 4, 5 chỗ tấm trải sàn cao su chất lượng cao (hàng loại 1)",4.0,5243406542722,285000,285000,0,0,0,o-to-xe-may-xe-dap
133820225,"Bạt phủ xe ô tô 7 chỗ có 3 lớp cao cấp , bạt phủ trùm xe hơi dòng Innova, Ecosport, Crv, CX5, Tucson, Santafe, Carens",31.0,3241623437868,299000,299000,0,0,4,o-to-xe-may-xe-dap
133712193,Khánh treo xe hơi - Dây treo xe ô tô cực đẹp | gỗ Hoàng Dương,5.0,3372787583082,190000,215000,25000,12,2,o-to-xe-may-xe-dap
132862915,Sơn SAMURAI KUROBUSHI H2*** SƠN CHỊU NHIỆT (MÀU ĐEN) chính hãng dành cho xe máy,34.0,1761251939004,130000,130000,0,0,7,o-to-xe-may-xe-dap
121073250,"Dung dịch phun khói khử mùi ô tô Nano Xclean For Horeca Dùng Với Máy Phun Khói-Kháng Khuẩn, Khử Mùi Mốc, Mùi Ẩm, Mùi Hôi Không Gian Nhà Hàng-Nano Bạc AHTC",15.0,5163665147215,792000,792000,0,0,3,o-to-xe-may-xe-dap
119719160,Bình Ắc Quy Cho UPS GLOBE WP7.5-12 Khô 12V - 7.5AH,14.0,7280034059230,279000,279000,0,0,1,o-to-xe-may-xe-dap
117597884,COMBO 4 lon Nước làm mát động cơ màu xanh Esna Coolant 500ml,3.0,3112529304116,79000,79000,0,0,0,o-to-xe-may-xe-dap
116622929,Tượng phật di lặc để taplo kiêm nước hoa ô tô xe hơi cao cấp khử mùi chống say xe cầu an lành hạnh phúc,4.0,6815522135424,245000,245000,0,0,0,o-to-xe-may-xe-dap
111463201,Rèm che nắng theo xe Toyota Cross hút nam châm cánh cửa,18.0,9661695141118,322800,322800,0,0,6,o-to-xe-may-xe-dap
111362258,"Bọc vô lăng, bọc da vô lăng carbon có logo dành cho Isuzu",1.0,5979419608068,138000,138000,0,0,1,o-to-xe-may-xe-dap
95469831,Ví đựng giấy tờ xe ô tô dành cho hãng xe Hyundai,1.0,8907478974912,45000,45000,0,0,0,o-to-xe-may-xe-dap
81693965,THẢM TAPLO DA VÂN CARBON CAO CẤP XE FORD RANGER XLS 2018 - 2020,5.0,6858429749059,233500,233500,0,0,1,o-to-xe-may-xe-dap
71075907,"Bộ Dụng Cụ Chùi Chải Vệ Sinh Sên Xích Nhông Đĩa Cho Xe Đạp Thể Thao, Địa Hình (Kèm nước rửa tẩy rửa vệ sinh sên xích) Vệ Sinh Xích Líp Mai Lee",212.0,9200704155421,159000,159000,0,0,62,o-to-xe-may-xe-dap
70520914,Chân Chống Xe Đạp Thể Thao Hợp Kim Nhôm Siêu Nhẹ Có Thể Điều Chỉnh Dài Ngắn 36-41cm Phù Hợp Bánh Xe 22-29 inch Cho Xe Đạp Mai Lee,33.0,4688906169548,126420,126420,0,0,6,o-to-xe-may-xe-dap
56418216,Nước Rửa Kính Ô Tô  Xglass Classic Thương Hiệu Ekokemika - Hàng Chính Hãng,103.0,7422914720622,65000,65000,0,0,22,o-to-xe-may-xe-dap
54476107,"Nón bảo hiểm 3/4 kính âm Royal M139 Đỏ Đô Nhám cao cấp Lót tháo rời, che hết mặt",172.0,8840299889793,489000,489000,0,0,60,o-to-xe-may-xe-dap
51965527,"Bạt Trùm Xe Hơi ELANTRA 5 Chỗ Chắn nắng che mưa bảo vệ xe Ô TÔ , Xe Hơi Hiệu Quả ",1.0,1708417814379,265000,265000,0,0,0,o-to-xe-may-xe-dap
22975262,DUNG DỊCH VỆ SINH HỆ THỐNG DÀN LẠNH - ĐIỀU HÒA Ô TÔ 3M AIR CONDITIONER CLEANER FOAM 250ML,22.0,8395712638538,162000,162000,0,0,2,o-to-xe-may-xe-dap
10397107, Dung dịch rửa xe không chạm Ekokemika BIO 30 (5L),324.0,8438811099111,645000,645000,0,0,36,o-to-xe-may-xe-dap
3935845,Nước hoa ô tô cao cấp WIne Korea A50 65ml Hương Thơm Dễ Chịu,25.0,6386864480771,139000,139000,0,0,4,o-to-xe-may-xe-dap
1254637,Nano Bảo Vệ Động Cơ Cho Mô Tô Xe Máy Bluechem Nano Engine Super Protection (50ml),18.0,8412747224373,105000,105000,0,0,2,o-to-xe-may-xe-dap
1254567,"Chất Tấy Rửa, Bôi Trơn, Chống Rỉ Sét 3M 5 Way (400ml)",10.0,8583428159236,69000,69000,0,0,3,o-to-xe-may-xe-dap
276626620,Xe máy Honda Vision 2025 Thể Thao ,19.0,3482156132507,38970000,38970000,0,0,2,o-to-xe-may-xe-dap
276489033,Bao Da Chìa Khóa Ô Tô Handmade Vinfast E34 VF8 VF9 VF6 da bò thật - hãng chính hãng,2.0,6242140979986,270630,279000,8370,3,1,o-to-xe-may-xe-dap
276253744,"Chai tẩy sạch và đánh bóng inox 3M 3M-SSCP 600ml - tẩy sạch vết rỉ sét ở các vật liệu inox như xoong nồi, bếp gas, vòi rửa, kính, gạch,...",3.0,1903628610952,275000,275000,0,0,0,o-to-xe-may-xe-dap
276101026,Ổ cứng di động WD Elements USB 500GB: Đối tác lưu trữ đáng tin cậy cho máy tính của bạn,7.0,5273109470910,496000,496000,0,0,1,o-to-xe-may-xe-dap
276006820,[Mới] Đệm Lót Mũ Bảo Hiểm Giúp Thoáng Khí Chống Áp Lực Khi Lái Xe - Dụng Cụ Giữ Form Tóc Và Bảo Vệ Da Đầu,24.0,8472155033887,20000,20000,0,0,1,o-to-xe-may-xe-dap
275474354,"Túi vải đựng mũ bảo hiểm Royal Royce Rona Roc chất vải không dệt, hạn chế trầy xước - tem màu ngẫu nhiên",176.0,9952824838544,40000,50000,10000,20,0,o-to-xe-may-xe-dap
275072609,"Bạt Trùm Xe Máy , Áo Trùm Xe Che Nắng Mưa, Tấm Phủ Che Nắng Xe Máy Đa Năng Vải Dù Siêu Dày, Hàng Việt Nam, Có Túi Đựng ",48.0,2505760322786,143000,143000,0,0,7,o-to-xe-may-xe-dap
275062998,Mũ bảo hiểm xe đạp thể thao Kiotool siêu nhẹ thoáng khí an toàn khi đạp xe,54.0,4064540925834,145000,145000,0,0,17,o-to-xe-may-xe-dap
273839889,(CHỌN LOẠI) Giá Đỡ - Kẹp Điện Thoại Gắn Xe Đạp Và Xe Máy Vô Cùng Chắc Chắn - Hàng chính hãng dododios,18.0,2674812800081,74000,74000,0,0,1,o-to-xe-may-xe-dap
255342774,"Bạt phủ trùm xe ô tô Mazda CX5 3 lớp tráng bạc thông minh, chất liệu vải dù oxford cao cấp, áo chùm bảo vệ xe 4,5,7 chỗ ",1.0,1617226991572,408000,408000,0,0,0,o-to-xe-may-xe-dap
247405976,Bio 20 - 1 lít - Dung dịch rửa xe không chạm - Nước rửa xe bọt tuyết - Ekokemika,3.0,7498139001370,99000,99000,0,0,0,o-to-xe-may-xe-dap
188964502,Chai xịt diệt khuẩn khử mùi ô tô xe khách bằng nano bạc Nano Reiwa 100ml được chứng nhận viện Pasteur an toàn cho trẻ em - Hàng chính hãng,272.0,8209025184968,48000,48000,0,0,52,o-to-xe-may-xe-dap
188937366,Chai Xịt Dưỡng Sên Senfineco 9924 Chain Lub Extreme Ceramic 200ml,33.0,9506218475271,180000,180000,0,0,8,o-to-xe-may-xe-dap
184794821,Phiếu mua hàng Honda Big Bike Hoàng Việt,46.0,2944524299142,5000000,5000000,0,0,9,o-to-xe-may-xe-dap
181772788,"Bạt Phủ Xe Ô Tô Toyota Vios, Altis, Camry, Fortuner, Innova, Yaris, Rush, Hilux, Wigo, Land Cruiser",0.0,6450313177725,430000,430000,0,0,0,o-to-xe-may-xe-dap
179523040,"Tấm lót đệm lưới tựa lưng ghế ô tô ,xe hơi ,văn phòng chống nóng ,giảm đau mỏi,tạo dáng ngồi ngay thẳng và thoải mái",5.0,7361752460880,125000,125000,0,0,0,o-to-xe-may-xe-dap
169343286,"Bộ 2 Chốt ngắt tiếng kêu, chốt cài dây an toàn Ô tô Honda",22.0,7416438265803,65000,65000,0,0,2,o-to-xe-may-xe-dap
163576613,"[Quá Tiện] Sạc Bình Ắc Quy KhoNCC Hàng Chính Hãng - Điện áp 12V2A dòng 2~20Ah - Cho Cả Bình Khô Hoặc Nước Của Xe Máy, Ôtô - KDHS-SAQXM",41.0,3392241935630,119000,158000,39000,25,6,o-to-xe-may-xe-dap
162581887,"Máy bơm lốp ô tô Tâm Luân động cơ DÂY ĐỒNG, chip chống quả tải và ngắn mạch, máy bơm lốp xe ô tô công suất 120w, máy bơm ô tô 12V",224.0,4675059680547,199000,300000,101000,34,66,o-to-xe-may-xe-dap
125009528,Nhớt Tổng Hợp Cho Xe Tay Ga 4 Thì Motul Scooter Power LE 5W40 Có Chiết Lẻ ,71.0,1187745836610,175000,175000,0,0,18,o-to-xe-may-xe-dap
117598477,Nước làm mát động cơ xe ô tô màu xanh Esna Coolant,80.0,6991646271710,19000,19000,0,0,9,o-to-xe-may-xe-dap
115471868,( Dành Cho ) Bộ Tựa Lưng Lót Ghế Ô Tô Có Hạt Gỗ Massage Hàng Cao Cấp ,4.0,1698798097192,338000,338000,0,0,1,o-to-xe-may-xe-dap
102445310,"Hộp đựng khăn giấy chất liệu da trên ô tô và bàn làm việc,kèm bảng số điện thoại",22.0,4679906295920,139990,139990,0,0,5,o-to-xe-may-xe-dap
88921228,Decal phản quang 3M serie 983 (1 mét lẻ),207.0,6951759490899,60000,60000,0,0,33,o-to-xe-may-xe-dap
74689554,24 Miếng Vá Săm Lốp Xe Đạp Dự Phòng Tự Vá Tại Nhà (Gồm Keo) Mai Lee,84.0,5906704813111,28380,28380,0,0,17,o-to-xe-may-xe-dap
72109275,"Kem Đánh Bóng Xóa Trầy Xước Sơn Ô tô - Xe Máy Cana Car Cream 100g -220g - đánh bóng bề mặt kim lọai, đồ gỗ, mặt đá",331.0,2847874935605,42000,42000,0,0,59,o-to-xe-may-xe-dap
72103308,"Đệm Yên Xe Đạp Thể Thao Đàn Hồi Mềm Dày Thoáng Khí Cao Cấp Giúp Êm Mông Thoải Mái (Bản Nâng Cấp) Chống Trượt, Siêu Êm Có Lỗ Rãnh Thoát (Thân Rộng) Mai Lee",833.0,4255868119609,101300,101300,0,0,236,o-to-xe-may-xe-dap
71102314,Hộp đựng đồ đa năng gấp gọn để cốp sau ô tô dung tích 55 lít,16.0,8289924800787,268000,268000,0,0,7,o-to-xe-may-xe-dap
59548941,Phủ kính nano chống bám nước gương kính ô tô Nhật Bản,69.0,5745849196020,195000,195000,0,0,15,o-to-xe-may-xe-dap
58244258,"Bơm lốp ô tô xiaomi 70mai midrive TP03 , Bơm lốp đa năng  , Bơm lốp mini - Hàng nhập khẩu",599.0,1859272844824,625000,625000,0,0,132,o-to-xe-may-xe-dap
46580082,Nước Rửa Xe Không Chạm Đặc Biệt T-rex 80 Ekokemika (5L) - Hàng Chính Hãng,31.0,3991440639899,1010000,1010000,0,0,9,o-to-xe-may-xe-dap
44259453,Khăn lau ô tô chuyên dụng Microfiber 3M 36x36cm - màu vàng,497.0,7048455932029,24000,24000,0,0,23,o-to-xe-may-xe-dap
34531222,"Bộ Hộp Dụng Cụ Vá Lốp Xe Lốp Không Săm Vá Lụi (vá ngoài) Bằng Thép Không Gỉ Cho Xe Oto, Xe Hơi Và Xe Máy Mai Lee - Hàng Chính Hãng",445.0,4223316365519,129000,129000,0,0,92,o-to-xe-may-xe-dap
25969322,Mũ bảo hiểm nửa đầu Bulldog Gang,107.0,7980519219328,696000,696000,0,0,33,o-to-xe-may-xe-dap
7295755,Nước rửa xe đậm đặc Sonax Gloss Shampoo 314300 1L  ,124.0,5068921767353,134000,134000,0,0,27,o-to-xe-may-xe-dap
5485879,"Chai xịt bóng nhanh dùng cho sơn bóng, sơn mờ, wrap Sonax Xtreme Brilliant Shine Detailer 287400 750ml",7.0,8624851765455,218000,218000,0,0,2,o-to-xe-may-xe-dap
2453873,Chai xịt dưỡng sên/xích Repsol 400ml,17.0,5024462595565,138000,138000,0,0,6,o-to-xe-may-xe-dap
1254635,Dung Dịch Vệ Sinh Hệ Thống Xăng Cho Mô Tô Xe Máy Bluechem Fuel Sysem Cleaner (50ml),63.0,2094474713144,79000,79000,0,0,8,o-to-xe-may-xe-dap
1237331,"Chai Xịt Bóng Da, Bóng Gỗ Toyo (500ml)",827.0,5281017348353,69000,69000,0,0,89,o-to-xe-may-xe-dap
276626834,Xe Máy Honda Vision 2025 - Phiên Bản Đặc Biệt,5.0,4388975753129,36354000,36354000,0,0,1,o-to-xe-may-xe-dap
276626812,Xe máy Honda Vision 2025 Đặc Biệt  ,11.0,7446391151558,37330000,37330000,0,0,3,o-to-xe-may-xe-dap
276101662,Xe máy Honda Lead 125cc 2025 - Phiên Bản Đặc Biệt,26.0,9631391752390,47162000,47162000,0,0,6,o-to-xe-may-xe-dap
275905060,Kính Phi Công Gắn Nón Bảo Hiểm - Trang Trí Mũ Bảo Hiểm 1/2 - Trang Trí Mũ Bảo Hiểm 3/4,6.0,1728958161048,100000,100000,0,0,3,o-to-xe-may-xe-dap
275769117,"Quây chống chuột - Rào chắn chuột ô tô 4-5-7 chỗ và bán tải loại cao cấp, có lưới inox chống cắn",25.0,9593991875815,890000,890000,0,0,5,o-to-xe-may-xe-dap
275618186,Khung Biển Số Xi Titan Full Bộ tặng MECA gắn mọi loại xe máy như hình,26.0,9522863335240,33000,33000,0,0,2,o-to-xe-may-xe-dap
275508038,"Xe đạp Thống Nhất mini New 24, 26 inch - Phù hợp với người cao từ 1m35 trở lên",117.0,3025158117154,2690000,2690000,0,0,36,o-to-xe-may-xe-dap
275263833,Xe máy Honda Air Blade 125cc 2025 - Phiên Bản Đặc Biệt,15.0,6475579133659,47667000,47667000,0,0,6,o-to-xe-may-xe-dap
274450539,"Thiết bị hiển thị và cảnh báo tốc độ hắt kính lái xe ô tô Hud M8 - OBD 2, dùng được cho đa phần các loại xe",38.0,7762004486002,419000,419000,0,0,5,o-to-xe-may-xe-dap
273897383,"Bộ nối tăng chiều cao ghi đông xe đạp hợp kim nhôm, dễ lắp đặt",15.0,9826945120769,119000,119000,0,0,3,o-to-xe-may-xe-dap
273829007,"Khăn lau xe ô tô chuyên dụng đa năng microfiber, siêu thấm, khổ to, không để lại bụi vải TÂM LUÂN Chổi lau tẩm dầu - Hàng chính hãng",690.0,7817507662837,23000,40000,17000,43,52,o-to-xe-may-xe-dap
273311185,Xe Máy Honda SH Mode 2024 - Phiên Bản Đặc Biệt,27.0,9422752673054,67667000,67667000,0,0,7,o-to-xe-may-xe-dap
270059041,"Biển báo phản quang tam giác xếp gọn, biển cảnh báo nguy hiểm, biển tam giác phản quang sự cố, phụ kiện ô tô Tâm Luân",86.0,2376912180346,85000,130000,45000,35,9,o-to-xe-may-xe-dap
178089164,"Chai xịt tẩy rửa hợp kim nhôm, tẩy lốc máy, đầu bò, dàn chân xe máy, xịt sên SprayKing REPAIR 1000ml",63.0,3690763254566,65000,65000,0,0,13,o-to-xe-may-xe-dap
171651830,"Máy bơm lốp mini đa năng tự ngắt Michelin 3321 - Bơm xe đạp, xe máy, ô tô, bóng, xe hơi 4 bánh, có đèn LED, nhỏ gọn, thông minh, sạc Micro USB",301.0,8151228511740,889000,889000,0,0,72,o-to-xe-may-xe-dap
169885717,"[Vải Dù Dày Nặng 1kg3]Bạt Phủ - Áo Trùm Xe Máy Cao Cấp Vải Dù 2 Mặt Che Nắng, Mưa Giữ Xe Luôn Như Mới Vừa Tất Cả Loại Xe",450.0,9642087922622,135000,135000,0,0,82,o-to-xe-may-xe-dap
147124821,"Bộ 6 Tấm Chắn Nắng Ô tô, Che Nắng Xốp Tròn Dày Dặn chống nóng xe hơi",8.0,9461714334431,61000,61000,0,0,0,o-to-xe-may-xe-dap
146370320,"Bọc khóa smartkey dành cho Honda Airblade AB, Lead, Vision, Vario 150- Bezen Armor",34.0,4421444562196,89000,89000,0,0,6,o-to-xe-may-xe-dap
110646106,Bơm xe đạp xe máy Kiotool chuyên dụng ống to nhanh đầy hơi bơm nhẹ  có đầy đủ phụ kiện bơm bóng đá thú nhún bơm phao bơi,1395.0,6525708193463,125000,125000,0,0,371,o-to-xe-may-xe-dap
107458507,"Bạt phủ xe ô tô cao cấp, cho xe ôtô 4 chỗ đến 7 chỗ, phản quang,chống nóng, chống nước, có khóa kéo cánh cửa",0.0,3588793444020,425000,425000,0,0,0,o-to-xe-may-xe-dap
105328552,Combo 2 can Nước rửa xe bọt tuyết chuyên dụng Car Shampoo 5L cho ô tô xe máy,279.0,4649418347050,258000,258000,0,0,49,o-to-xe-may-xe-dap
100256806,Xe đạp Thống Nhất GN 06-24 - Hàng chính hãng,16.0,3202115384099,2290000,2290000,0,0,6,o-to-xe-may-xe-dap
99275571,"Tấm Chắn Nắng, Chống Nóng Ngoài Kính Lái Ô Tô 3 Lớp, Tráng Bạc Cỡ Lớn 118cm x 148cm, Có Trùm Gương - Hàng chính hãng",121.0,6477094391849,114000,114000,0,0,27,o-to-xe-may-xe-dap
87392058,"Túi xe đạp cao cấp,túi treo sườn xe đạp chống nước bọc cảm ứng phù hợp với mọi dòng xe Thương hiệu KIOTOOL",164.0,9342173996244,65000,65000,0,0,35,o-to-xe-may-xe-dap
84870183,Combo chai vệ sinh sên Megacools 500ml và xịt bảo dưỡng sên Megacools 300ml tặng bàn chải 3D cao cấp,126.0,6047985875483,159000,159000,0,0,39,o-to-xe-may-xe-dap
76379559,"[Loại Lớn - Dày] Áo Bạt Phủ Trùm Xe Máy KhoNCC Che Mưa Nắng Dòng Xe Lớn SH 125 150i , Moto Z1000 - NQL-BPXMT-Z1K - Hàng Chính Hãng (Xanh Đen)",990.0,5100429738616,159000,248000,89000,36,283,o-to-xe-may-xe-dap
73802977,"Giá Bình Nước Xe Đạp Siêu Nhẹ Gắn Khung Cho Xe Đạp Leo Núi, Thể Thao Giá Rẻ Bằng Nhựa Chất Lượng Cao Mai Lee",232.0,2965389227197,44900,44900,0,0,68,o-to-xe-may-xe-dap
56870012,Máy Bơm Lốp Xe Máy Xe Đạp Không Dây 150PSI 4000mAh LED Hiển Thị Kép Thiết Kế Đặc Biệt Nhỏ Gọn Tự Động Ngắt Khi Đủ Hơi,33.0,5839864744639,331000,331000,0,0,9,o-to-xe-may-xe-dap
53296107,Bảng Hiển Thị Số Điện Thoại Gắn Trên Taplo Xe Ô TÔ  Giúp Người Đi Đường Dễ Dàng Liên Hệ Với Bạn Khi Cần Thiết,101.0,4631464131731,10000,10000,0,0,11,o-to-xe-may-xe-dap
46578885,Nước Rửa Xe Không Chạm Đặc Biệt T-rex 80 Ekokemika - (1l) - Hàng Chính Hãng,103.0,8433850749997,205000,205000,0,0,19,o-to-xe-may-xe-dap
36273203,"NƯỚc RỬa KÍnh Ô TÔ TẠo HiỆu Ứng Nano XuẤt XỨ ChÂu Âu, HƯƠng Hoa OẢi HƯƠng Xglass Lavanda (3.2l) - Hàng Chính Hãng",425.0,1867679533937,145000,145000,0,0,86,o-to-xe-may-xe-dap
34845206,Nước rửa xe bọt tuyết Car Shampoo 5 lít cho ô tô xe máy ,58.0,8306572174869,136000,136000,0,0,7,o-to-xe-may-xe-dap
17891240,Dầu nhớt Xado Moto Luxury Racing 10w40 1L,24.0,2912515389083,400000,400000,0,0,9,o-to-xe-may-xe-dap
11506461,"Bơm MICHELIN 4398ml 12266 bơm ô tô, xe hơi mini tự ngắt",255.0,8449894421652,1139000,1139000,0,0,60,o-to-xe-may-xe-dap
11503718,"CHAI XỊT BỌT TUYẾT VỆ SINH NÓN BẢO HIỂM, YÊN, RỬA XE KHÔ NHANH CHÓNG LUBE71 WELL FOAM SPRAY 600ML",14.0,6940643707512,229000,229000,0,0,5,o-to-xe-may-xe-dap
3665771,Dầu bôi trơn chống rỉ sét đa năng 3M 5-W,63.0,2094566388724,69000,69000,0,0,12,o-to-xe-may-xe-dap
3522761, Sáp thơm ô tô hương cà phê AREON Ken Coffee - NHẬP KHẨU BULGARIA,543.0,3142702220410,265000,265000,0,0,64,o-to-xe-may-xe-dap
1254601,Khăn Lau Xe Hơi 3M Perfect-It Super Soft Microfiber PN05400 (32 x 36 cm),20.0,3048296982966,54000,54000,0,0,1,o-to-xe-may-xe-dap
1254583,Dung Dịch Chống Bám Nước Trên Kính Xe 3M Glass Coat Windshield 3M 08889 (200ml),630.0,8003399422875,155000,155000,0,0,146,o-to-xe-may-xe-dap
646560,Khóa Thắng Đĩa Master Lock 8303 EURDPS+,53.0,4606327983062,560000,560000,0,0,16,o-to-xe-may-xe-dap
276493893,Set Váy Ngủ Dây Nơ V1 Cosplay Bikini 1 Mảnh Sexy Gợi Cảm Độc Lạ Freebra,1.0,5007317538418,298000,298000,0,0,0,thoi-trang-nu
58255254,Combo 4 Quần Lót Nữ Lưng Cao Modal Phối Ren Active Miley Lingerie FDS0125-0225-0925-1225 - Giao màu ngẫu nhiên,425.0,1800171775863,328000,328000,0,0,104,thoi-trang-nu
54046230,Set Váy Ngủ Ren Áo Choàng Ngủ Sexy 3 Chi Tiết ,52.0,9278320990047,358000,358000,0,0,9,thoi-trang-nu
273369075,"Áo Thun Nữ Cao Cấp Premium Cotton Sure Fashion, Mềm mại, Thoả mái, Thoáng khí, Nhẹ tênh, Kháng khuẩn, An toàn cho làn da, Bạn sẽ cảm nhận rất rõ ràng khi mặc sản phẩm Organic 100% cotton này",10.0,6520918084101,149000,290000,141000,49,7,thoi-trang-nu
188134497,Miếng dán ngực sinh nhiệt tự thân Hàn Quốc - cơ chế tự dính khít khi tiếp xúc với bề mặt da có nhiệt,234.0,8426240737651,136000,136000,0,0,20,thoi-trang-nu
276931092,Combo 5 Quần Lót Thun Lạnh Trơn 4 Chiều Mềm Mịn Thoáng Khí MILEY LINGERIE ,77.0,8990066178433,395000,395000,0,0,3,thoi-trang-nu
263693409,Quần lót lọt khe Quần lót nữ chất liệu Cotton cao cấp mềm mịn,19.0,4612379949788,32000,32000,0,0,1,thoi-trang-nu
263045956,Đồ bơi nữ hai mảnh kín đáo đi biển có đệm ngực vải mềm mại phong cách thể thao,14.0,6278557826629,169000,169000,0,0,1,thoi-trang-nu
251305047,"Áo thun lá cờ Việt Nam, mã VN9. Áo thun cờ đỏ sao vàng, chất liệu vải thun lạnh 3D Cool-Tech cao cấp, thoáng mát, thấm hút mồ hôi. Hàng hiệu Goking",50.0,9786385293837,69000,69000,0,0,2,thoi-trang-nu
247467721,Áo Thun POLO Unisex Form Rộng - Brand Chính Hãng SDVN - HAPPY,9.0,8300289788106,160000,290000,130000,45,0,thoi-trang-nu
276900166,"Áo  ren 2 dây  - 4 khuy đệm mỏng , mềm cao cấp siêu thoáng mát và gợi cảm tôn vòng 1 thêm sexy thêm quyến rũ ",0.0,2838461487598,94050,99000,4950,5,0,thoi-trang-nu
134020411,Set Váy Ngủ Ren Áo Choàng Ngủ Sexy 3 Chi Tiết,82.0,7070212843013,229000,458000,229000,50,14,thoi-trang-nu
1752845,Bộ 10 Quần Lót Nữ Modal Miley Lingerie - Giao Màu Ngẫu Nhiên,1978.0,5888449236014,459000,459000,0,0,448,thoi-trang-nu
7965235,Bộ 8 quần lót nữ Modal Bikini Miley Lingerie - New Color,117.0,9607703714923,360000,360000,0,0,14,thoi-trang-nu
14257817,Combo 10 Quần Lót Nữ Modal Miley Lingerie New Color - Giao Màu Ngẫu Nhiên,1127.0,9741073502701,459000,790000,331000,42,270,thoi-trang-nu
244298467,ÁO LÓT NỮ KHÔNG GỌNG MỎNG TRƠN BELLE 151,11.0,9775144435445,80000,80000,0,0,2,thoi-trang-nu
198795306,"<BST Mới> Áo thun giữ nhiệt nữ dài tay cổ tròn Vicci vải Premium Cotton cao cấp co giãn, mềm mịn ôm dáng nhiều màu",18.0,2352904817517,135000,189000,54000,29,0,thoi-trang-nu
198350975,Đồ bộ ngủ nữ lụa 2 dây mặc nhà sexy quyến rũ vải satin cao cấp thoáng mát 4Lova,36.0,3398635626920,129000,129000,0,0,5,thoi-trang-nu
192628650,Quần lót nữ sexy,3.0,5152950156754,29000,29000,0,0,0,thoi-trang-nu
191298492,"Bộ 2 dây nữ, bộ đồ mặc nhà vải đũi mềm nhẹ, thoáng mát, nhiều màu size từ 40 - 75 kg, phong cách năng động dễ thương",15.0,7856107961633,160000,160000,0,0,0,thoi-trang-nu
58230363,Combo 2 Quần Lót Nữ Lưng Cao Modal Phối Ren Active Miley Lingerie Màu Da & Kem FDS0925-1425,101.0,3755926260782,164000,164000,0,0,16,thoi-trang-nu
24030500,Bộ 5 quần lót nữ basic Comfort Modal MILEY LINGERIE - Màu ngẫu nhiên,70.0,2997769008171,259000,396000,137000,35,9,thoi-trang-nu
101342997,Combo 5 Quần Lót Nữ Cotton Thiên Nhiên BeingMe Miley Lingerie - Màu Đen,18.0,9852705502430,325000,570000,245000,43,3,thoi-trang-nu
276900158,"Áo Bra ren nữ  2 dây hoa - 4 khuy đệm mỏng ,mềm cao cấp siêu thoáng mát và gợi cảm tôn vòng 1 thêm sexy thêm  quyến rũ ",1.0,9222066213781,94050,99000,4950,5,0,thoi-trang-nu
252657344,Áo thun Nữ croptop cổ tròn tay ngắn 7 màu cotton lạnh chất đẹp siêu co giãn chống bai xù,44.0,8909520009291,99000,99000,0,0,6,thoi-trang-nu
186268548,Quần lót nữ ren lọt khe Sexy hình bướm gợi cảm ôm dáng tạo đường cong quyến rũ,51.0,1253969526554,35000,35000,0,0,11,thoi-trang-nu
184822996,Áo Thun Trơn Vải Dày Andromeda Nhiều Màu Ngắn Tay Cổ Tròn Unisex,5.0,6348681521897,49000,49000,0,0,0,thoi-trang-nu
184816269,Áo Thun Có Cổ Cá Sấu Mè Thời Trang 24h Màu Xanh Ya Siêu Nhẹ Mát,6.0,9390851369707,87000,87000,0,0,0,thoi-trang-nu
183692692,Áo ngực bầu- Áo lót bầu và cho con bú mở cúc ngang tiện lợi A02,7.0,4074841531340,99000,99000,0,0,2,thoi-trang-nu
181247693,Quần Legging Nữ Dài Cạp Cao Đẹp Cao Cấp PINKAHA Nâng Mông Vải Thun Cotton Siêu Co Giãn 4 Chiều Ôm Sát,139.0,8156508924423,169000,185000,16000,9,18,thoi-trang-nu
177320879,"Miếng Dán Cố Định Quần Áo, Miếng Băng Dính 2 Mặt Thời Trang Cố Định Quần Áo, Dán Kín Khe Hở Ngực LYPK003",561.0,5284408876542,28000,28000,0,0,36,thoi-trang-nu
174379920,Áo Thun Cá Sấu Nữ Có Cổ - Cánh sen (45-75kg),3.0,2273025581404,96000,96000,0,0,0,thoi-trang-nu
165844516,"Combo 3 cặp dán ti, miếng dán ngực silicon siêu mềm, chắc chắn, sử dụng nhiều lần LYPK35-36",326.0,5000355147690,84000,84000,0,0,37,thoi-trang-nu
165212534,"Áo Lót Nữ, Áo Lót Đúc Su Đệm Dày Siêu Nâng Ngực Tạo Khe Quyến Rũ, Áo Ngực Su Bàn Tay Không Gọng Không Đường May Thương Hiệu BAW Mã ANM15",162.0,8191892883121,89000,89000,0,0,16,thoi-trang-nu
160819392,"Bồ đồ lót, Set nội y ren xuyên thấu, không gọng mỏng, nhẹ, thêu hoa đầy nữ tính và gợi cảm LYEB024",97.0,2567545061706,69000,69000,0,0,19,thoi-trang-nu
146222727,Áo polo nữ ADINO màu trắng phối viền xẻ lai vải cotton co giãn dáng slimfit trẻ trung APN02,161.0,4448253260959,149000,278000,129000,46,42,thoi-trang-nu
131907412,"Bộ 30 miếng(15 cặp) dán ngực vô hình, chống lộ ti, thoải mái, nhỏ gọn, tiện lợi LYPK",228.0,3349127546683,57000,57000,0,0,14,thoi-trang-nu
124239850,Áo hai dây sợi bún chất cotton có đệm nâng ngực - Áo 2 dây crotop đi biển,43.0,9979096320250,35000,35000,0,0,6,thoi-trang-nu
121258407,Áo polo nữ màu trắng phối viền chìm ADINO vải cotton polyester mềm dáng slimfit công sở hơi ôm trẻ trung APN03,264.0,1142932813170,159000,318000,159000,50,94,thoi-trang-nu
107540897,ĐẦM ELIZABET MẪU MỚI SANG CHẢNH CÓ HAI MÀU,42.0,9648387624750,165000,165000,0,0,8,thoi-trang-nu
106753082,"Áo Lót Nữ, Áo Lót Đúc Su Đệm Dày Siêu Nâng Ngực Tạo Khe Quyến Rũ, Áo Ngực Su Bàn Tay Không Gọng Không Đường May Thương Hiệu BAW Mã AN372",621.0,1959045333528,89000,89000,0,0,159,thoi-trang-nu
97790859,Quần Lót Nữ Cạp Cao Cotton Mỏng Kháng Khuẩn Co Giãn 4 Chiều P466,124.0,9492594849531,42000,42000,0,0,15,thoi-trang-nu
97606021,"Đồ Ngủ Hai Dây Lụa Satin Cao Cấp Sexy Quyến Rũ Thương Hiệu Baw, Chất Liệu Lụa Mát Mịn Nhẹ Nhàng Cực Kỳ Lôi Cuốn NT707 (hình thật shop tự chụp)",404.0,6805472935494,89000,89000,0,0,123,thoi-trang-nu
93225490,"(40-57kg) Đồ bộ kate thái đùi nữ. Đồ bộ đùi nữ kate thái. Đồ bộ pijama TNQN. Đồ bộ pizama TNQN. Đồ bộ pyjama TNQN. Đồ bộ mặc nhà nữ. Đồ bộ mặc ngủ nữ. Chất kate mịn, ko gây kích ứng da, chống nhăn, giữ màu tốt.",38.0,4653402295577,65000,65000,0,0,5,thoi-trang-nu
84822764, Quần Lót Cotton Dây Mảnh Thoáng Khí Siêu Mềm Mại P078,36.0,7877918093397,28000,28000,0,0,1,thoi-trang-nu
84484780,"Áo Ngực Ren Thái siêu đẹp có gọng không đệm, Áo Ngực Đệm Mỏng Tạo Khe Siêu Nâng Đỡ thương hiệu BAW mã AN17",13.0,1192237864247,69000,69000,0,0,3,thoi-trang-nu
76661889,Quần lót lọt khe nữ chuỗi hạt sexy,22.0,7258528024093,25000,25000,0,0,4,thoi-trang-nu
70816541,"COMBO 5 quần đùi nữ May 10, quần mặc nhà, quần ngủ",3511.0,9428616316949,135000,135000,0,0,1074,thoi-trang-nu
66089930,"Quần lót nữ WANNABE QLT02 quần chíp thun valise lạnh mát, tối giản, màu trơn, giá rẻ bao bền",70.0,8377137177298,39000,39000,0,0,8,thoi-trang-nu
57982432,Quần Lót Nữ Xuyên Thấu Co Dãn Siêu Mỏng - Quần Lót Nữ Không May Viền Thoáng Mát Không Lộ Viền Quần,616.0,2596634552018,25000,25000,0,0,77,thoi-trang-nu
49289747,"Ao lót nữ không gọng, không đệm nâng ngực Azuno Az2020",9.0,9536736444920,94000,94000,0,0,3,thoi-trang-nu
44248342,"Combo 10 quần lót nữ cao cấp, hàng đẹp loại tốt, co giãn đàn hồi tốt, không gây khó chịu khi mặc,đồ lót nữ phù hợp mọi lứa tuổi",3643.0,7768823036967,120000,120000,0,0,949,thoi-trang-nu
36904256,Bikini Hai Mảnh Đồ Bơi Tay Dài Che Nắng MHAT045 MayHomes Form Chuẩn Thun Bốn Chiều Co Giãn Tốt,595.0,6797238650735,259000,259000,0,0,165,thoi-trang-nu
31597593,"Siêu giảm giá. Áo thun nữ thoát nhiệt Nhật Bản Goking, form ôm eo, chất liệu tự nhiên 100% cotton thấm hút mồ hôi tốt. Áo phông trơn nữ hàng hiệu cao cấp",507.0,5090016747940,99000,99000,0,0,116,thoi-trang-nu
11339281,Combo 5 Quần Nữ Ren Ép Bông Miley Lingerie Lily Flower,422.0,9048514474161,249000,249000,0,0,130,thoi-trang-nu
276491587,Set Váy Ngủ 2 Dây Ren Dài Sexy Dễ Thương Freesize,7.0,9467847747970,378000,378000,0,0,0,thoi-trang-nu
277772763,Combo 5 quần lót nữ thun lạnh trơn big size Thái Lan 3259,2.0,8780973398181,185000,185000,0,0,0,thoi-trang-nu
273249438,[MUA 2 TẶNG 2] Pack 4 quần lót nữ siêu mỏng iBasic PA4PANW157,24.0,5085369048258,198000,396000,198000,50,5,thoi-trang-nu
273206254,Váy ngủ bodysuit ren cổ yếm xẻ đáy sexy gợi cảm Q530 - Đầm ngủ nữ bodysuit quyến rũ - Đồ ngủ nữ,16.0,7737839659476,120000,150000,30000,20,1,thoi-trang-nu
247820154, Miếng dán ngực chống mồ hôi ,325.0,4450429541882,136000,136000,0,0,25,thoi-trang-nu
199101108,Áo Blazer Linen Nữ Dài Tay 1 Lớp Mẫu Mới Phong Cách Hàn Quốc Áo Vest Blazer Nữ Khoác Ngoài Chất Linen Cao Cấp Haint Boutique Bz03,4.0,8197400872423,299000,299000,0,0,0,thoi-trang-nu
276314562,10 Miếng Dán Ngực Silicon - Miếng Dán Ti Tàng Hình có thể tái sử dụng - HENRYSA,13.0,7018007936775,65000,100000,35000,35,1,thoi-trang-nu
101423006,Combo 5 Quần Lót Nữ Cotton Thiên Nhiên BeingMe Miley Lingerie - Màu Xám Nhạt,8.0,1671862621962,325000,570000,245000,43,0,thoi-trang-nu
197894187,Miếng Dán Ngực Silicon Hộp 5 Cặp Miếng Dán Ngực Siêu Dính Tái Sử Dụng Nhiều Lần H02,261.0,1531262671471,65000,85000,20000,24,19,thoi-trang-nu
193920267,Áo Lót Dán Nâng Ngực Silicon - Áo Bra Dán Ngực Silicon Cài Trước Không Gọng Hình Bàn Tay,532.0,7564680796683,59000,65000,6000,9,48,thoi-trang-nu
185867063,Bộ quần áo ngắn cho mẹ Xanh golf đũi xước - AICDMEI3QI1X - AIN Closet,3.0,8426910505903,325000,415000,90000,22,2,thoi-trang-nu
183558599,"Đầm suông kẻ sọc cổ sơ mi Linen kèm đai thắt eo, chất vải linen tự nhiên, thời trang phong cách Hàn Da73",8.0,3550394060949,199000,199000,0,0,1,thoi-trang-nu
182841437,"Đồ ngủ bigsize nữ, Đồ ngủ sexy 2 dây ren nude không mút, chất phi mịn quyến rũ mã 400",12.0,9037140822675,61000,61000,0,0,4,thoi-trang-nu
162215179,Combo 10 Quần Lót Nữ Lưng Cao Modal Phối Ren Miley Lingerie FDS_25 - Giao màu ngẫu nhiên,31.0,1098197383921,609000,609000,0,0,8,thoi-trang-nu
180247331,"Đầm suông nữ Đũi Việt dáng dài 2 túi sườn, đầm form rộng cổ sơ mi phong cách cá tính thời trang thương hiệu chính hãng DV61",33.0,8477669578731,299000,299000,0,0,6,thoi-trang-nu
177272170,Đồ bộ nữ quần ống suông áo sơ mi 2 túi sang trọng,16.0,6687832118416,165000,165000,0,0,8,thoi-trang-nu
176534606,Chân Váy Xòe New Design Dáng Midi Dài Qua Gối Duyên dáng,26.0,6308063753255,199000,329000,130000,40,5,thoi-trang-nu
174249107,"Đầm maxi 2 dây dáng dài rộng chun ngưc, váy 2 dây đi biển bầu bí thoải mái",8.0,6501341939265,97000,97000,0,0,1,thoi-trang-nu
146230660,Áo polo nữ ADINO màu xanh đen phối viền xẻ lai vải cotton co giãn dáng slimfit trẻ trung APN02,104.0,3884237823503,149000,278000,129000,46,31,thoi-trang-nu
138533230,Áo dài xưa - Áo dài gấm may - lụa gấm cao cấp,9.0,2412710504182,1900000,1900000,0,0,1,thoi-trang-nu
124874229,Có size đến 85kg-Đồ bộ mặc ở nhà cho nữ quần dài co giãn thoáng mát,63.0,1380230788523,99000,99000,0,0,11,thoi-trang-nu
124489767,"Đầm ngủ, váy ngủ phi không mút 2 dây viền ren 2 bên sexy quyến rũ 834",51.0,2934873915627,56000,56000,0,0,16,thoi-trang-nu
124489754,"Đồ ngủ sexy nữ Đồ ngủ hai dây có mút ngực chất phi hai dây chất mịn quyến rũ, 5",47.0,8015266382580,80000,80000,0,0,12,thoi-trang-nu
121258680,Áo polo nữ màu hồng phối viền chìm ADINO vải cotton polyester mềm dáng slimfit công sở hơi ôm trẻ trung APN03,210.0,1211103910658,159000,318000,159000,50,71,thoi-trang-nu
118126647,sơ mi lụa trung niên cao cấp_áo trung niên tay phối họa tiết_áo sơ mi sang trọng thanh lịch mẫu mới cho bà cho mẹ,8.0,9290891034061,262000,262000,0,0,2,thoi-trang-nu
116577315,"Quần ống rộng nữ, quần culottes nữ chất đũi chun lưng cúc khóa dáng lỡ",81.0,2952342136308,65000,65000,0,0,20,thoi-trang-nu
116244653,"Quần ống rộng nữ,quần culottes nữ lưng cao khóa sườn vải tuyết mưa nhiều màu",63.0,5440855868379,89000,89000,0,0,23,thoi-trang-nu
107123520,Quần ống rộng nữ lửng kiểu hàn măc thoáng mát,158.0,1908959592409,53000,53000,0,0,48,thoi-trang-nu
106756612,"Áo Lót Nữ, Áo Lót Đúc Su Đệm Dày Siêu Nâng Ngực Tạo Khe Quyến Rũ, Áo Ngực Su Thương Hiệu BAW Mã AN373",412.0,7734343995745,89000,89000,0,0,58,thoi-trang-nu
104908173,chân váy A dáng dài xếp ly phối 3 khuy chất tuyết mưa ,70.0,1483878203035,115000,115000,0,0,31,thoi-trang-nu
103407058,quần ống suông lưng cao 1 khuy khóa trước chất tuyết mưa xinh xăn ,216.0,6236556999058,85000,85000,0,0,87,thoi-trang-nu
103026406,Quần nữ ống rộng lưng thun chất liệu đũi,27.0,8440480205015,129000,129000,0,0,7,thoi-trang-nu
84119398,"Quần lót giấy mặc 1 lần KACHOO, 5 cái/bịch,thoáng mát, tiện lợi khi đi du lịch hay những ngày ấy",317.0,2034271948556,25870,25870,0,0,16,thoi-trang-nu
74444966,"Áo Lót Nữ, Áo Bra Ren Su Đúc Azuno AZB85 Quai Bản To Mặc Mùa Hè Cực Mát, Thoải Mái",135.0,2249367479588,61000,61000,0,0,23,thoi-trang-nu
59180714,Quần lót lọt khe nữ buộc dây quyến rũ - Đen,186.0,8519506694764,29000,29000,0,0,37,thoi-trang-nu
54852797,Quần Short Thể Thao Nữ Lưng Cao Vải Dệt Cao Cấp,10.0,2667119722285,179000,179000,0,0,1,thoi-trang-nu
54009193,COMBO 5 QUẦN GẤM LƯNG CAO NHIỀU SIZE 6412,3.0,4514945528742,390000,390000,0,0,0,thoi-trang-nu
51407838,Đầm Suông Trung Niên Kiểu Đầm Suông BigSize In Hoa Lá Cột Eo GOTI 3205,317.0,4662409968983,298900,298900,0,0,94,thoi-trang-nu
44901035,"Đầm ngủ lụa WANNABE DN612 váy ngủ tối giản, 2 dây êm dịu thỏai mái, trẻ trung chăm sóc làn da, nâng niu giấc ngủ của bạn",48.0,3729695513547,370000,370000,0,0,5,thoi-trang-nu
44150035,Áo Ngực Nữ Không Gọng Full Ren Miley Lingerie,76.0,3546204441388,200000,200000,0,0,17,thoi-trang-nu
40939641,ÁO VEST BLAZER PHỐI SỌC,165.0,6919109190656,189000,189000,0,0,40,thoi-trang-nu
1921281,Áo Ngực Triumph D151 CS-VN - Da,468.0,1598149290455,283000,329000,46000,14,34,thoi-trang-nu
276547039,Combo 5 Quần Lót Flexi Stretch Chất Liệu Bamboo Visco - Miley Lingerie,1.0,2065893895209,325000,410000,85000,21,0,thoi-trang-nu
276497008,Áo len nữ Hàn Quốc dài tay cổ 3 phân mềm mại thời trang cao cấp freesize,1.0,6954019550063,199000,199000,0,0,1,thoi-trang-nu
274871279,"Combo 5 Quần Lót Nữ Su Đúc Trơn Sister Hood Thái Lan 604 – Siêu Mát, Siêu Ôm, Không Viền",1.0,5304751324751,160000,160000,0,0,0,thoi-trang-nu
271372945,Đồ trung niên Bộ phối Áo lụa Hàn Châu mềm mượt thoáng mát với quần Đũi vải dày dặn đủ size từ 45kg tới 65kg - Tuấn Tú Store 68,3.0,8767478776282,271000,271000,0,0,0,thoi-trang-nu
198436591,Đầm Midi Trắng Cổ Vuông Viền Ren Thanh Lịch Nữ Tính Tay Ngắn,25.0,2933660782359,320000,320000,0,0,5,thoi-trang-nu
198305160,Áo thun giữ nhiệt nữ tay dài cổ cao 5 phân Vicci vải premium cotton mềm mịn ôm dáng,36.0,3453942939421,135000,189000,54000,29,4,thoi-trang-nu
195915771,"Aó kiểu nữ - họa tiết thêu, chất đũi (SP18)",19.0,7462903436089,151000,151000,0,0,2,thoi-trang-nu
192222724,"Áo thun nữ cổ tim tay dài vải cotton đẹp, dễ mặc dễ phối đồ, mặc bốn mùa",33.0,4315905267606,129000,129000,0,0,5,thoi-trang-nu
191910410,đồ bộ pizama,0.0,1378538422436,140000,140000,0,0,0,thoi-trang-nu
190509291,"Áo lót nữ nâng ngực tạo khe, cúp ngang có gọng Triumph 695-025 đệm mút vừa giúp nâng và định hình ngực tối đa, dây vai có thể tháo rời",18.0,9174293355177,739000,859000,120000,14,2,thoi-trang-nu
189337830,COMBO 4 QUẦN MW COTTON CẠP CAO,2.0,1050568740135,156000,156000,0,0,1,thoi-trang-nu
182729631,"Đầm suông linen tay lỡ cổ phát V, chất vải linen tự nhiên mềm mát, thời trang cho phái nữ Da78",8.0,3764273460877,299000,299000,0,0,2,thoi-trang-nu
181991779,Quần short đũi nữ Đũi Việt DVQT20,1.0,9203375904638,99000,99000,0,0,1,thoi-trang-nu
176633187,"Combo 3 cặp dán ti, miếng dán ngực silicon siêu mềm, chắc chắn, sử dụng nhiều lần LYPK35-36 - Hình trái tim",13.0,4426584746245,84000,84000,0,0,0,thoi-trang-nu
176545246,"Đồ bơi nữ từ 35-60kg, chất polyester - Áo bơi tay dài cho bé phát triển bơi lâu mà không sợ lạnh",4.0,9963319112811,419000,419000,0,0,3,thoi-trang-nu
165211929,"Áo Lót Nữ, Áo Ngực Đúc Su Không Gọng Xuất Nhật đệm bàn tay thông hơi siêu nâng ngực, áo lót chống ung thư Thương Hiệu Baw mã AN039",292.0,6278729637226,89000,89000,0,0,61,thoi-trang-nu
141678914,Set 05 quần lót nữ BIG SIZE Thun cotton Cạp cao Hàng Việt Nam(Từ 60kg đến 90kg),10.0,7121488621565,109200,109200,0,0,3,thoi-trang-nu
140921150,"Đồ bộ mặc nhà,đồ bộ mặc nhà đẹp, đồ bộ mặc nhà cao cấp, chất đũi lạnh",2.0,4200615771469,150000,150000,0,0,0,thoi-trang-nu
132928231, CHÂN VÁY CARO XẾP LY NÚT,2.0,2793464972678,138000,138000,0,0,2,thoi-trang-nu
124239898,Váy babydoll hoa nhí tay bồng -Đầm nữ vintage dáng suông Hàn Quốc,7.0,9570772679300,227000,227000,0,0,2,thoi-trang-nu
109570274,Combo 2 Quần Boy Short Sợi Vải Thiên Nhiên Miley Lingerie - Màu ngẫu nhiên,10.0,6589073793487,139000,139000,0,0,2,thoi-trang-nu
101949563,Quần lót nữ JONES cotton  ren 002,565.0,9546377085709,12000,12000,0,0,59,thoi-trang-nu
101949408,Quần lót nữ Jones thun  lạnh ren 001,373.0,1707031843892,12900,12900,0,0,45,thoi-trang-nu
95508445,Đầm Hoa Bèo Lai Ngực Cột Nơ Tiểu Thơ,15.0,5734491039996,188100,188100,0,0,6,thoi-trang-nu
93311803,HOT HIT- Quần ống rộng giả váy lửng chất đũi,132.0,8615338905088,65000,65000,0,0,28,thoi-trang-nu
92145164,Đồ Bơi Nữ Hai Mảnh Kiểu Váy Tay Dài Dành Cho Cân Nặng 37Kg-50Kg AT216 MayHomes Chất Liệu Thun Poly,182.0,9592070677490,174840,188000,13160,7,35,thoi-trang-nu
91820251,"Áo ngực Enow's chính hãng cúp ngang, mút vừa",108.0,2758908780504,120000,120000,0,0,23,thoi-trang-nu
85399288, Quần Vải Nữ ️SALE️ Culottes Ống Suông siêu cao khóa trước 2 khuy chất tuyết mưa nhập khẩu cao cấp,43.0,9940425719927,86000,86000,0,0,22,thoi-trang-nu
84823781, Quần Lót Cotton Cạp Cao Full Mông Kháng Khuẩn P377,53.0,6950602847304,52000,52000,0,0,9,thoi-trang-nu
74360894,Quần Lót Nữ Modal Trơn Comfort Miley Lingerie BCS-04,178.0,6864458888245,65000,65000,0,0,22,thoi-trang-nu
55279177,Đồ Bơi Cặp Đồ Bơi Tay Dài Che Nắng Đi Biển AT172 MayHomes Long Sleeve Couple Swimsuits,542.0,1942399197666,285000,285000,0,0,153,thoi-trang-nu
53171377,Combo 4 Quần Lót Modal Phối Ren Bikini Miley Lingerie FCM0104_0204,9.0,6259457853705,188000,188000,0,0,0,thoi-trang-nu
52093685,đầm hoa nhí xoè hoạ tiết hoa yêu lắm duyên dáng dễ  thương,84.0,1434527944964,238000,238000,0,0,34,thoi-trang-nu
51714933,Áo Sơ Mi Nữ Tay Dài Công Sở,1.0,6024592270126,140000,140000,0,0,1,thoi-trang-nu
48094460,Áo sơ mi đũi nữ cổ V có túi Đũi Việt DVSM172,29.0,4808784630668,169000,169000,0,0,7,thoi-trang-nu
32380868,Áo len nữ trơn Freesize Haint Boutique Al31,26.0,1200620419872,161000,161000,0,0,10,thoi-trang-nu
30704368,quần tây nữ cao cấp hàng nhập,31.0,8656951052418,135000,135000,0,0,3,thoi-trang-nu
21125223,Áo Ngực Nữ Cotton Không Gọng Miley Lingerie BRW09015,82.0,9399551132041,200000,200000,0,0,19,thoi-trang-nu
10576055,Quần tây công sở_Q02,679.0,6015013413550,239000,239000,0,0,177,thoi-trang-nu
273886315,Áo cardigan len vặn thừng khuy to 4 màu dày dặn Freesize dưới 60kg,1.0,2761063340047,159000,159000,0,0,0,thoi-trang-nu
252207238,Combo 3 Quần Lót Cho Nữ Vải Sợi Thiên Nhiên Bamboo BigSize [XL-5XL] - FBS01,13.0,6520422008133,327000,327000,0,0,0,thoi-trang-nu
244298780,COMBO 5 QUẦN LÓT NỮ THUN LẠNH TRƠN BIG SIZE ANGELAVIC,3.0,5855962593206,135000,135000,0,0,0,thoi-trang-nu
210124707,Đầm dây hoa nhí Dubi Dress Gem Cloting SP060711,1.0,5518652887206,610000,610000,0,0,0,thoi-trang-nu
205710205,Áo khoác chống nắng nữ thông hơi tay dài xỏ ngón che kín tay mũ vành rộng chống nắng tốt,1.0,5177244384801,129000,129000,0,0,0,thoi-trang-nu
200520688,Áo polo nữ màu trắng phối viền ADINO vải polyester cotton không bai xù dáng công sở slimfit hơi ôm trẻ trung APN05,9.0,7527158263452,169000,338000,169000,50,2,thoi-trang-nu
199049134,"Áo ngực bra su học sinh BeeNa 2106 không gọng mút nhẹ, co giản thoải mái",2.0,8836031419614,95000,95000,0,0,0,thoi-trang-nu
198461239,Bộ Đồ Lót Nữ Ren Có Gọng Ren Mềm Hoa Văn Hồ Điệp Phong Cách Châu Âu S486,3.0,4263091253370,245000,245000,0,0,1,thoi-trang-nu
196205637,Sét Đồ Nữ Chất Liệu Đũi Siêu Mịn Mát Dành Cho Phụ Nữ Trung Tuổi và Cao Tuổi 2022 - Tuấn Tú Store,4.0,4539165706266,290000,290000,0,0,0,thoi-trang-nu
191740364,Dây áo ngực dây áo bra dây thay thế áo quây hay áo trễ vai nữ tính ngọc nhựa abs,2.0,7765732673854,145000,145000,0,0,1,thoi-trang-nu
187658098,"Áo Lót Nữ, Áo Ngực Dán Cài Trước, Áo Ngực Dán Cánh Tiên Đệm Thông Hơi Sexy Quyến Rũ Thương Hiệu Baw MS14",6.0,7273476946941,59000,59000,0,0,1,thoi-trang-nu
185977874,"Đầm suông linen cổ V thắt eo 2 màu,thời trang nữ phong cách trẻ trung Haint Boutique Hb72",3.0,3777291220857,299000,299000,0,0,1,thoi-trang-nu
182481410,"Áo sơ mi nữ tay lỡ cổ đức, họa tiết thêu hoa tinh tế, chất liệu Đũi mềm mát co giãn nhẹ, form đẹp NeSa Shop SMH.55",16.0,2357535226920,148000,289000,141000,49,5,thoi-trang-nu
176751923,Áo sơ mi công sở nữ viền ren sang trọng thanh lịch,3.0,5683234650225,149000,149000,0,0,0,thoi-trang-nu
167951497,Đồ ngủ bigsize/ Đồ ngủ gợi cảm sexy có mút ngực cột dây sau lưng mã 3,51.0,3011529243037,61000,61000,0,0,15,thoi-trang-nu
165205523,Quần lót nữ lọt khe QL2591 - Quần lót nữ sexy - Quần chíp nữ,8.0,3243790801039,29000,49000,20000,41,2,thoi-trang-nu
155883990,Đai gen ống nịt định hình đùi sau hút mỡ bắp đùi,8.0,1400516081649,520000,520000,0,0,2,thoi-trang-nu
146276974,Quần lót nâng mông thật tự nhiên Quần định hình nâng mông,35.0,6769736966912,120000,120000,0,0,2,thoi-trang-nu
134817893,set đồ nữ thu đông dài tay quần jogger in chữ COSMOS 3 màu,35.0,6787128808585,190000,190000,0,0,18,thoi-trang-nu
124489711,"Đồ ngủ sexy nữ Đồ ngủ 2 dây viền ren đen không mút, chất phi mịn quyến rũ 382",67.0,1673381176867,56000,56000,0,0,14,thoi-trang-nu
117177201,Bộ cotton sơ sinh bác sỹ dài hiệu - BBC27,19.0,2720437146452,75000,75000,0,0,8,thoi-trang-nu
113050911,Áo khoác nữ Áo khoát nữ kaki chống nắng CHAO KIOS đẹp cá tính hàng rất đẹp-A114,4.0,9213333440430,156450,156450,0,0,2,thoi-trang-nu
111041662,"Quần Lót Nữ, Bộ 3 Quần Lót Nữ Lụa Lạnh Cao Cấp Mềm Mịn Hàng Thương Gia, Quần Lót Nữ Kháng Khuẩn, Quần Lót Nữ Co Giãn Tốt Thương Hiệu Baw Mã QLN8812",5.0,5035096358570,129000,129000,0,0,0,thoi-trang-nu
109711702,Quần Lót Bầu Cạp Chéo Cotton Lụa Miley Nature Miley Lingerie PRC0200,10.0,1191377414007,125000,125000,0,0,0,thoi-trang-nu
103498666,quần ống rộng cúc khóa chun lưng kiểu nhật mềm mát,33.0,5633733108409,69000,69000,0,0,14,thoi-trang-nu
90642830,Quần tây nữ vải co giãn QT01,3.0,7033858510395,149000,149000,0,0,2,thoi-trang-nu
89597498, Quần Lót Lọt Khe Allmix Sport Cạp To Chất Cotton Tăm Thấm Hút Mồ Hôi P397,6.0,2185230027883,44000,44000,0,0,0,thoi-trang-nu
83757503,Bộ 10 Quần Lót Su không đường may thương hiệu BAW hàng loại 1  QLNTOP1,572.0,8097081333871,179000,179000,0,0,152,thoi-trang-nu
83685398,"Áó Giảm Béo Vùng Lưng, Vai, Bắp Tay Cho Bạn, Đai nit giảm mỡ vùng lưng, vai, bắp tay",2.0,6408553738721,175000,175000,0,0,1,thoi-trang-nu
82914882,"Quần Ngố Legging Nữ Màu Đen, Chất Liệu Co Dãn Thoải Mái - FORMENSHOP - FMHN006",67.0,6927450312109,19000,59000,40000,68,14,thoi-trang-nu
82129940,"Đồ bơi liền thân nữ cutout xanh rêu lạ mắt, bikini một mảnh sexy quyến rũ, hàng chuẩn chất đẹp | KT077",6.0,2572013450552,320000,320000,0,0,2,thoi-trang-nu
73722483,Áo ngực nữ cúp ngang Elegant Miley Lingerie BRM04002 - Màu đỏ đô,4.0,8397583731653,239000,239000,0,0,0,thoi-trang-nu
66095339,"Quần lót thun cotton Wannabe qlc02 đơn giản, dễ mặc",5.0,6909266937591,39000,39000,0,0,0,thoi-trang-nu
54443067, Bộ ĐồLót Ren Nữ Không Gọng Nâng Ngực Đệm Mỏng Azuno DL01  Phong Cách Sexy Dây Đôi Không Giãn Không Quăn Sau Khi Dùng Lâu,66.0,4236603744676,104000,104000,0,0,11,thoi-trang-nu
51018351,COMBO 3 QUẦN LƯNG CAO CAO CẤP 085,5.0,2240788369908,201000,201000,0,0,2,thoi-trang-nu
43993357,Quần lót nữ ren - tím,39.0,4815790066534,25000,25000,0,0,3,thoi-trang-nu
13781143,Áo khoác jean nữ Titishop NT78,4.0,6360506466064,199000,199000,0,0,1,thoi-trang-nu
13677629,Combo 4 quần short nữ hoạ tiết thổ cẩm Phúc An 3014,57.0,6634017871274,90000,90000,0,0,4,thoi-trang-nu
4153363,Áo khoác nữ cổ chui hoodie Phúc An,181.0,9816659748603,149000,149000,0,0,11,thoi-trang-nu
275835100,"Áo Sweater Unisex Logo Thương Hiệu Sure, Form Rộng Thiết Kế Sang Trọng, Chất liệu Nỉ Da Cá Dày Dặn",1.0,9549841360060,599000,599000,0,0,0,thoi-trang-nu
274604466,"Sét Đồ Bộ nữ chất thun thái M,L,XL mát lạnh ,mềm mịn không xù lông DB01 siêu sang 6 màu trẻ trung",3.0,7949147071637,179000,179000,0,0,0,thoi-trang-nu
208686285,"đồ nữ, đồ bộ nữ chất lụa",2.0,9464229381528,160000,160000,0,0,0,thoi-trang-nu
197541591,"Áo lót nữ đệm nước Triumph Maximizer 089 - 281 phối ren, cúp chéo có gọng giúp nâng đẩy và định hình ngực tối đa",7.0,1840454180379,615000,799000,184000,23,1,thoi-trang-nu
193886649,"Áo sơ mi nữ form rộng kiểu tay lỡ cổ tròn NeSa Shop, chất liệu Đũi tơ thấm hút mồ hôi, áo sơ mi nữ nhiều màu, SMH.034",8.0,7230137624414,139000,229000,90000,39,5,thoi-trang-nu
193370287,"đồ bộ mặc nhà cao cấp, chất kate hàn",15.0,6921427415158,180000,180000,0,0,3,thoi-trang-nu
192947717,Áo sơ mi nữ form rộng tay ngắn chuẩn form hàn quốc trẻ trung năng động vải lạu mềm mại ít nhăn-MURN02,3.0,7508171052847,95000,190000,95000,50,1,thoi-trang-nu
192934960,Áo sơ mi nữ tay ngắn form rộng trẻ trung sinh động vải lụa mềm mịn mát không nhăn-MURN01,4.0,1655046798658,95000,190000,95000,50,1,thoi-trang-nu
189737693,Quần Lót Lọt Khe Su Đúc Không Đường May Không Lộ Viền Gợi Cảm Quyến Rũ Sexy Q7,205.0,3487760728595,22000,22500,500,2,21,thoi-trang-nu
187021822,"Bộ đồ bơi, bikini tắm biển nữ kín đáo quần áo dài che nắng - B.38",18.0,3006209185492,299000,299000,0,0,4,thoi-trang-nu
185842762,ÁO DÁN NGỰC CÀI TRƯỚC HÌNH XOÀI SIÊU NÂNG NGỰC SIÊU DÍNH,1.0,6395652405952,19000,19000,0,0,0,thoi-trang-nu
183558713,"Đầm sơ mi nữ kẻ caro, Đầm đũi nữ ngắn tay, dáng dài phong cách công sở ARCTIC HUNTER AH73",2.0,2624422356479,199000,199000,0,0,0,thoi-trang-nu
182460262,Áo ngực học sinh không gọng cotton iBasic BRAT018,34.0,3802567199077,169000,199000,30000,15,0,thoi-trang-nu
178009345,đồ bộ mặc nhà,4.0,3338826643644,185625,185625,0,0,0,thoi-trang-nu
176293265,Bộ độ mặc nhà trung niên Tole (lanh) Vicci BGD.08 áo cộc tay phối quần dài lưng thun in họa tiết,23.0,4414159928818,170000,309000,139000,45,3,thoi-trang-nu
174379901,Áo Thun Cá Sấu Nữ Có Cổ - Đỏ Đô(45-75kg),3.0,2225008630596,96000,96000,0,0,0,thoi-trang-nu
174379852,Áo Thun Cá Sấu Nữ Có Cổ -Màu trắng(45-75kg),1.0,9293578400569,96000,96000,0,0,0,thoi-trang-nu
165193110,"Quần Ghen Định Hình, Quần Gen Nịt Bụng Dưới Su Pha Ren Có Móc Cài Và Size, Quần Ghen Cạp Cao Siêu Giảm Eo Và Mỡ Bụng Sau Sinh QG5",387.0,5362759166455,99000,99000,0,0,62,thoi-trang-nu
149980646,Hộp 10 Miếng Dán Ngực Silicon Siêu Mềm Dùng Được Nhiều Lần - Hàng Loại 1 - Chính Hãng MINIIN,37.0,9601747588262,45000,45000,0,0,7,thoi-trang-nu
141562440,"Váy len suông dài tay bo, đầm suông thun len gân dáng dài thu đông",74.0,2838689748524,105000,105000,0,0,43,thoi-trang-nu
116958995,"Áo Choàng Ngủ Phi Lụa Wannabe KI010 đơn giản, sang trọng",9.0,3455954375800,500000,500000,0,0,2,thoi-trang-nu
109594029,GOTI - ĐẦM XÒE DỰ TIỆC NỮ KIỂU ĐẦM XÒE DỰ TIỆC ĐÍNH HẠT BẸT - ĐẦM DỰ TIỆC CAO CẤP NỮ 3308 3321,30.0,8061049083449,286200,286200,0,0,13,thoi-trang-nu
101949389,Quần lót nữ ren JONES 006,18.0,7282488297532,15400,15400,0,0,1,thoi-trang-nu
92023043,Combo 5Quần lót nữ giúp nâng mông Mara vải lụa Pháp,8.0,2793720533367,110000,110000,0,0,3,thoi-trang-nu
84826692, Quần Lót Siêu Mềm Mịn Cao Cấp P041,27.0,1084342438192,60000,60000,0,0,3,thoi-trang-nu
83344765,Áo Nịt Ngực Không Viền Dây Kéo Trước Dành Cho Tomboy - Áo Lót Bó Ép Nịt Làm Nhỏ Ngực Tomboy Thể Thao Gym Thun Ba Lỗ Gen Thun Không Viền Dây Khóa Kéo Trước Bigsize Nguyễn Nguyên,2.0,4715868283276,208950,208950,0,0,1,thoi-trang-nu
82651316,"Đầm xòe cổ V sang trọng - nhiều size và màu, form dáng chuẩn thich hợp mặc đi làm, dạo phố hoặc dự tiệc",11.0,8705717385427,230000,230000,0,0,1,thoi-trang-nu
81187228,Áo Thun Trắng Ngắn Tay Cổ Tròn Đủ Size,74.0,5933992859129,49000,49000,0,0,6,thoi-trang-nu
78946352,Áo kiểu nữ cổ vuông xinh xắn,31.0,4850008546636,180000,180000,0,0,7,thoi-trang-nu
74439423,Quần Lót Nữ Lưng Cao Modal Phối Ren Active Miley Lingerie FDS-25,70.0,6569735119844,79000,79000,0,0,8,thoi-trang-nu
73510663,Quần lót nữ lọt khe ren xẻ đáy hạt ngọc - Đỏ,10.0,5795594931636,25000,25000,0,0,2,thoi-trang-nu
71311806,Gen Nịt Bụng Siêu Đốt Mỡ - Đai Nịt Bụng Sau Sinh Lấy Lại Vóc Dáng Nhanh Chóng,39.0,2427856431617,349000,350000,1000,0,10,thoi-trang-nu
66803444,Áo Cardigan Nữ Họa Tiết Xinh Thời Trang Korea ALN037 MayHomes Mẫu Mới Mùa Xuân,170.0,8884689884623,172050,185000,12950,7,51,thoi-trang-nu
66580038,Sét đồ bộ nữ quần da beo phối áo màu năng động,36.0,8223422547546,99000,99000,0,0,21,thoi-trang-nu
55023823,"Set Đồ Bơi 3 Mảnh Rực Rỡ Nắng Hè AT167 MayHomes Bộ Đồ Áo Bơi Nữ, Quần Bơi Nữ Và Váy Bơi Nữ",527.0,7274470204234,149460,159000,9540,6,114,thoi-trang-nu
54419407,COMBO 5 QUẦN REN VIỆT NAM SIÊU ĐẸP 042,3.0,8044980603433,134000,134000,0,0,2,thoi-trang-nu
52137723,Áo lót nữ nâng ngực không gọng cao cấp tạo khe quyến rũ dn20040534,22.0,5760261667880,179000,179000,0,0,3,thoi-trang-nu
36028190,Áo Len Nữ Cardigan Áo Khoác Len Kiểu Hàn Quốc Thêu Hoa ALN020 MayHomes Thời Trang Thu Đông,240.0,4340443446079,184140,198000,13860,7,54,thoi-trang-nu
3074923,Váy đầm lanh (tole) Vicci TVN004.7 vải xước họa  tiết hoa nền nâu ,7.0,1884163150029,149500,299000,149500,50,2,thoi-trang-nu
1921295,Áo Ngực Triumph D151 VV-VN - Da Sậm,508.0,3174099940503,283000,329000,46000,14,43,thoi-trang-nu
277811775,"Áo thun cờ đỏ sao vàng, trang phục biểu diễn, dành cho bé gái và bé trai, size đến 100kg, Amazing",4.0,5235455980755,51000,70000,19000,27,0,thoi-trang-nu
276628633,Áo sơ mi nữ form rộng 2N Unisex somi khoác ngoài caro xanh số 17,1.0,7717288351698,189000,250000,61000,24,0,thoi-trang-nu
275949851,Hộp 60 Miếng Dán Ngực Giấy Dùng 1 Lần Hình Hoa Siêu Bám Dính Thông Hơi Thoáng Mát 307,4.0,2025543199822,100000,100000,0,0,0,thoi-trang-nu
275520765,Váy ngủ bodysuit ren thắt nơ sexy Q64 - Bộ đồ ngủ liền thân bodysuit - Đầm ngủ bodysuit gợi cảm,10.0,3193196368542,99000,160000,61000,38,1,thoi-trang-nu
273789628,Áo len nữ form rộng dài tay dáng dài họa tiết sọc cổ tròn Hàn Quốc Freesize dưới 75kg,2.0,2240455932473,179000,179000,0,0,1,thoi-trang-nu
273220015,"Áo lót nữ mỏng, không đệm mút, không gọng Vicci AV.08 mềm mại, thoáng mát tạo cảm giác dễ chịu, thoải mái tuyệt đối, phù hợp cho người ngực to, bà bầu, phụ nữ trung niên",12.0,6995407061194,115000,189000,74000,39,1,thoi-trang-nu
253580279,"Áo hai dây nữ cổ đổ mặc trong vest chất vải lụa latin, thoáng mát khi mặc - New Design AO0013",15.0,8509330586717,139000,199000,60000,30,0,thoi-trang-nu
253400794,Đầm xoè thiết kế trung niên cao cấp sang trọng Cổ tròn kết hoa tay lỡ màu Đen TTV STORE TTV1253,1.0,3975427116676,515000,515000,0,0,0,thoi-trang-nu
250010204,Áo thun nữ MXM cổ tròn form rộng in gấu dễ thương thun cotton 4 chiều từ 45-60kg ( ANU082 ),6.0,8084852342099,95000,95000,0,0,0,thoi-trang-nu
249090800,Áo Lót Nữ Không Gọng Giấu Viền Chống Lộ Mỡ Lưng Làm Gọn Ngực Đệm Mỏng B539,8.0,3983805569193,195000,195000,0,0,2,thoi-trang-nu
245782329,Áo thun cổ tim nữ trơn tay ngắn KING Áo phông ngắn tay nữ V06,1.0,6069664019149,150000,150000,0,0,0,thoi-trang-nu
197427271,"Áo Lụa 2 Dây New Design  Kiểu Nữ Nhiều Size, Mặc  Mát Trong Vest Blazer Dễ Thương, Chất Satin Trơn Bóng ,Mịn AO0008",17.0,7982156955146,139000,199000,60000,30,3,thoi-trang-nu
195968448,Quần lọt khe Cotton cạp chéo ấn tượng sexy,1.0,9591742668679,55000,55000,0,0,0,thoi-trang-nu
185842527,Áo lót nữ CANLIN KEXIN đệm nầy siêu nâng ngưucj - Áo lót CK không gọng 106,13.0,3494887958730,65000,65000,0,0,0,thoi-trang-nu
174308384,Váy ngủ 2 dây lụa satin cổ V ren bèo cao cấp gợi cảm Q139 - Váy ngủ sexy - Đầm ngủ nữ - Đồ ngủ mạc nhà,8.0,7206989286195,139000,210000,71000,34,0,thoi-trang-nu
173632628,Đai nịt bụng VITA LATEX cải tiến ĐẶC 15 xương,40.0,8415310539478,380000,380000,0,0,11,thoi-trang-nu
164250229,Áo lót nâng ngực nữ bra quây ren cao cấp LUPERI SP852 bản 3 móc kèm 1 dây ngang,4.0,5835968528204,345000,345000,0,0,0,thoi-trang-nu
150924079,Áo dài voan tơ,15.0,4426760220004,2900000,2900000,0,0,4,thoi-trang-nu
138755770,"Áo thun nữ cổ tim tay dài , áo thun trơn cotton đẹp, dễ mặc dễ phối đồ, mặc bốn mùa",13.0,3277766800883,129000,129000,0,0,1,thoi-trang-nu
128302215,Bộ đồ ngủ 2 dây chất phi bóng mềm mịn có mút ngực viền ren hai bên mã 5,72.0,5963264731533,58000,58000,0,0,27,thoi-trang-nu
124490062,"Đồ ngủ sexy nữ Đồ ngủ 2 dây ren nude không mút, chất phi mịn quyến rũ 400",108.0,4424640711900,56000,56000,0,0,37,thoi-trang-nu
116206931,"Quần ống rộng nữ,quần ống suông nữ lưng cao dáng dài 1 khuy chất tuyết mưa dày dặn",120.0,4617429660097,85000,85000,0,0,41,thoi-trang-nu
113332193,"váy suông nữ ,đầm suông nữ sát nách dáng dài chất đũi 3 màu xinh xắn",107.0,4377701297375,80000,80000,0,0,38,thoi-trang-nu
107393162,"Bộ Đồ Pijama Nữ Mặc Nhà, Quần Áo Ngủ Nữ Ngắn Tay Azuno BN196 Chất Liệu Cotton Lụa Cho Mùa Hè ",65.0,6758534830592,275000,275000,0,0,27,thoi-trang-nu
107155666,Quần lót nữ ren dây chéo ôm mông,2.0,1320391296224,19000,19000,0,0,0,thoi-trang-nu
103797449,Quần Lót Chống Tràn Nguyệt San Trơn Cotton Thoáng Khí Cạp Vừa P471,134.0,2274043655772,42000,42000,0,0,15,thoi-trang-nu
103358724,Quần chíp sexy - Quần lót lọt khe nữ sexy - Quần lót nữ lọt khe xẻ dáy,20.0,2882199080470,30000,30000,0,0,1,thoi-trang-nu
102099787,Quần Jeans nữ rủ Lưng Thun-JGIAYDAI,62.0,2380433834817,179000,179000,0,0,16,thoi-trang-nu
94081677, Quần Lửng Ống Rộng vải đũi- Giả váy,33.0,8368356186767,70000,70000,0,0,9,thoi-trang-nu
87534240,"Bikini dài tay, đồ bơi nữ dáng thể thao dài tay, quần đùi sooc khỏe khoắn",165.0,6745462410230,269000,269000,0,0,39,thoi-trang-nu
83345441,Bản Nịt Ngực Tomboy Ngang 15cm Không Viền Gen Thun Khóa Cài Hông Thể Thao Định Hình Cố Định Vòng 1 Bigsize Nguyễn Nguyên,7.0,3196016091087,93450,93450,0,0,1,thoi-trang-nu
82874281,Áo Ngực Đúc Su Không Gọng Xuất Nhật đệm mỏng chống ung thư Thương Hiệu Baw mã AN03,529.0,8612673690005,69000,69000,0,0,107,thoi-trang-nu
81186470,Áo Thun Xanh Ngọc Vải Dày Đủ Size,2.0,6207267214710,27000,27000,0,0,0,thoi-trang-nu
73528213,Áo Lót Mút Dày Siêu Nâng Ngực Màu Trơn Basic Doomm Doomm By Sabina SBA7998,185.0,7422581658402,579000,579000,0,0,36,thoi-trang-nu
68939197,Áo Thu Trắng Đủ Size Cho Mọi Lứa Tuổi,24.0,5739591406636,37000,37000,0,0,2,thoi-trang-nu
68628797,Combo 10 Quần Lót Nữ Modal Phối Ren Trước Remix - Giao Màu Ngẫu Nhiên FCM04,160.0,4258752426845,450000,450000,0,0,63,thoi-trang-nu
51544288,ÁO KHOÁC JEAN 2 MÀU TAY DÀI ( dưới 65kg ) damsuong119,4.0,1467328098765,199000,199000,0,0,2,thoi-trang-nu
50377280, Quần lót nữ ren,87.0,2138795907827,29000,29000,0,0,12,thoi-trang-nu
44105325,Áo len nữ thời trang phong cách Châu Âu,9.0,1426829312831,169000,169000,0,0,2,thoi-trang-nu
15445748,Áo ngực Bra toàn ren sexy 2 dây mút rời BREN01 (đen),2.0,2202317130366,84000,84000,0,0,0,thoi-trang-nu
276045003,QUẦN JOGGER NỮ VẢI DÙ CAO CẤP NHIỀU MÀU ĐA NĂNG,3.0,6391909399585,199000,199000,0,0,1,thoi-trang-nu
275276504,Đồ Bơi Nữ Hai Mảnh Đa Năng Gồm Áo Bơi Nữ Và Váy Bơi Nữ,11.0,8470128621999,219000,219000,0,0,1,thoi-trang-nu
272222584,Áo Lót Nữ Không Gọng Đệm Mỏng Chất Modal Mềm Mại Thoáng Khí Cao Cấp B020,4.0,3089248586132,195000,195000,0,0,1,thoi-trang-nu
271128220,"Áo lót nữ nâng ngực trơn, mỏng, có gọng Vicci AV.06 (phiên bản nâng cấp của AV.04) cúp chéo, dây vai có thể tháo rời, mềm mại, thoải mái tuyệt đối",33.0,6169231093365,115000,198000,83000,42,3,thoi-trang-nu
252657874,Áo thun Nữ croptop cổ tròn tay ngắn 7 màu cotton lạnh chất đẹp siêu co giãn chống bai xù,58.0,1228040075689,79000,79000,0,0,9,thoi-trang-nu
244298027,COMBO 5 QUẦN LÓT NỮ REN SPRING 5402,7.0,9036333256375,170000,170000,0,0,2,thoi-trang-nu
204644849,Hộp 60 Miếng Dán Ngực Giấy Dùng 1 Lần Hình Hoa Siêu Bám Dính Thông Hơi Thoáng Mát 307,276.0,3332088076020,55000,75000,20000,27,21,thoi-trang-nu
199169223,Aó gen định hình bắp tay sau hút mỡ bắp tay cố định ngực sau phẩu thuật nâng ngực treo sa trễ,15.0,6252273407653,395000,395000,0,0,1,thoi-trang-nu
192934185,"Đồ Bộ Nữ New Design Chất Lụa Satin Mịn  Mặc Mát  Nhiều Màu, Freesize (40 - 65kg) Quần Đùi Áo Hai Dây CB0001",14.0,4187702355132,159000,249000,90000,36,6,thoi-trang-nu
192224123,"Áo thun nữ cổ tim tay dài vải cotton đẹp, dễ mặc dễ phối đồ, mặc bốn mùa",26.0,8352812571665,99000,99000,0,0,7,thoi-trang-nu
185005658,Áo lá học sinh cấp 1 cấp 2 cao cấp áo ngực trẻ em tuổi mới lớn dậy thì chất cotton mềm mại thoáng mát Lá Bralette A23,13.0,6534371172070,39000,39000,0,0,0,thoi-trang-nu
181991402,Áo sơ mi nữ Đũi Việt thiết kế cổ V thời trang ALE12,7.0,5960016959374,159000,159000,0,0,1,thoi-trang-nu
152494664,Áo thun Teeworld Saigonese Cô Ba Version 2 Form Rộng Nam Nữ Unisex,81.0,5618123720725,299000,299000,0,0,21,thoi-trang-nu
147043717,"váy len suông dài tay bo tay,đầm suông nữ len gân dáng dài thu đông 3 màu cá tính",86.0,1886580081039,85000,85000,0,0,29,thoi-trang-nu
146228143,Áo polo nữ ADINO màu vàng phối viền xẻ lai vải cotton co giãn dáng slimfit trẻ trung APN02,128.0,9789246422919,149000,278000,129000,46,44,thoi-trang-nu
145290025,"Chân Váy Công Sở New Design Thiết Kế Dáng Váy chữ A, Dài Qua Gối , Tôn Dáng Sang Trọng, Vải Tốt co Giãn CV0053",17.0,5311080446324,169000,299000,130000,43,3,thoi-trang-nu
138755296,"Áo Thun Nữ Cổ Tim Tay ngắn , Trẻ Trung, Mẫu Mới nhất",129.0,2575011896584,79000,79000,0,0,30,thoi-trang-nu
138749319,"Áo Thun Nữ Cổ Tim Tay ngắn , Trẻ Trung, Mẫu Mới nhất",7.0,2480835872060,99000,99000,0,0,0,thoi-trang-nu
134381185,"bộ nữ chất liệu đũi, full size từ 35kg đến 95kg (T43)",5.0,1053498088922,186000,186000,0,0,0,thoi-trang-nu
124874010,Đồ bộ nữ mặc ở nhà bộ lửng co giãn thoáng mát,34.0,8384914922086,88000,88000,0,0,12,thoi-trang-nu
118126502,Bộ đồ lửng thun lạnh trung niên nữ cao cấp_ bộ đồ nữ mặc nhà,38.0,1150914802959,158000,158000,0,0,10,thoi-trang-nu
117573855,"set đồ nữ chất đũi,bộ đồ nữ hè áo yếm quần đùi chât đũi xinh xắn",48.0,5996416456799,99000,99000,0,0,21,thoi-trang-nu
116574971,"Quần sooc nữ,quần đùi nữ ống rộng chun lưng khóa trước chất kaki nhiều màu",30.0,1462629013400,65000,65000,0,0,12,thoi-trang-nu
113543251,GOTI - ÁO KIỂU TRUNG NIÊN GIẤU BỤNG BIGSIZE DẠNG ÁO SƠ MI TRUNG NIÊN NỮ  ĐÍNH NÚT CHO MẸ U50 U60 CHO NGƯỜI MẬP 3A01 ,52.0,7676774778472,179000,179000,0,0,15,thoi-trang-nu
112193938,áo sơ mi nữ dài tay vạt tôm chất đũi nhiều màu,162.0,1961893894743,89000,89000,0,0,70,thoi-trang-nu
110872343,"quần ống rộng nữ, quần ống suông G..U chất đũi 3 màu",38.0,1110281536338,65000,65000,0,0,10,thoi-trang-nu
106765137,Áo Ngực Đúc Su Không Gọng Xuất Nhật đệm mỏng chống ung thư Thương Hiệu Baw mã AN031,1523.0,3507696035394,89000,89000,0,0,357,thoi-trang-nu
104793592,"Áo lót Bra vải cotton Thái Lan vải  B.1134 – Form Cup A, không gọng",35.0,3353343636127,65000,65000,0,0,6,thoi-trang-nu
87616279,Áo Lót Không Gọng Mút Dày Siêu Nâng Ngực Màu Trơn Habpy Lady By Sabina HBXLP0005,50.0,9481416149237,383000,383000,0,0,10,thoi-trang-nu
84822657, Quần Mặc Trong Váy Dáng Dài Cạp Cao Gen Bụng Thon Đùi Cao Cấp D379,91.0,4668722283637,92000,92000,0,0,14,thoi-trang-nu
84077317,"Đồ bơi áo tắm cho người trung tuổi, dáng váy quần sooc đùi dài, tôn dáng tránh lộ bụng, bikini trung niên cho mẹ cho bà size lớn | KT007",28.0,6613228216288,350000,350000,0,0,7,thoi-trang-nu
82700848,Bộ 5 Quần Lót Cotton 365 không hăn chống HPV 10 màu big size đến 65kg cạp vừa thương hiệu Baw QLN17,1299.0,3922407678986,109000,109000,0,0,264,thoi-trang-nu
82700777,"Bộ 5 Quần lót nữ O2 Cotton Ép Không Đường May, chất liệu thoáng mát thương hiệu BAW QLN14",1731.0,9744058230229,149000,149000,0,0,333,thoi-trang-nu
82642292,Áo Sơ Mi Nữ Dài Tay Công Sở Thời Trang PONIVA,54.0,2629279834687,105000,105000,0,0,11,thoi-trang-nu
73837718,Áo thun nữ cổ tròn form rộng thun cotton 4 chiều phong cách Hàn Quốc in chữ ( ANU018 ),90.0,6925876879878,95000,95000,0,0,37,thoi-trang-nu
67151410,Áo Sơ Mi Nữ Ngắn Tay Công Sở Phối Viền Màu Đẹp,54.0,7456891053312,105000,105000,0,0,28,thoi-trang-nu
56029352,Đồ bộ mặc nhà quần dài áo in chữ chất liệu cotton thoáng mát,13.0,7756182071378,99000,99000,0,0,5,thoi-trang-nu
36574256,"1 Quần tây công sở ống suông rộng, ống đứng, dạng cullotes sang trọng, nữ tính",86.0,7630195743173,280000,280000,0,0,25,thoi-trang-nu
277425337,Áo ba lỗ nữ có mút đúc cố định chống hở ngực chất thun lạnh thoáng khí vô cùng thoải mái,3.0,5663141286630,155000,155000,0,0,2,thoi-trang-nu
276329236,"Áo sơ mi nữ form rộng sát nách, chất liệu mềm mát, áo kiểu nữ, form trẻ trung, năng động NeSa Shop SMT03",3.0,3276064587010,91000,179000,88000,49,1,thoi-trang-nu
273719507,Không Lo Mất Điện: Giải Pháp Nguồn Pin Dự Phòng 5V-12V - 2A Cho Modem Wifi và Camera Chất Lượng,2.0,5548904583044,255000,255000,0,0,0,thoi-trang-nu
271138640,Đồ Bộ Đũi Trung Niên Chất Liệu Đũi Cao Cấp Cho Mẹ Và Bà Mặc Đi Tiệc Đi Chơi - Tuấn Tú Store 68,8.0,5222405792436,279000,279000,0,0,1,thoi-trang-nu
252131124,"Dây áo ngực, áo lót trong suốt- Hàng Chính Hãng",876.0,7455475652198,20900,22000,1100,5,7,thoi-trang-nu
248783911,Quần Ống Rộng Nữ Chất Liệu Đũi Hoa Thêu Tinh Xảo Trẻ Trung 2023 - Tuấn Tú Store 68,2.0,4104252808943,191000,191000,0,0,2,thoi-trang-nu
243012243,"Đồ bơi nữ kín đáo hai mảnh đi biển che bụng, Bikini nữ vải thun mềm mại co giãn 4 chiều",46.0,8581026004442,159000,159000,0,0,6,thoi-trang-nu
243008318,Combo 10 Quần Lót Nữ Modal Bigsize [2XL-5XL] - BCS04,4.0,8686585370035,830000,830000,0,0,1,thoi-trang-nu
225238987,Chân Váy Xếp Ly HQJeans Tennis Skirt Chữ A Dáng Ngắn Thiết kế Xếp Ly Đẹp Chuẩn HQJ99,2.0,1615626199839,305000,305000,0,0,2,thoi-trang-nu
217176713,Áo thun tay lỡ form rộng - phông nam nữ cotton oversize - T shirt Trái tim - 2N Unisex,27.0,5938297832857,99000,125000,26000,21,6,thoi-trang-nu
198352364,"Quần đùi nữ mặc nhà lụa satin cao cấp 4LOVA mềm mại, quyến rũ",68.0,3549077335284,39000,39000,0,0,11,thoi-trang-nu
194456357,Váy đầm xòe dự tiệc cưới cổ cách điệu tay phồng bigsize sang trọng mẫu mới siêu hot giá rẻ,6.0,2593771848102,149000,149000,0,0,2,thoi-trang-nu
192303246,Quần Độn Mông Hông Thông Hơi Cao Cấp Không Viền Mặc Váy Áo Dài 2 Màu Da Đen Đúc Su Hàng Loại 1,81.0,2973350261249,99000,165000,66000,40,15,thoi-trang-nu
185842799,Đai Gen Nịt Bụng Thông Hơi chống cuộn - Nịt Bụng Giảm Mỡ Sau Sinh MAIKA,9.0,7360722445858,35000,35000,0,0,1,thoi-trang-nu
177895515,Bộ đồ lót ren ôm ngực tôn dáng không gọng kèm quần lót nữ cao cấp Q463 - Bộ lót nữ sexy - Đồ lót nữ - Bộ lót áo ngực kèm quần chip nữ,6.0,2953954857838,169000,280000,111000,40,3,thoi-trang-nu
168850401,Váy ngủ hai dây ren mỏng sexy Q36 - Đầm ngủ nữ xuyên thấu - Đồ ngủ mặc nhà,7.0,2816190397036,119000,160000,41000,26,0,thoi-trang-nu
166533565,"Quần Độn Mông Nữ, Quần Độn Mông Lưng Ren Thông Hơi Siêu Thoáng Mát Mềm Mại Thương Hiệu Baw DM01",127.0,1535145849187,99000,99000,0,0,19,thoi-trang-nu
121245657,Áo polo nữ màu đen phối viền chìm ADINO vải cotton polyester mềm dáng slimfit công sở hơi ôm trẻ trung APN03,79.0,1316293455940,159000,318000,159000,50,27,thoi-trang-nu
118126172,Bộ đồ mặc nhà trung niên nữ _ Bộ đồ thun lạnh mềm mịn_Bộ đồ cho mẹ mẫu mới,24.0,2367417567859,104000,104000,0,0,1,thoi-trang-nu
114463297,"Quần lót ren cao cấp T-back Wannabe QLR01 gợi cảm, quyến rũ",7.0,2752087593303,126000,126000,0,0,1,thoi-trang-nu
109698272,Quần lót nữ cotton mặc váy iBasic V107,262.0,8775396525687,69000,69000,0,0,24,thoi-trang-nu
94902348,"Áo cổ nữ cổ V sang chảnh - nhiều size và màu, form dáng chuẩn thích hợp mặc đi làm, dự tiệc",17.0,6826655929657,148000,148000,0,0,6,thoi-trang-nu
93100635,ÁO LÁ HỌC SINH COTTON TĂM 2 LỚP MÚT MỎNG 007,159.0,3672499570361,38000,38000,0,0,27,thoi-trang-nu
84824958, Áo Lót Bralette Cotton Mỏng Có Đệm Lót B308,15.0,3078993085282,65000,65000,0,0,2,thoi-trang-nu
84487723,Áo Ngực Bra 3 dây cotton có đệm mặc thoáng mát thương hiêu BAW mã AN18,198.0,1225373351531,49000,49000,0,0,29,thoi-trang-nu
73732192,Áo Ngực Nữ Thể Thao Kèm Mút Ngực Melange Active Miley Lingerie BRM-053,49.0,5196944585149,269000,269000,0,0,8,thoi-trang-nu
72556311,Áo Ngực Nữ Không Gọng Cotton Lụa Flexi Miley Lingerie BRC,54.0,4908723826852,249000,249000,0,0,13,thoi-trang-nu
68969343,Quần Lót Nữ - 5 Quần Thun Lạnh Dãn 4 Chiều Thông Hơi - giao màu ngẫu nhiên,10.0,4892171528591,105000,105000,0,0,3,thoi-trang-nu
68940444,Áo Thun 3 Lỗ Sát Nách Thun Lạnh Nam Nữ,102.0,6017907262060,62000,62000,0,0,23,thoi-trang-nu
58686358,Áo len nữ dệt kim phối màu thời trang ALN07,64.0,8702445853655,149000,149000,0,0,15,thoi-trang-nu
55959625,"Áo ren lưới đi biển thời trang, mặc ngoài bikini, croptop, dáng lửng tay lỡ xinh xắn, mẫu cao cấp mới 2020 | AR003",7.0,1865751014831,240000,240000,0,0,0,thoi-trang-nu
55458645,Áo ngực UNQ001 không gọng siêu nhẹ Nhật Bản,27.0,7654389333179,479000,479000,0,0,6,thoi-trang-nu
50004697,Bộ đồ liền thân hình thú Cá Sấu (Khủng long) xanh,17.0,3016006183538,239000,239000,0,0,6,thoi-trang-nu
44014260,Quần lót lọt khe - Màu mận,32.0,6814918514351,25000,25000,0,0,3,thoi-trang-nu
39305969,[Video SP Thật] Combo 5 Chiếc Quần Lót Nữ Lọt Khe Su Đúc Không Đường May Mịn Mát Sexy (Freesize 55kg),8.0,3656847822588,125000,125000,0,0,1,thoi-trang-nu
21029987,Quần jean thun nữ ,45.0,1539527414872,330000,330000,0,0,8,thoi-trang-nu
12710511,Quần Legging Vicci Cao Cấp Màu Đen Vân Xước Cạp Cao 11P,5.0,2188380272489,224500,449000,224500,50,0,thoi-trang-nu
11447496,"Sơ mi nữ vải đũi, tay dài có túi Haint Boutique S172",56.0,8821002593466,159000,159000,0,0,16,thoi-trang-nu
9670279,Áo Khoác Nữ 4 Túi Dây Kéo Phúc An 4045,375.0,6991780846527,190000,190000,0,0,58,thoi-trang-nu
276497369,"Quần đũi nữ ống suoong, dài chất liệu thoải mái, dễ mặc mẫu mới",3.0,2576471247126,260000,260000,0,0,1,thoi-trang-nu
275470328,COMBO 3 ÁO LÁ DÀI THUN LỤA ANGELAVIC,6.0,1397394278160,84000,84000,0,0,0,thoi-trang-nu
275276208,Đồ bơi nữ kiểu váy liền thân bikini 1 mảnh tôn dáng che khuyết điểm có sẵn mút ngực quần đùi,6.0,9989286298053,219000,219000,0,0,1,thoi-trang-nu
254411370,"Áo bra dây mảnh cài trước mút mỏng, áo ngực nữ mút mỏng cực kỳ gợi cảm quyến rũ bra2099",3.0,4867481660751,27000,27000,0,0,0,thoi-trang-nu
194498328,"Váy len body chiết eo, Đầm xinh dáng ôm chất liệu len dệt kim cao cấp- VL01",3.0,2052957011218,289000,289000,0,0,1,thoi-trang-nu
192781082,YU CHERRY | Đầm Ruffle Neck Tank Dress YD147,2.0,8881481273289,474000,474000,0,0,0,thoi-trang-nu
191412217,Dây áo lót dây cài áo bra hạt cườm và ngọc trai nhiều loại siêu sang chảnh hot girl,5.0,3193564775733,126000,126000,0,0,0,thoi-trang-nu
187315703,Áo sơ mi nữ tay dài form rộng trơn trẻ trung nặng động vải lụa mềm mịn-MUD03,42.0,3084660755007,105000,210000,105000,50,8,thoi-trang-nu
183560785,"Đầm sơ mi linen nữ form suông, dáng dài phong cách vitage ARCTIC HUNTER AH75",34.0,6980726903254,249000,249000,0,0,9,thoi-trang-nu
180924959,Bộ đồ mặc nhà nữ lanh (tole) Vicci BN10 thiết kế tay ngắn xẻ cách điệu phối quần lửng in họa tiết,43.0,4586233110924,135000,269000,134000,50,11,thoi-trang-nu
174897065,Váy ngủ lụa cổ V đan dây hông cao cấp Q407 - Đầm ngủ 2 dây sexy gợi cảm - Đồ ngủ lụa quyến rủ - Đồ ngủ mạc nhà,14.0,1928918645231,129000,190000,61000,32,3,thoi-trang-nu
174843854,Áo thun Teeworld Saigon Traffic T-shirt Trắng Đen Form Rộng Unisex Nam Nữ,63.0,1580160274827,339000,339000,0,0,26,thoi-trang-nu
152892550,Áo hai dây gân tăm kiểu dây sợi bún có mút đệm vải cotton - Áo 2 dây siêu co dãn ôm sát cơ thể mix đồ siêu chất,6.0,6016253955601,59000,59000,0,0,0,thoi-trang-nu
146225246,Áo polo nữ ADINO màu đen phối viền xẻ lai vải cotton co giãn dáng slimfit trẻ trung APN02,54.0,4195972339693,149000,278000,129000,46,12,thoi-trang-nu
144191819,"Áo lót nữ cotton không gọng đệm mỏng cao cấp, áo bra nữ sinh chất mềm mại thoáng mát",20.0,5291063671785,69000,69000,0,0,2,thoi-trang-nu
138148914,"Áo sơ mi nữ dài tay trắng đi học, đi làm cổ bẻ form rộng vừa, bo nhún cổ tay vải lụa mềm mát",45.0,2070006967995,72000,72000,0,0,23,thoi-trang-nu
131998845,"Áo giữ nhiệt nữ, áo thun dài tay thu đông cho nữ cổ cao kiểu hàn",39.0,9756542969439,39000,39000,0,0,16,thoi-trang-nu
117762251,"quần ống rộng nữ ,quần ống rộng culottes dáng dài khóa sườn chất vải co giãn",51.0,5930918419237,85000,85000,0,0,4,thoi-trang-nu
112979400, Áo Lót Không Gọng Đệm Mỏng Chống Hằn Chống Lộ Mỡ Lưng Định Hình Ngực Cao Cấp B049,12.0,1384251356618,202000,202000,0,0,0,thoi-trang-nu
110801615,"Đầm dự tiệc bo eo cánh dơi sang trọng - nhiều size, form dáng chuẩn thích hợp mặc đi làm, đi tiệc",31.0,2302602593874,250000,250000,0,0,9,thoi-trang-nu
110138146,Quần lót nữ Cotton Never thoáng mát tôn dáng,55.0,1415304870890,9000,9000,0,0,0,thoi-trang-nu
107154707,Quần lót ren nữ xuyên thấu gợi cảm,57.0,2615597948464,25000,25000,0,0,10,thoi-trang-nu
101049275,Quần tây nữ baggy Titishop QDN174,2.0,9086059737967,249000,249000,0,0,1,thoi-trang-nu
98807520,"Áo phông ngắn tay, áo thun nữ cộc tay Vicci AP.01.6 chất liệu cotton vân gỗ in hoạ kẻ",95.0,2384889490549,84000,168000,84000,50,27,thoi-trang-nu
93238464,"Quần ống rộng giả váy thời trang 2021 - nhiều size, form dáng chuẩn thích hợp mặc đi làm, dạo phố hoặc du lịch",31.0,9990122315589,199000,199000,0,0,10,thoi-trang-nu
90655330,Quần lót G-String Sexy đẹp xuyên thấu,16.0,5897533542652,29000,29000,0,0,1,thoi-trang-nu
84819925,Quần Lót Cạp Cao Ren Mềm Không Lộ Viền Cao Cấp P361,20.0,6762068033654,91000,91000,0,0,6,thoi-trang-nu
78629416,Áo kiểu peplum cổ tim phối nơ sang trọng thích hợp mặc đi làm hoặc dạo phố,55.0,4730065896556,180000,180000,0,0,14,thoi-trang-nu
76474236,Đầm xòe cổ tim họa tiết độc lạ sang trọng đủ size từ 38-71kg,5.0,9993784662049,149000,149000,0,0,2,thoi-trang-nu
74421965,Áo Lót Không Gọng Mút Đệm Vừa Thời Trang Pretty Perfect By Sabina SBU8510,131.0,1304210103063,609000,609000,0,0,37,thoi-trang-nu
73588007,"Áo ngực nữ Triumph 2505 có gọng, mút mỏng, bản lưng to định hình ôm nâng đẩy ngực",58.0,7077766519780,949000,1199000,250000,21,14,thoi-trang-nu
73510793,Quần chip nữ khoét đũng thiên thần sexy xì lip thong đẹp - Vàng,23.0,6403923172412,25000,25000,0,0,4,thoi-trang-nu
69625268,Đồ bộ nữ quần dài áo thiêu hoa trước sau xẻ tà 1411,3.0,3967115596620,99000,99000,0,0,2,thoi-trang-nu
68537466,Áo kiểu tay dài phối nút hoạ tiết kẻ sọc cho phái nữ,205.0,4509655799858,199000,199000,0,0,45,thoi-trang-nu
68119208,Sét Đồ Bộ Nữ Thời Trang,46.0,5312246386981,99000,99000,0,0,12,thoi-trang-nu
67140446,Áo Sơ Mi Nữ Dài Tay Phối Họa Tiết Star Thanh Lịch,35.0,3018511312229,89000,89000,0,0,13,thoi-trang-nu
57967766,Đồ bộ ngủ Pijama mặc nhà Lụa Gấm tay ngắn quần dài - dài cộc phối bèo họa tiết dưới 62kg cho bạn nữ cực xinh và dễ thương,3.0,8223486590281,160000,160000,0,0,0,thoi-trang-nu
51507409,Quần lót hình bướm lọt khe sexy,125.0,2958159078167,25000,25000,0,0,16,thoi-trang-nu
34592981,Áo Sơ Mi Sọc Hana,353.0,8665809421306,119000,119000,0,0,86,thoi-trang-nu
6535821,Quần Lót Nữ - Quần Đùi Mặc Trong Váy Su Thông Hơi,62.0,3124956488679,36000,36000,0,0,12,thoi-trang-nu
277880353,Gạo ST25 Harmony Vinh Hiển 5KG,62.0,9712705526374,148000,170000,22000,13,9,bach-hoa-online
197636985,Thùng 12 Hộp Sữa Tươi Tiệt Trùng Dutch Lady Cô Gái Hà Lan Không Đường (12 X 965ML),590.0,6199602829354,408000,657000,249000,38,51,bach-hoa-online
20366824,Trung Nguyên Legend - Cà phê hạt rang Success 1 - Bịch 1kg,2584.0,3083526413377,289000,339625,50625,15,155,bach-hoa-online
2454289,Thùng 48 Hộp Sữa Tươi Tiệt Trùng Dutch Lady Cô Gái Hà Lan Không Đường (48X180ml),2766.0,4318824707507,338000,533000,195000,37,358,bach-hoa-online
273930166,[Tặng hộp 4 gói nước cốt cà phê] Combo 2 Bịch Cà phê Hòa tan NESCAFÉ CAFÉ VIỆT 35 gói Vị Mạnh đặc trưng,6576.0,6411591387360,285000,337000,52000,15,19,bach-hoa-online
277838067,[Tặng ly sứ cao cấp] Cà phê Hòa tan NESCAFÉ CAFÉ VIỆT 35 gói Vị Mạnh đặc trưng,11.0,9692579007721,170000,170000,0,0,0,bach-hoa-online
277779080,[Tặng hộp 2 ly thủy tinh] Combo 2 Bịch NESCAFE 3IN1 Công thức cải tiến - VỊ NGUYÊN BẢN Bịch 46 gói,151.0,1478618095390,374000,374000,0,0,0,bach-hoa-online
277779078,[Tặng hộp 2 ly thủy tinh] Combo 2 Bịch Cà phê đen hòa tan NESCAFE Café Việt (Túi 35 gói x 16g),498.0,7017767914751,337000,337000,0,0,0,bach-hoa-online
277501934,[Tặng thùng đá] Combo 4 Bịch Cà phê Hòa tan NESCAFÉ CAFÉ VIỆT 35 gói Vị Mạnh đặc trưng,45.0,4072743767561,675000,675000,0,0,0,bach-hoa-online
207854178,Trung Nguyên Legend - Hộp Quà Tặng Cà Phê Sáng Tạo 8 - Bộ Quà Tặng Giàu Có,268.0,6875318773729,557000,633056,76056,12,13,bach-hoa-online
272635015,[Tặng Bộ bình lumiarc] Combo 3 Bịch NESCAFE 3IN1 Công thức cải tiến - VỊ NGUYÊN BẢN Bịch 46 gói,4183.0,7893805162322,481000,488000,7000,1,14,bach-hoa-online
200629272,[Tặng Bộ picnic 2 ly và hộp đựng] Combo 2 Bịch Cà phê Hòa tan NESCAFÉ CAFÉ VIỆT 35 gói Vị Mạnh đặc trưng,2161.0,2082073759100,285000,337000,52000,15,13,bach-hoa-online
39702057,Trung Nguyên Legend - Cà phê rang xay S Chinh phục - Bịch 500gr,9832.0,1667755414224,81000,90515,9515,11,459,bach-hoa-online
58410333,Trung Nguyên Legend - Cà phê rang xay Gourmet Blend - Hộp 500gr,1753.0,1420234438193,165000,172148,7148,4,106,bach-hoa-online
274798897,[Tặng Ca Đá 1L] Combo 3 Bịch NESCAFE 3IN1 Công thức cải tiến - VỊ NGUYÊN BẢN Bịch 46 gói,2803.0,4980417203490,546000,561000,15000,3,5,bach-hoa-online
274273463,Thùng 48 Hộp Sữa Nestlé MILO Nước (180ml / Hộp) - không màng nhựa,7810.0,5463755579407,369000,412000,43000,10,23,bach-hoa-online
273930178,[Tặng hộp 4 gói nước cốt cà phê] Combo 2 Bịch Cà phê Hòa tan NESCAFÉ VỊ NGUYÊN BẢN 46 gói Đậm Thơm Hoàn Hảo,1002.0,2901047208870,321000,374000,53000,14,13,bach-hoa-online
2454355,Thùng 48 Hộp Sữa Chua Lên Men Tự Nhiên Yomost Vị Cam (170ml/Hộp),78043.0,7264277997200,301000,454000,153000,34,620,bach-hoa-online
51713342,Trung Nguyên Legend - Cà phê rang xay Sức sống Nâu - Bịch 500gr,3885.0,2213028750187,118000,134799,16799,12,277,bach-hoa-online
91474073,Cà phê hòa tan Nescafé 3in1 Cà Phê Sữa Đá 600G ( Bịch 25 Gói x 24g ),4104.0,2097916443371,114000,147000,33000,22,430,bach-hoa-online
46212040,500g Trà sơn mật hồng sâm,57.0,7031099007192,59000,59000,0,0,5,bach-hoa-online
161454715,Trung Nguyên Legend - Cà phê hoà tan rang xay 3in1 Classic - Bịch 50 gói x 17gr,6182.0,7817778724696,175000,202599,27599,14,347,bach-hoa-online
272635007,[Tặng ly sứ cao cấp] Cà phê Hòa tan NESCAFÉ VỊ NGUYÊN BẢN 46 gói Đậm Thơm Hoàn Hảo,3154.0,5773188171124,156000,187000,31000,17,23,bach-hoa-online
201851947,"Thùng 20 Gói Sữa Đậu Đen, Óc Chó, Hạnh Nhân Sahmyook Foods (190ml / Gói)",608.0,4806222451840,273000,402000,129000,32,58,bach-hoa-online
178285744,Thùng 48 hộp Sữa đặc có đường Dutch Lady cao cấp (48 hộp x 380g),36.0,4364348133433,1318000,2470000,1152000,47,3,bach-hoa-online
174247255,Trung Nguyên Legend - Cà phê hòa tan G7 3in1 - Bịch 50 sachets x 16gr (gói vuông),4510.0,8234044001914,175000,196937,21937,11,179,bach-hoa-online
174101598,"Granola Siêu Hạt DK Harvest - 5 loại hạt ngũ cốc Giảm Cân Nướng Mật Ong, Không Đường - Trọng lượng 500g",782.0,2719000937742,149000,149000,0,0,98,bach-hoa-online
114809875,Cà phê hòa tan kết hợp rang xay NESCAFÉ RED CUP 200g,2322.0,6871840163936,165000,226000,61000,27,229,bach-hoa-online
76755601,Sữa Lúa Mạch Nestlé MILO Lon Thùng 24 Lon x 240 ml (4x6x240ml),1245.0,6732140295115,309000,394000,85000,22,167,bach-hoa-online
59178781,Trung Nguyên Legend - Cà phê hoà tan rang xay Cappuccino Hazelnut - Hộp 12 gói x 18gr,3856.0,5952112800434,75000,85874,10874,13,239,bach-hoa-online
59178463,Trung Nguyên Legend - Cà phê rang xay Sáng tạo 2 - Bịch 340gr,2195.0,4355119773045,90000,107953,17953,17,106,bach-hoa-online
58434660,Trung Nguyên Legend - Cà phê sữa hòa tan G7 3in1 - Bịch 100 sticks x 16gr (gói dài),6408.0,1316406311930,319000,365738,46738,13,470,bach-hoa-online
58406605,Trung Nguyên Legend - Cà phê rang xay Sáng tạo 5 - Bịch 340gr,4091.0,9716838387657,155000,180349,25349,14,196,bach-hoa-online
51713351,Trung Nguyên Legend - Cà phê hoà tan rang xay Passiona - Hộp 14 gói x 16gr,4360.0,6640248279000,76000,86848,10848,12,225,bach-hoa-online
39371818,"Hạt Hạnh Nhân Tách Vỏ Nướng Mộc Smile Nuts Hộp Giấy 500g - Hạnh nhân nhập khẩu từ Mỹ, nướng mộc giòn rụm, thơm ngon",1426.0,8438128238197,235000,305500,70500,23,243,bach-hoa-online
16167916,Táo Đỏ Khô Cao Cấp Smile Nuts Hộp 500g,2609.0,2687778366552,94000,122200,28200,23,351,bach-hoa-online
15973974,Thùng 48 Hộp Sữa Nestlé Milo Ít Đường (180ml/ Hộp),15504.0,1231755070744,365000,450000,85000,19,1220,bach-hoa-online
10240037,Thùng 48 Hộp Sữa Nestlé MILO Nước (180ml / Hộp),150558.0,9798371282668,379000,450000,71000,16,1684,bach-hoa-online
7865974,"Thùng 24 Hộp Sữa Đậu Đen, Óc Chó, Hạnh Nhân Sahmyook Foods (140ml / Hộp)",6058.0,3463036668854,266000,405000,139000,34,898,bach-hoa-online
609586,"Thùng 24 Hộp Sữa Đậu Đen, Óc Chó, Hạnh Nhân Sahmyook Foods (190ml / Hộp)",7491.0,3697095900345,337000,497000,160000,32,1092,bach-hoa-online
484525,Đồ Ăn Cho Mèo Lớn Whiskas Vị Cá Biển Túi 1.2 Kg,2717.0,1504156519687,133000,140000,7000,5,80,bach-hoa-online
484524,Đồ Ăn Cho Mèo Con Whiskas Vị Cá Biển Và Sữa Dạng Túi 1.1 Kg,5300.0,1506333474260,125000,140000,15000,11,203,bach-hoa-online
20367638,Trung Nguyên Legend - Cà phê hạt rang Success 2 - Bịch 1kg,1012.0,6323048008802,485000,551518,66518,12,93,bach-hoa-online
197636995,Thùng 12 Hộp Sữa Tươi Tiệt Trùng Dutch Lady Cô Gái Hà Lan Có Đường (12 X 965ML),196.0,6996847122860,408000,657000,249000,38,18,bach-hoa-online
58409812,Trung Nguyên Legend - Cà phê rang xay Chế phin 1 - Bịch 500gr,2513.0,1242491696617,139000,153513,14513,9,194,bach-hoa-online
275972447,Bia thủ công | Rooster Beers Lốc 4 Lon Pale và IPA Mix x 330ml,5.0,6537563828430,189000,189000,0,0,0,bach-hoa-online
275925856,Cà Phê Robusta Nguyên Chất Đất Cà Phê 250g | Pure Robusta Coffee 250g - Gu Đậm Đà,49.0,9046315010329,29000,29000,0,0,1,bach-hoa-online
275615721,Thùng Sữa hạt Veyo lên men tự nhiên Vị Nguyên bản Ít đường (30hộp x 180ml),21.0,9212166570625,161000,245000,84000,34,0,bach-hoa-online
273716360,Trung Nguyên Legend - Cà phê sữa hòa tan G7 Gold Rumi - Hộp 14 gói x 18gr,178.0,9371569673822,78000,89175,11175,13,15,bach-hoa-online
273523197,Ngũ cốc ăn sáng MILO (Hộp 300g),156.0,1656819734924,99000,110000,11000,10,9,bach-hoa-online
252564076,[TOP SALE] TỔ YẾN CHƯNG ĐÔNG TRÙNG HẠ THẢO 100% Tổ Yến Thật (Hàm Lượng 30%) (6 Lọ X 70ML) - Đệ Nhất Yến Đảo - Giảm Stress - Giảm Mệt Mỏi - Đẹp Da - Đẩy Lùi Lão Hóa - Điều Hòa Đường Huyết - Ổn Định Huyết Áp - Tăng Sức Đề Kháng - Tăng Sức Đề Kháng,222.0,4163456422496,370500,390000,19500,5,19,bach-hoa-online
2454357,Thùng 48 Hộp Sữa Chua Lên Men Tự Nhiên Yomost Bạc Hà - Việt Quất (170ml/Hộp),10957.0,4121961512138,301000,454000,153000,34,712,bach-hoa-online
2454353,Thùng 48 Hộp Sữa Chua Lên Men Tự Nhiên Yomost Vị Dâu (170ml/Hộp),52498.0,7888433754317,301000,454000,153000,34,566,bach-hoa-online
62737129,Trung Nguyên Legend - Cà phê phin giấy Vietnamese Blend - Hộp 10 gói x 10gr,1906.0,3076057529426,133000,148334,15334,10,134,bach-hoa-online
272999022,[10 chiếc] Súp thưởng cho mèo thơm ngon bổ dưỡng,18.0,8077422042880,9000,9000,0,0,0,bach-hoa-online
272421929,[TẶNG Bộ 3 muỗng cà phê inox NESCAFE] Nước cốt cà phê NESCAFÉ - CÀ PHÊ SỮA ĐÁ (hộp 5 gói),370.0,1605263110563,54500,56000,1500,3,24,bach-hoa-online
253395988,Cà phê hòa tan đen - Trung Nguyên Legend Americano hộp 15 gói x 2g,973.0,1574942942950,46000,52488,6488,12,35,bach-hoa-online
275709361,Thùng 24 chai Trà Thanh Nhiệt Dr Thanh không đường chai PET 330 ml,7.0,8746610349740,266000,319000,53000,17,0,bach-hoa-online
58453178,Trung Nguyên Legend - Cà phê hoà tan rang xay 3in1 Special Edition - Hộp 9 gói x 25gr,1868.0,4793958131365,63000,72151,9151,13,131,bach-hoa-online
184241162,"Sữa bột tăng cân,hổ trợ tiêu hóa healthy 400g TOPTEN Milk",11.0,5300705271787,290000,290000,0,0,1,bach-hoa-online
275709354,Thùng 24 chai Trà Thanh Nhiệt Dr Thanh chai PET 330 ml,6503.0,3928573875305,272000,319000,47000,15,1,bach-hoa-online
189604310,Cà phê phin giấy Gu Người Việt DalatFarm - Hộp 10 túi x 10 g,221.0,1909443761712,120000,120000,0,0,13,bach-hoa-online
189586825,Cà phê phin giấy Arabica Cầu Đất DalatFarm - Hộp 10 túi x 10 g,292.0,8336695635767,150000,150000,0,0,10,bach-hoa-online
177336108,Thùng Veyo Sữa hạt lên men tự nhiên Vị Dâu Nhật (30hộp x 180ml),925.0,5818474307056,161000,245000,84000,34,120,bach-hoa-online
176630892,"Granola siêu Hạt &amp; Quả NOFA 600gr, Ngũ cốc giảm cân thêm Macca, Óc chó đỏ",186.0,6261225165439,41000,41000,0,0,30,bach-hoa-online
133696713,Dầu Đậu Nành Simply 1L/2L/5L,130272.0,6520013377149,75617,75617,0,0,1548,bach-hoa-online
120497686,Trà lúa mạch Itoen Nhật Bản 405g,156.0,8990777452350,99000,99000,0,0,19,bach-hoa-online
114467215,Thùng Fristi Hương Nho 48x80ml,1951.0,8857682961728,167000,186624,19624,11,78,bach-hoa-online
114467212,Thùng Fristi Hương Dâu 48x80ml,2029.0,1056576425854,167000,255000,88000,35,96,bach-hoa-online
114467209,Thùng Fristi Hương Cam 48x80ml,2076.0,4732716131887,167000,255000,88000,35,94,bach-hoa-online
90059778,"Combo Detox thải độc - Bột rau củ hữu cơ sấy lạnh Dalahouse - Hộp 21 gói 7 loại rau củ, mỗi gói 3gr [Mẫu mới] - Hỗ trợ giảm cân, Thải độc, thanh lọc cơ thể",210.0,3598492923701,166500,166500,0,0,51,bach-hoa-online
85479195,"Cà Phê Arabica Cầu Đất Nguyên Chất Rang Mộc Đặc Biệt, Hậu Vị Ngọt Đậm Hương Trái Cây, Hạt Pha Máy Xay Pha Phin Ngon Từ Nông Trại Message Coffee  ",6273.0,3123774604933,225000,280000,55000,20,887,bach-hoa-online
73570463,"Cà phê hạt Robusta nguyên chất 100% 1kg - Coffee Tree thơm ngon, đậm đà",1993.0,8159124979258,390000,390000,0,0,283,bach-hoa-online
72331222,"Trà gạo lứt huyết rồng - đậu đen xanh lòng MS (01kg) - Thanh nhiệt, mát gan, lợi sữa",1247.0,6424408039938,99000,99000,0,0,215,bach-hoa-online
71979469,Trà Oolong Kim Tuyên Cầu Đất - Túi 200Gr,3284.0,2157092788304,155000,155000,0,0,287,bach-hoa-online
58444508,Sữa Lúa Mạch Nestlé MILO Teen Protein Canxi (24 x 210ml),2127.0,1884990022599,239000,309000,70000,23,364,bach-hoa-online
58407832,Trung Nguyên Legend - Cà phê rang xay Sáng tạo 1 - Bịch 340gr,3282.0,6824799863530,82000,92553,10553,11,149,bach-hoa-online
57304713,"Cà phê bột 100% nguyên chất truyền thống số 3 Coffee Tree 500gr thơm ngon, đậm đà, gu mạnh (Cà phê) ",1456.0,8688075065012,159000,219000,60000,27,193,bach-hoa-online
51966118,Trà Lài Cầu Đất - Túi 150Gr (Trà Hoa Nhài - Jasmine Tea),5865.0,4724529999299,60000,60000,0,0,589,bach-hoa-online
51713363,Trung Nguyên Legend - Cà phê hoà tan rang xay 3in1 Special Edition - Hộp 18 gói x 25gr,8152.0,2275946787911,124000,141457,17457,12,363,bach-hoa-online
51713336,Trung Nguyên Legend - Cà phê rang xay House Blend - Hộp 500gr,1542.0,4193771122081,115000,128066,13066,10,50,bach-hoa-online
49246233,THỨC ĂN CHO MÈO MỌI LỨA TUỔI CATSRANG 3KG,1631.0,2454409827405,330000,420000,90000,21,223,bach-hoa-online
5032435,"Dầu Olive Pomace Silarus 1L cao cấp, dùng chiên rán, nấu ăn, giảm chất béo có hại - thương hiệu Silarus nhập khẩu 100% từ Ý",1102.0,9388730065775,236610,236610,0,0,103,bach-hoa-online
3493689,Trung Nguyên Legend - Cà phê hoà tan rang xay 3in1 Classic - Hộp 12 gói x 17gr,2076.0,8490115128577,51000,58468,7468,13,185,bach-hoa-online
1692537,Thùng 12 Hộp Nước Dừa Cocoxim Sen (330ml x12 Hộp),974.0,3671259541506,217800,217800,0,0,145,bach-hoa-online
276659219,Thùng 24 hộp Sữa dưa lưới 200ml nhãn hiệu Binggrae,6.0,1240922025545,305000,463000,158000,34,0,bach-hoa-online
276377951,"1 lọ Procin 50A trị khàn giọng, sã cánh, tiêu chảy cho chim cảnh, vẹt",26.0,6122051306867,29999,29999,0,0,0,bach-hoa-online
276235302,Pate Cho Mèo Hello Cat Tuna - Thức Ăn Cho Mèo Mọi Lứa Tuổi Trong Thạch 400g,27.0,2777027072630,25500,45000,19500,43,7,bach-hoa-online
274848070,Cát vệ sinh đậu nành cho mèo - TODAY'S LITTER TOFU (7L) | Cát hữu cơ vón chắc,276.0,4785249649956,180000,180000,0,0,19,bach-hoa-online
274764345,Thức Ăn Cho Mèo Whiskas Adult 1+ Years Vị Cá Ngừ 3kg/Túi,31.0,6310692029399,269000,304000,35000,12,3,bach-hoa-online
274649761,Thùng 30 gói mì Oppa ăn liền Ottogi 65g,7.0,5250051030870,149000,149000,0,0,1,bach-hoa-online
273963048,Si Rô VinaSyrup 750ml - 21 Vị Trái Cây Tự Nhiên,1226.0,9284330362621,30000,30000,0,0,64,bach-hoa-online
273310823,"Natural Gia Vị Nấu Ướp Dh Foods - Gia Vị Ngũ Hương, Nấu Cà Ri, Ướp Thịt Nướng, Ướp Thịt Chẩm Chéo, Ướp Thịt Mắc Mật, Nấu Bò Kho",17.0,5178782443290,6900,6900,0,0,1,bach-hoa-online
244133704,"Sữa gạo lứt Hàn Quốc Sahmyook 1,5L",79.0,5285691264280,59000,90000,31000,34,4,bach-hoa-online
219134711,"Xốt Bún Bò Huế HiXOT hũ 220gram, gia vị hoàn chỉnh, không cần nêm nếm",131.0,1517680923618,55000,55000,0,0,6,bach-hoa-online
200629270,[Tặng Bộ picnic hộp đựng và 2 ly] Combo 2 Bịch NESCAFE 3IN1 Công thức cải tiến - VỊ NGUYÊN BẢN Bịch 46 gói,26746.0,1335918660832,321000,374000,53000,14,140,bach-hoa-online
114809866,Nước tương MAGGI đậu nành đậm đặc 700ml,1814.0,5362699769282,33600,41000,7400,18,172,bach-hoa-online
86267511,Cà phê Cầu Đất Blend Cao Cấp Nguyên Chất Rang Mộc 100% Kết Hợp Giữa Arabica Cầu Đất Và Robusta Honey Cho Vị Đắng Đầm Thơm Ngọt Hậu - Message Coffee,3334.0,6970457616547,210000,260000,50000,19,419,bach-hoa-online
77749703,Combo 2 Túi Cà Phê Sữa King Cofffee (50 gói x 20g),213.0,3817044049471,397000,397000,0,0,38,bach-hoa-online
74245802,Trung Nguyên Legend - Cà phê G7 hòa tan đen ( không đường) - hộp 15 gói 2gr,3626.0,5835286907720,37000,40909,3909,10,230,bach-hoa-online
73569777,"Cà phê bột Robusta nguyên chất 100% 500gr  - Coffee Tree thơm ngon, đậm đà",3407.0,4727621885293,195000,195000,0,0,405,bach-hoa-online
68607796,Đậu đen xanh lòng rang sẵn - 1kg - (MS ) - Đậu đen xanh lòng hữu cơ - hạt nhỏ thuần chủng,1084.0,5140034592555,125000,125000,0,0,154,bach-hoa-online
68269446,Bột ngũ cốc dinh dưỡng từ 18 loại  Đậu & Hạt cao cấp - MS ( 500gr),2578.0,6761692402087,130000,130000,0,0,360,bach-hoa-online
68211446,Bột ngũ cốc dinh dưỡng cao cấp 05 loại đậu & hạt ( không đường )  - MS - (500gr),2927.0,3673704696182,86545,86545,0,0,326,bach-hoa-online
68031130,"Cà phê bột Arabica Cầu Đất 500g nguyên chất 100% Coffee Tree  thơm nồng, vị nhẹ, gu tây",2158.0,6596996032001,199000,299000,100000,33,269,bach-hoa-online
65923404,Trà Oolong Kim Tuyên Cầu Đất - Hộp 220Gr - Dalat Farm ,3793.0,6109886115892,190000,190000,0,0,525,bach-hoa-online
61363239,Cát Vệ Sinh Đậu Phụ Cho Mèo ACROPET 5L - Hương Lavender,980.0,5725927355938,104400,120000,15600,13,95,bach-hoa-online
59514285,Trung Nguyên Legend - Cà phê hòa tan G7 3in1 - Hộp 21 gói x 16gr,1360.0,1069380051773,80000,87545,7545,9,75,bach-hoa-online
59514129,Trung Nguyên Legend - Cà phê hòa tan G7 3in1 - Bịch 50 sticks x 16gr (gói dài),3948.0,2870819063422,175000,196937,21937,11,237,bach-hoa-online
59178438,Trung Nguyên Legend - Cà phê sữa hòa tan G7 3in1 gu mạnh - Hộp 12 gói x 25gr,3112.0,2665598996746,70000,77806,7806,10,140,bach-hoa-online
58899983,"Cà phê Robusta Honey nguyên chất rang mộc cafe pha phin - pha máy vị đắng đầm, hậu ngọt và hương thơm nồng từ Message Coffee",4529.0,1727273100884,195000,240000,45000,19,555,bach-hoa-online
58811363,"Bánh gạo lứt nguyên hạt ăn kiêng GUfoods (Gói 510g = 54 bánh) - Không chiên dầu, Phù hợp Eat clean, Ăn vặt healthy, Thực dưỡng, Tập Gym, Giảm cân",7571.0,3863696435726,133900,133900,0,0,1291,bach-hoa-online
58448473,Trung Nguyên Legend - Cà phê rang xay Sáng tạo 4 - Bịch 340gr,2569.0,8216443473901,137000,147642,10642,7,160,bach-hoa-online
58448354,Trung Nguyên Legend - Cà phê rang xay Chế phin 5 - Bịch 500gr,2077.0,3306203840878,269000,292910,23910,8,157,bach-hoa-online
58409447,Trung Nguyên Legend - Cà phê rang xay Chế phin 2 - Bịch 500gr,1880.0,3937446391164,160000,176228,16228,9,156,bach-hoa-online
57695989,Cà phê bột truyền thống số 1 (500gr) Coffee Tree 100% nguyên chất gu đậm hương nhẹ,761.0,3445901922919,213000,213000,0,0,98,bach-hoa-online
57306363,"Cà phê hạt Arabica Cầu Đất nguyên chất 100% Coffee Tree 1kg thơm nồng, vị nhẹ, gu tây - Cà phê Đà Lạt tuyển chọn hoàn toàn trái chín rang công nghệ Châu Âu",1953.0,4751142570536,394000,599000,205000,34,279,bach-hoa-online
57302645,"Cà phê hạt 100% nguyên chất truyền thống số 2 Coffee Tree 1kg đậm đà, thơm ngon, gu vừa",323.0,2501438866926,299000,334000,35000,10,63,bach-hoa-online
57300896,Cà phê bột 100% nguyên chất truyền thống số 2 (500gr) Coffee Tree gu vừa vị chuẩn truyền thống,1324.0,9479734475049,159000,167000,8000,5,187,bach-hoa-online
57282097,"Gạo Lứt Tím Than Túi 1Kg - Gạo Ông Thọ - Thơm mềm dẻo, tốt cho sức khỏe",2772.0,3299245511908,55900,55900,0,0,264,bach-hoa-online
45803948,Đặc sản Sóc Trăng - Gạo Thơm ST25 Túi 5Kg - Đạt Giải Gạo Ngon Nhất Thế Giới Năm 2019 tại Manila - OCOP 4 Sao,13178.0,4575737048619,250000,250000,0,0,1056,bach-hoa-online
13409520,Thùng 48 Hộp Sữa Uống Dutch Lady Cô Gái Hà Lan Có Đường Cao Khỏe (48X170ml),6125.0,1426068459007,312000,347328,35328,10,572,bach-hoa-online
9731241,Xương gặm vệ sinh miệng cho chó (Bịch 5 thanh),85.0,8124178429851,19777,19777,0,0,11,bach-hoa-online
1064988,Trung Nguyên Legend - Cà phê hòa tan G7 2in1 - Hộp 15 gói x 16gr,2061.0,3659809021326,69000,79031,10031,13,95,bach-hoa-online
537489,Thùng 30 Gói Mì Khoai Tây Cung Đình Hương Vị Lẩu Tôm Chua Cay,409.0,9306703842567,222000,290000,68000,23,24,bach-hoa-online
277348304,Lương Khô Dinh Dưỡng Mix 13 Vị 500g,33.0,2827984679457,59000,100000,41000,41,4,bach-hoa-online
276378908,"1 lọ quinocoli 10ml trị chướng diều, khô chân, xù lông, phân xanh trắng, toi, rù cho chim, vẹt, gia cầm",30.0,3245265125505,13999,13999,0,0,0,bach-hoa-online
275645086,Thùng 48 Hộp Sữa Tươi Tiệt Trùng Dutch Lady Cô Gái Hà Lan ít đường 180ml,25.0,1974615056881,338000,552000,214000,39,3,bach-hoa-online
275030558,"FIVE AZIMAX - Thuốc Hỗ Trợ Trị Hô Hấp, Nhiễm Trùng Da Cho Thú Cưng_Fivevet",8.0,4302290039291,80000,80000,0,0,0,bach-hoa-online
273983851,Today's dinner - Thức ăn hạt cho chó trưởng thành cân bằng dinh dưỡng (Adult dog),62.0,1200896807813,89500,120000,30500,25,3,bach-hoa-online
273716412,Trung Nguyên Legend - Cà phê sữa hòa tan G7 Gold Picasso Latte - Hộp 14 gói x 18gr,263.0,4577374246975,78000,89175,11175,13,13,bach-hoa-online
272828405,Cát Vệ Sinh Đậu Nành Cho Mèo Tofu Cat Litter Catsme 6L - YonaPetshop,77.0,5036405170809,115000,115000,0,0,4,bach-hoa-online
253219920,(5KG) THỨC ĂN HẠT CHO MÈO MỌI LỨA TUỔI CATSRANG,138.0,2146562582476,550000,550000,0,0,10,bach-hoa-online
205007749,Thức ăn hạt mềm cho chó Zenith | Chó con | Chó trưởng thành | Chó già | Không ngũ cốc | Hỗ trợ miễn dịch | Phát triển xương khớp chắc khoẻ | Chính hãng Hàn Quốc,212.0,3049430677698,240000,300000,60000,20,16,bach-hoa-online
196486400,"ký sinh trùng trên cá, vime clean 100g/ gói",64.0,3003059343988,68000,68000,0,0,0,bach-hoa-online
190701491,Cà Phê Cold Brew Arabica Cầu Đất DalatFarm - Túi 125 g,490.0,8652415832727,130000,130000,0,0,38,bach-hoa-online
181999214,"Xịt nấm ngứa, ve rận, ghẻ ngứa và viêm da cho chó mèo Fungikur (50ml)",15.0,3322771532002,115000,115000,0,0,5,bach-hoa-online
160658295,"Bánh gạo lứt nguyên hạt Hello Rice, bánh gạo lức ăn kiêng giảm cân thực dưỡng",188.0,8267449106098,29000,29000,0,0,16,bach-hoa-online
146276627,Táo đỏ sấy khô cao cấp Kobe Bussan chất lượng nội địa Nhật Bản 500g,107.0,7445858206999,225000,225000,0,0,28,bach-hoa-online
114809887,Sữa lúa mạch Nestlé MILO Nguyên chất 400g (hũ nhựa) - Giao mẫu ngẫu nhiên,2258.0,1589893271165,85300,98000,12700,13,172,bach-hoa-online
114809857,Hạt nêm cao cấp MAGGI vị Nấm Hương gói 450g,1742.0,8935947616487,54100,62000,7900,13,121,bach-hoa-online
114778894,Thùng Fristi Hương Đào Tiên Nhật Bản 48x80ml,1062.0,6809717126657,167000,255000,88000,35,64,bach-hoa-online
101150949,Me Xí Muội Chua Cay DTFood cực ngon,133.0,8704070085988,49000,49000,0,0,28,bach-hoa-online
93525485,"Trà Thảo Mộc KingTea 500g Hỗ Trợ Đau Dạ Dày, Ổn Định Huyết Áp, Hạ Men Gan , Mỡ Máu Và Ngăn Ngừa Ung Thư Giúp Ngủ Ngon",612.0,6272376379193,135000,135000,0,0,83,bach-hoa-online
77283146,Trân châu thủy tinh Yoki 300g (10*30g),939.0,3248277336151,35000,35000,0,0,170,bach-hoa-online
76582330,Tổ Yến Sào Tinh Chế (5 Tổ/40g/Hộp) (Tổ Yến làm sạch/Tổ Yến Sạch chế biến từ Tổ Yến Thô /Tổ Yến còn lông) Yến Sào Trung Nam,496.0,6449680673618,1764000,2100000,336000,16,82,bach-hoa-online
68429315,"Hạt Hạnh Nhân Sống DK Harvest  Nhập Khẩu - Túi 500g, 1000g",3014.0,5421446774037,159000,159000,0,0,522,bach-hoa-online
67921481,Trung Nguyên Legend - Creamer đặc có đường Brothers - Lon 390gr,6437.0,3208875867965,29305,29305,0,0,273,bach-hoa-online
67207109,Thức Ăn Hạt Catsrang Cho Mèo Mọi Lứa Tuổi - 2Kg,1057.0,7014238549630,262650,309000,46350,15,178,bach-hoa-online
62735877,Trung Nguyên Legend - Cà phê phin giấy Americano - Hộp 10 gói x 10gr,1631.0,2798206435402,133000,148334,15334,10,114,bach-hoa-online
58911324,Cà phê Robusta Đắk Lắk 1kg,862.0,1019851586204,249000,249000,0,0,141,bach-hoa-online
58452062,Đường Phèn Biên Hòa Pro (500gr),382.0,9128138269319,32100,40500,8400,21,19,bach-hoa-online
58392902,Trung Nguyên Legend - Cà phê G7 hòa tan đen ( không đường) - bịch 100 sachets 2gr,4333.0,1178856557890,199000,226641,27641,12,347,bach-hoa-online
57879692,Thức ăn cho mèo trưởng thành Me-O Cat Food,158.0,5475203387299,26888,26888,0,0,14,bach-hoa-online
57118697,"Cà phê bột nguyên chất 100% Coffee Tree đặc biệt 500gr thơm ngon, đậm đà - Cà phê rang xay pha phin gu việt",1906.0,3133765630896,159000,196000,37000,19,224,bach-hoa-online
56863272,Cà phê hạt nguyên chất Coffee Tree đặc biêt (1kg) gu đậm đắng thơm - Cà phê pha phin hoặc pha máy từ BMT hiệu Coffee Tree,917.0,2546158490655,329000,465000,136000,29,169,bach-hoa-online
50488105,Trà Xanh Thái Nguyên Khánh Nga ,1315.0,6517529112595,29000,29000,0,0,69,bach-hoa-online
50295630,"Combo 2 hộp Hạt Chia Đen Hữu Cơ Smile Nuts 500g - Nhập khẩu từ Nam Mỹ (Hạt Chia 100% Organic, hạt sáng, nở đều, không lẫn tạp chất)",367.0,4335375041928,218000,284000,66000,23,82,bach-hoa-online
37137744,Ngũ cốc Calbee vị Trái cây gói đỏ 800gr (Trái cây & các loại Hạt),698.0,3929746122111,131000,131000,0,0,142,bach-hoa-online
35848354,Cà Phê Đen Hòa Tan Espresso KING COFFEE - Hộp 100 gói x 2.5g,2215.0,4887077367023,424500,446800,22300,5,278,bach-hoa-online
35354610,(COMBO 1KG) 2 HỘP HẠT ĐIỀU RANG MUỐI XẾP HOA ĐẸP HÀNG CHẤT LƯỢNG LOẠI 1,326.0,7783756812327,190000,190000,0,0,96,bach-hoa-online
17148693,"Bột CaCao Nguyên Chất 100% DK Harvest 100g, 200g, 500g",4351.0,2530260440226,39000,39000,0,0,664,bach-hoa-online
16176611,Combo 2 Hộp Táo Đỏ Khô Cao Cấp Smile Nuts (500g/hộp),1301.0,6921877537403,188000,245000,57000,23,215,bach-hoa-online
13409436,Kem đặc có đường Dutch Lady gói 545g,8897.0,2185985952648,39000,45000,6000,13,350,bach-hoa-online
3041823,Thùng 4 Lốc Sữa Nguyên Kem Devondale Fullcream (4 x 6 x 200Ml),3267.0,1522608814685,359000,436000,77000,18,252,bach-hoa-online
277489484,Yến mạch cán dẹp nguyên hạt Úc,433.0,2358116298006,26000,26000,0,0,35,bach-hoa-online
277487249,[HOÀN VỎ 20K] COMBO 2 BÌNH - Nước uống tinh khiết WOW / Nước kiềm đóng bình FOY 19L - 2IN1,8.0,1733291970340,138000,241500,103500,43,4,bach-hoa-online
276379975,Kẹo Dẻo Zoo Foam Jelly Dưa hấu Bibica,18.0,2503357837856,4289,4874,585,12,1,bach-hoa-online
275172214,Canh Rau Tập Tàng Nấm Rơm Ăn Liền ISOUP 35g 05 Viên - Viên Canh Ăn Liền Sấy Thăng Hoa,87.0,3465465385412,58000,58000,0,0,4,bach-hoa-online
275019762,Lốc 16 gói mì ramen ăn liền Tokyo Noodle vị gà 480g,12.0,8692913047463,105000,105000,0,0,0,bach-hoa-online
273992080,Sinh Tố VINA MỨT 1000ml - 10 Vị Trái Cây Tươi Tự Nhiên,760.0,7643924251170,75000,75000,0,0,8,bach-hoa-online
273977859,Si Rô CARISA 680g - 13 Vị Trái Cây,131.0,2715982989247,30000,30000,0,0,3,bach-hoa-online
273643944,Thực phẩm bổ sung Trà Việt Quất và Hoa Atiso Đỏ NESTEA 10 gói x 12g,49.0,5712775533755,29100,44000,14900,34,3,bach-hoa-online
273643938,Nước Tương MAGGI Đậu Nành Thanh Dịu 450ml,44.0,6037636150461,19700,23000,3300,14,3,bach-hoa-online
272634992,Cà phê hoà tan NESCAFÉ 3IN1 VỊ RANG ĐẬM - công thức cải tiến (bịch 46 gói x 16g),452.0,5570228507935,161000,187000,26000,14,30,bach-hoa-online
272617177,Catsrang 5Kg Thức Ăn Hạt Cho Mèo Mọi Lứa Tuổi,4.0,4100527006152,102000,102000,0,0,0,bach-hoa-online
263648803,Combo 5 Cà phê rang xay Moka Highlands Coffee 200g - dòng cà phê cao cấp,162.0,5835005327028,690000,690000,0,0,8,bach-hoa-online
263648721,Combo 5 gói Cà Phê Rang Xay Truyền Thống Highlands Coffee (200g),148.0,1710364660084,490000,490000,0,0,7,bach-hoa-online
252012351,Hạt chia đen BLACK BAG CHIA 500g,10.0,1628162589371,71400,110000,38600,35,1,bach-hoa-online
214731700,Vi Sinh Làm Trong Nước  Bể Cá Extrabio 125ml 250ml 500ml 1000ml,16.0,2724763962223,55000,55000,0,0,7,bach-hoa-online
201965540,COMBO 5 Gói Thức Ăn Hạt Cho Mèo Trưởng Thành Từ Thái Lan Zoi Cat 1kg - YonaPetshop,70.0,2265577827484,55000,55000,0,0,9,bach-hoa-online
198197816,Dâu tằm sấy dẻo ít đường Kentary - sấy nguyên vị chua chua ngọt ngọt - đồ ăn vặt healthy,23.0,8342832659732,125000,125000,0,0,4,bach-hoa-online
197636987,Thùng 48 Bịch Sữa Tiệt Trùng Dutch Lady Cô Gái Hà Lan Có Đường 180ml,7877.0,8879347952113,280000,419000,139000,33,84,bach-hoa-online
192305356,"Súp thưởng cho mèo thú cưng shizuka thanh 15gr nhiều vị kích thích ăn ngon,hỗ trợ tiêu hóa",1250.0,7810049035007,1000,1000,0,0,3,bach-hoa-online
191620128,Tã Lót Chuồng Miếng Lót Vệ Sinh Cho Chó Mèo Siêu Thấm Hút Dono,77.0,1724510561093,59000,59000,0,0,4,bach-hoa-online
175154880,Dầu hào Lee Kum Kee Premium Brand Oyster Sauce (510g/chai) loại đặc biệt với chiết xuất hàu lên đến 40%,105.0,4299825008942,136000,148000,12000,8,4,bach-hoa-online
169197351,Cà phê viên nén Ý Carraro Gourmet tương thích Dolce Gusto 16 viên/hộp,77.0,1179700648548,129600,162000,32400,20,11,bach-hoa-online
166525080,"Bột cần tây hữu cơ nguyên chất sấy lạnh Dalahouse - Mẫu mới 2022 Hộp - Hỗ trợ giảm cân, cao huyết áp, ngăn chặn gia tăng mỡ trong máu",1347.0,6269206269738,121500,121500,0,0,143,bach-hoa-online
159095758,Đạm thực vật và Superfoods hữu cơ Orgain hương Socola và Vani Organic Protein & Superfoods Orgain - Chocolate & Vanilla,256.0,9334760409366,880000,885000,5000,1,44,bach-hoa-online
137754659,CÁT VỆ SINH HỮU CƠ VÓN CỤC SIÊU THẤM HÚT VÀ KHÁNG KHUẨN CHO MÈO NHẠY CẢM - CAT’S BEST SENSITIVE,65.0,3556486150025,249600,320000,70400,22,5,bach-hoa-online
89624989,Tương ớt Chilica 255g,764.0,3757201176575,42900,42900,0,0,83,bach-hoa-online
66475968,Trà Lài Cầu Đất Đặc Biệt - Hộp 110Gr (Trà hoa Nhài - Jasmine Tea) Dalat Farm ,2256.0,7282550270741,90000,90000,0,0,253,bach-hoa-online
58393302,Trung Nguyên Legend - Cà phê hoà tan rang xay Cappuccino Mocha - Hộp 12 gói x 18gr ( có sữa),3224.0,3572081189952,75000,85874,10874,13,186,bach-hoa-online
54690900,Trà Xanh Cầu Đất - Túi 150Gr (Green Tea) ,4031.0,1469987032272,60000,60000,0,0,362,bach-hoa-online
54479685,Quả la hán - La hán quả cao cấp không vỡ,613.0,2241518153774,39000,39000,0,0,132,bach-hoa-online
53706414,Hạt ngũ hoa,434.0,4663203236025,55000,55000,0,0,82,bach-hoa-online
39088200, Hạt Mix Nuts 5 Loại hạt nhập khẩu (Dẻ Cười + Hạnh Nhân + Hạt Điều + Óc Chó Vàng + Macca ) DK Harvest,796.0,8839050071348,179000,179000,0,0,126,bach-hoa-online
16551769,Cà Phê Hạt Mộc Trung Nguyên Success 2 Túi 1Kg,50.0,8597455544965,520000,520000,0,0,3,bach-hoa-online
15182824,Combo 2 hộp Bột ngũ cốc Damtuh Hàn Quốc 50 gói x 18g,283.0,2030418662659,468000,468000,0,0,49,bach-hoa-online
10677573,Dầu hạt cải nguyên chất nội địa Nhật Bản ( Chai 1L),990.0,6166516304033,94000,94000,0,0,67,bach-hoa-online
10409796,Thùng 24 Lon Cà Phê Sữa Highlands Coffee (235ml/Lon),2116.0,1048555005537,345000,380000,35000,9,58,bach-hoa-online
4767497,Yến Mạch Hữu Cơ Úc Absolute Organic Túi 700gram,685.0,1797285548660,128001,128001,0,0,43,bach-hoa-online
2922175,Gạo Thơm Thượng Hạng Nàng Sen 5kg - Thơm ngon dẻo nhiều - Chuẩn nhà hàng 5 sao,1345.0,5625701761958,195000,195000,0,0,45,bach-hoa-online
537395,Thùng 30 Gói Mì Cung Đình Hương Vị Gà Hầm (79g/Gói),122.0,9308616181443,243000,264000,21000,8,6,bach-hoa-online
276903746,"[Set quà tặng 2 hộp giấy 250ml] Nước mắm cá cơm thượng hạng Hoàng Gia - Quà Tết sang trọng tặng đối tác, gia đình, bạn bè ",2.0,8083586283716,450000,450000,0,0,0,bach-hoa-online
276633868,"Five-Tulacin 1%  Giải pháp hiệu quả cho CRD, viêm phổi, viêm đường hô hấp nặng.",11.0,6985441528217,335000,335000,0,0,0,bach-hoa-online
276594137,Lương Khô SBT Cung Cấp Năng Lượng Nhanh Chóng,31.0,8988136125283,38000,70000,32000,46,1,bach-hoa-online
276125743,"10 cái Tã quần cho chó mèo, băng vệ sinh chó cái,chó đực, mèo cái , mèo đực",11.0,7697430617848,52999,52999,0,0,4,bach-hoa-online
275658250,Bia thủ công | Rooster Beers 4 Lon Mix x 330ml,13.0,3654610246987,179000,179000,0,0,2,bach-hoa-online
275416528,Bàn chải lông CHÓ MÈO có cán nhựa chắc chắn PaKaSa - Hàng chính hãng,5.0,8773624501985,29000,58000,29000,50,0,bach-hoa-online
275172233,Canh Gà Lá Giang Ăn Liền ISOUP 72g 06 Viên - Viên Canh Ăn Liền Sấy Thăng Hoa,102.0,8682203418000,68000,68000,0,0,4,bach-hoa-online
274156328,Thức ăn hạt cho mèo | Cat's Eye | cho mèo mọi lứa tuổi | Hỗ trợ lông da,61.0,5502265945832,167200,190000,22800,12,5,bach-hoa-online
273205945,Ngũ cốc ăn sáng KOKO KRUNCH (Hộp 300g),64.0,7629896372657,99100,110000,10900,10,3,bach-hoa-online
271409497,Canh Riêu Tôm Ăn Liền I-Soup 42g 06 Viên,235.0,1016648212144,68000,68000,0,0,7,bach-hoa-online
271247979,GẠO LỨT NHẬT HOKKAIDO YUMEPIRIKA ,48.0,8897574449503,318000,318000,0,0,2,bach-hoa-online
262895905,Bánh gạo phô mai Bourbon Cheese Okaki 81g,2.0,9777262481379,85000,85000,0,0,0,bach-hoa-online
249388069,"Cà phê Hòa Tan Sấy Lạnh BLACK 80Gr Gu Đậm Đà, tinh chất cafe rang xay nguyên chất, tiện lợi, dùng liền từ Message Coffee ",132.0,4711151959928,130000,190000,60000,32,12,bach-hoa-online
249086922,DATINO Bột Nước Mát Thanh Nhiệt hộp 10gói x 8g,33.0,6203739507907,42000,42000,0,0,0,bach-hoa-online
192151757,XƯƠNG GẶM ORGO CHO CHÓ,819.0,7659304933040,21111,21111,0,0,31,bach-hoa-online
191413437,"Hạt Hỗn Hợp Dinh Dưỡng 4 Loại Hạt Điều, Hạnh Nhân, Óc Chó, Dẻ Cười Không Muối Lafooco 400g",159.0,4462242009436,209000,209000,0,0,10,bach-hoa-online
162974887,"Yến Mạch Quaker Oats Quick - 1 Minute 4,52kg (Dạng Hạt Cán Vỡ) - Thực phẩm ăn kiêng hỗ trợ giảm cân tốt cho sức khỏe",128.0,9491238781491,250000,250000,0,0,20,bach-hoa-online
162969869,"Yến Mạch Quaker Oats Old Fashion 4,52kg (Dạng Hạt Cán Dẹt) - Thực phẩm ăn kiêng hỗ trợ giảm cân tốt cho sức khỏe",95.0,2600045346486,250000,250000,0,0,8,bach-hoa-online
140579038,Mì Hảo Hảo Tôm Xào Chua Ngọt thùng 30 gói,274.0,8735867138373,145000,145000,0,0,50,bach-hoa-online
138101958,"Combo 2 Sản Phẩm Gạo  ST25 Túi 5Kg - Gạo Ông Cua, Đặc Sản Sóc Trăng",1369.0,7596266383750,475000,475000,0,0,102,bach-hoa-online
125918663,Tương ớt Cholimex chai pet 270g,388.0,8337835202412,12400,12400,0,0,10,bach-hoa-online
125858376,Sa tế tôm cholimex 450g,172.0,1039265262521,37000,37000,0,0,11,bach-hoa-online
110250734,Set Chè Dưỡng Nhan Giải Nhiệt 12 Vị Thơm Ngon Bổ Dưỡng DTFood,406.0,4189123691028,50000,50000,0,0,65,bach-hoa-online
108882784,Sốt mè rang kewpie chai 180 ml / Nước chấm xốt mè rang Rong nho ,241.0,2188369153809,35000,40000,5000,13,36,bach-hoa-online
105551873,Rong biển nấu canh Hàn Quốc 25G & 50G,399.0,6445218406249,41000,42000,1000,2,38,bach-hoa-online
87130751,Hạt Hạnh Nhân Rang Bơ DK Harvest Nhập Khẩu USA,103.0,2141844049659,93000,93000,0,0,17,bach-hoa-online
74729558,"Bột ngũ cốc Damtuh Hàn Quốc 900g (1 hộp 50 gói, mỗi gói 18g)",3.0,7809093447142,253000,253000,0,0,0,bach-hoa-online
73345804,Cà phê hạt Rang Trung Nguyên( Espresso Bịch 500gam),74.0,2052037695658,290000,290000,0,0,8,bach-hoa-online
68554583,Trà hắc kỷ tử - Kỷ tử đen (500gr),221.0,9377945881799,235000,235000,0,0,51,bach-hoa-online
62734188,Trung Nguyên Legend - Cà phê phin giấy Fusion Blend - Hộp 10 gói x 10gr,528.0,5939457130501,133000,148334,15334,10,31,bach-hoa-online
53306672,Trà Kỷ Tử Sấy Khô Mộc Sắc 100g,303.0,4490439992759,65000,65000,0,0,54,bach-hoa-online
52257723,Combo Trà ổi giảm cân Orihiro và Trà diếp cá thải độc mát gan Dokudami Orihio Nhật Bản,71.0,6086032582992,220000,220000,0,0,18,bach-hoa-online
31451473,"Nhân Hạt Óc Chó DK Harvest - Nhập khẩu USA/Chile - 100g, 200g, 400g",5912.0,5745304567693,85000,85000,0,0,701,bach-hoa-online
25200952,"Hạt Mix 8 loại hạt nhập khẩu DK HARVEST - Nhân hạt óc chó vàng, Nhân hạt óc chó đỏ, Hạnh nhân, Macca, Hạt điều, Hạt bí xanh tách vỏ, Hướng dương, Hạt dẻ cười.",4907.0,1721593423258,165000,165000,0,0,587,bach-hoa-online
13409476,Thùng 48 Hộp Sữa Uống Tiệt Trùng Dutch Lady Cô Gái Hà Lan Dâu (48 x 180ml),990.0,6710465075867,338000,552000,214000,39,141,bach-hoa-online
8082641,Đặc sản Tiền Giang - Gạo Đỗ Quyên Vinh Hiển 5kg - OCOP 4 SAO,4600.0,5626839560147,103000,108000,5000,5,357,bach-hoa-online
3116645,Gạo Thơm Lài Lotus Rice 2kg - Cơm mềm dẻo vừa - Chuẩn xuất khẩu,1525.0,6351397739726,60000,60000,0,0,132,bach-hoa-online
1065004,Cà Phê Cappuccino Hương Mocha Trung Nguyên (Hộp 12 Gói),542.0,3651346459570,85000,85000,0,0,50,bach-hoa-online
1047710,Kẹo Hắc Sâm Vitamin Hàn Quốc (300g),1349.0,3781170931550,49000,49000,0,0,102,bach-hoa-online
566902,Hạt Nêm Aji-ngon Heo 900g,384.0,9303827500731,72900,75894,2994,4,46,bach-hoa-online
277597324,Cà Phê Blend Nguyên Chất Đất Cà Phê 500g - 70% Robusta & 30% Arabica | Pure Coffee Blend - Gu Hài Hòa,26.0,5393313409191,159000,295000,136000,46,0,bach-hoa-online
277484756, Socola đắng không đường Beryl's 99% ca cao thanh 90g,16.0,7723808996366,82500,82500,0,0,1,bach-hoa-online
276660338,"Five-Perkon 3S for pet dùng cho bệnh Parvo, Care, giảm bạch cầu, viêm phế quản truyền nhiễm, sát trùng",12.0,5289405381335,255000,255000,0,0,0,bach-hoa-online
276473616,"Cà Phê Specially Nguyên Chất 500g Đất Cà Phê - Robusta và Moka Cầu Đất, Gu Tinh Tế | Specially Roasted Coffee 500g",106.0,2755830580551,159000,295000,136000,46,5,bach-hoa-online
276432524,Nước tương MAGGI đậu nành thanh dịu 700ml,10.0,4065195309446,29100,34000,4900,14,1,bach-hoa-online
275677693,Cà phê viên nén Carraro Gourmet Blends – Hàng nhập khẩu từ Ý - Tương thích với máy Nespresso,34.0,1476206806284,92340,97200,4860,5,2,bach-hoa-online
273523195,Ngũ cốc ăn sáng CHEERIOS (Hộp 300g),84.0,1193057782491,89100,103000,13900,13,6,bach-hoa-online
273419094,Cà Phê Sữa NESCAFÉ Cà Phê Sữa Đá (Hộp 10 Gói x 24g),48.0,4501848527674,44000,60000,16000,27,1,bach-hoa-online
272635021,Cà phê hoà tan NESCAFÉ 3IN1 VỊ RANG ĐẬM - công thức cải tiến (hộp 20 gói x 16g),93.0,8769348427493,62500,89000,26500,30,8,bach-hoa-online
272634995,Cà phê hoà tan NESCAFÉ 3IN1 VỊ NGUYÊN BẢN - công thức cải tiến (hộp 20 gói x 16g ),113.0,3562620575380,66800,89000,22200,25,6,bach-hoa-online
252573356,Cà phê hòa tan đen( Không đường sữa) Espresso Hộp 100 gói King Coffee,76.0,9663853606712,370000,370000,0,0,9,bach-hoa-online
249713666,Rượu Đế Bình Tây 39% - 2 Lít,145.0,9506901628398,175000,175000,0,0,10,bach-hoa-online
193589005,Hạt Sen Khô Đồng Tháp Viettin Mart 500G,30.0,9032201987833,110200,190000,79800,42,2,bach-hoa-online
179439737,"Viên nén chăm sóc sức khỏe đặc biệt cho chó mèo - Bổ sung canxi, vi lượng, men tiêu hóa, dưỡng lông",62.0,1347097072368,1000,1000,0,0,5,bach-hoa-online
173299475,Chai Xịt Ve Rận Chó Mèo Vime-Frondog 250ml,39.0,1897359577893,120000,120000,0,0,1,bach-hoa-online
155890433,Hạt Điều Rang Muối Bình Phước Nguyên Hạt Size A Cồ - Hàng Loại 1 ( 01 kg-2 hộp),392.0,2661023243405,270000,270000,0,0,42,bach-hoa-online
143947377,"Viên nhai Nexgard trị ve rận, bọ chét cho chó (1 viên) - 10-25kg",53.0,7281281622898,188000,188000,0,0,4,bach-hoa-online
141651020,"Hạt mix 5 loại hạt dinh dưỡng ( Hạt macca, quả óc chó vàng, quả óc chó đỏ, hạnh nhân, hạt điều )",135.0,2855714136072,289000,320000,31000,10,22,bach-hoa-online
139187018,Pate Thịt hộp Meowow cho mèo| Giàu DHA và Omega-3 | Nhiều topping,928.0,3323696156599,35100,45000,9900,22,20,bach-hoa-online
134809025,Thùng 48 Hộp Sữa SoCola Lúa Mạch KUN 180ml/hộp,80.0,3504475053778,303000,378000,75000,20,16,bach-hoa-online
126218794,Cà phê hòa tan 3 in 1 Goodmorning cafe sữa uống liền (bịch 24 gói x 20gr) Trần Quang Coffe,268.0,9529478069827,56000,56000,0,0,20,bach-hoa-online
125918669,Xốt ướp xá xíu Cholimex gói 70g,359.0,5417486709003,7500,7500,0,0,7,bach-hoa-online
124069895,Dầu Đậu Nành cao cấp Golden 5 lít,1890.0,3714906847409,265000,265000,0,0,463,bach-hoa-online
121027167,"Hạt Mè đen Thuần chủng Tự nhiên Cao cấp Bảo Tâm - 150g, 250g, 500g",182.0,9853046558794,29000,29000,0,0,18,bach-hoa-online
117785876,"Cà phê AEROCO Blend, gói 250g, pha phin, nguyên chất 100% rang mộc hậu vị ngọt thơm quyến rũ",317.0,9794131605707,225000,225000,0,0,25,bach-hoa-online
110981370,Dầu Oliu nguyên chất ép lạnh Extra Virgin hiệu Naturel 250 ml,129.0,6349290859343,110000,126500,16500,13,12,bach-hoa-online
108151143,Sốt mè rang/ Rong nho tách nước/Nước chấm mè rang kewpie  gói nhỏ 15ml / Combo rong nho 100G,184.0,6366331280679,20000,39000,19000,49,20,bach-hoa-online
94418041,Đường Đen MOLA 1.5 Kg - Pha Chế Sữa Tươi Trân Châu Đường Đen,307.0,8788313118546,90000,90000,0,0,9,bach-hoa-online
70606907,"Nước yến sào win'sNest Junior 12% (4 hũ * 70 ml / Hộp) thích hợp cho mọi đối tượng, đặc biệt trẻ em biếng ăn",4904.0,7930638545099,99450,195000,95550,49,446,bach-hoa-online
68778070,"Gạo Basmati India (Ấn Độ), chỉ số đường huyết (GI) thấp, tốt cho người bị tiểu đường, Túi 5kg",396.0,9669212906497,290000,290000,0,0,51,bach-hoa-online
59504295,Dầu Ăn Thượng Hạng Nhãn Hiệu Neptune Light 1L/2L/5L,60708.0,7915089060162,113000,147333,34333,23,1734,bach-hoa-online
59202545,Xí muội ngọt - Vị chua ngọt - Ô Mai Đào Không Hạt 500gr),48.0,5466178594676,75000,75000,0,0,3,bach-hoa-online
58944255,Hạt Chia Hữu Cơ Australia Healthy Food & Nuts Organic Chia Seeds (250g)  - QuaTangMe Extaste,219.0,2203834848109,99000,99000,0,0,41,bach-hoa-online
58407240,Trung Nguyên Legend - Cà phê rang xay Sáng tạo 3 - Bịch 340gr,2203.0,4119509124622,119000,130192,11192,9,136,bach-hoa-online
57708325,1 HỘP NƯỚC DỪA  DỨA VICO FRESH 330ML,1390.0,1625695922834,22000,22000,0,0,80,bach-hoa-online
54513683,Chè dây cao bằng loại nhiều tuyết nhiều lá - Gói 500gr,342.0,1893280222120,59000,59000,0,0,46,bach-hoa-online
45490330,Cà Phê Hòa Tan 100% Đen Thuần Khiết KING COFFEE - Hộp 150 gói x 2g,695.0,7815695049745,286000,301000,15000,5,126,bach-hoa-online
42013180,Hạt điều rang muối vỏ lụa sviet - sài gòn,182.0,3820491757361,106000,106000,0,0,32,bach-hoa-online
22553303,Nước mắm Khải Hoàn Phú Quốc 43 độ đam 205ml thùng 6 chai,59.0,7068819091599,365000,365000,0,0,19,bach-hoa-online
484446,Bánh Xương Chăm Sóc Răng Dành Cho Chó Nhỏ Pedigree-56g,3117.0,1503715132657,33100,50000,16900,34,32,bach-hoa-online
276777266,Sữa yến mạch nguyên chất Oatside (200ml),15.0,5643096200600,13000,13000,0,0,0,bach-hoa-online
276392895,"Rong biển kẹp hạt dinh dưỡng ăn kiêng giảm cân Mộc Lan Healthy Foods - 250g, 500g",17.0,2611539940774,108000,135000,27000,20,3,bach-hoa-online
275952558,Táo Đỏ Tân Cương Sấy Giòn Không Hạt 250g VietTin Mart,14.0,5547963449803,55600,100000,44400,44,2,bach-hoa-online
275806818,"Trà Đông Trùng Hạ Thảo Tứ Vị Táo Đỏ Sunbeleaf – Bồi Bổ Cơ Thể, Bổ Khí Huyết, Tốt Cho Tim Mạch, Chống Lão Hóa – Hộp 10 Đến 20 Gói",13.0,4845109122662,89000,178000,89000,50,4,bach-hoa-online
275516352,[DTT] 50 hũ 50% ( Kèm 10 hũ) Yến chưng chọn vị- Yến sào Đỗ Thị Toán,9.0,1506835927883,1369000,2600000,1231000,47,0,bach-hoa-online
275454792,"Lược Chải Lông, Đẩy Lông Cho Chó Mèo CLEAN giúp sạch lông,Chải sạch lông 1 cách hiệu quả, không gây rối, không làm xước da thú cưng",17.0,1486081434998,48000,48000,0,0,1,bach-hoa-online
275362211,"Snack gạo lứt ngũ cốc nguyên hạt GUfoods - Không đường, Không chiên dầu, Không gluten, Thanh đạm, Lành mạnh, Phù hợp Eat clean, Ăn vặt healthy, Tiện lợi, Thuần chay",112.0,2225913353839,24900,24900,0,0,8,bach-hoa-online
275244474,Bột Nêm Thịt Gà Ajinomoto 1kg,0.0,5326763887735,116000,116000,0,0,1,bach-hoa-online
274851727,Sữa Bột Dành Cho Người Bị Tiểu Đường Glucerna Abbott Hoa Kì Hương Vani 380g/400g,40.0,6389581403245,429000,500000,71000,14,3,bach-hoa-online
274765123,"Thức Ăn Cho Chó Trưởng Thành Pedigree Adult 1+ Years Vị Gà, Rau Củ 1.5kg/Túi",34.0,5103845961175,113000,119000,6000,5,1,bach-hoa-online
274045549,Bánh Mochi YUKI&LOVE tổng hợp ''Beautiful Girl'' Mixed Mochi 300g,45.0,4610170456247,133000,140400,7400,5,4,bach-hoa-online
273127189,Combo 3 Cà Phê Hạt Full City Roast Highlands Coffee 1kg ,0.0,5972105516926,1950000,1950000,0,0,6,bach-hoa-online
260827289,"Cà phê Espresso E1 1Kg Nguyên Hạt, cafe chuyên biệt cho pha máy, giá sỉ dành cho chủ quán từ Message Coffee",78.0,3518895365877,385000,480000,95000,20,12,bach-hoa-online
196856253,Hạt Dưa sạch Thái Sơn rang củi không nhuộm màu ngon đặc biệt 1Kg loại bì vàng HD1MV,217.0,2805375279374,176000,176000,0,0,19,bach-hoa-online
182294741,1kg Hộp - Royal Canin Dry Mix Feeding Thức Ăn Cho Mèo Trưởng Thành ,95.0,7213038867176,226666,226666,0,0,2,bach-hoa-online
161409473,Thùng 48 hộp sữa tươi tiệt trùng Dalatmilk ít đường 110 ml (110 ml x 48),604.0,8848331294032,271200,271200,0,0,84,bach-hoa-online
153768302,Kẹo ngậm đau họng Ricola Shweizer Krauterzucker tạo cảm giác dịu nhẹ và thơm mát miệng và cổ họng - QuaTangMe Extaste,399.0,6234356940734,158000,158000,0,0,74,bach-hoa-online
145506034,TRÀ TRÁI KHỔ QUA RỪNG hũ 100g & hũ 120g - HƯƠNG SEN VIỆT,110.0,8037686500421,150000,150000,0,0,10,bach-hoa-online
137753154,Thức ăn hạt cho mèo Natural Core C3 Bene 3012 | Thịt gà và Cá hồi | Tốt cho tiết niệu và tim mạch | Ngăn ngừa dị ứng | Chính hãng Hàn Quốc,317.0,2238493735066,266400,370000,103600,28,25,bach-hoa-online
107018017,Bánh Dinh Dưỡng Mumsure 165 gam  bibica vị cam - Sản phẩm dinh dưỡng dành cho phụ nữ mang thai,126.0,1838988599989,33237,37769,4532,12,15,bach-hoa-online
70633549,500gram Bột Baking Soda Đa Công Dụng TETE,2918.0,2595580255707,29000,29000,0,0,457,bach-hoa-online
58863735,Bột CaCao Nguyên Chất Cao Cấp DTFood 500g,616.0,4545864797841,75000,75000,0,0,129,bach-hoa-online
58405972,Trung Nguyên Legend - Cà phê rang xay Sáng tạo 8 - Hộp 250gr,1177.0,8808131606830,275000,315388,40388,13,112,bach-hoa-online
58389098,Trung Nguyên Legend - Cà phê hoà tan rang xay Cappuccino Coconut - Hộp 12 gói x 18gr,1733.0,5327498069018,75000,85874,10874,13,133,bach-hoa-online
56669841,"Mật ong cao cấp xuất khẩu Hoa Xuyến Chi Phúc Khang Hũ (500g) - Hàng Chính Hãng  - Mật ong sạch, mật ong cao cấp đạt tiêu chuẩn xuất khẩu - Bồi bổ cơ thể, tăng sức đề kháng",203.0,5384417572189,129000,129000,0,0,33,bach-hoa-online
55625510,Táo Đỏ Tân Cương Dried Jujube DK Harvest,5755.0,2521869148842,69000,69000,0,0,783,bach-hoa-online
53268663,Gạo Hạt Ngọc Trời Lứt Tím 1Kg,285.0,2127824080884,55000,55000,0,0,36,bach-hoa-online
52855014,"Combo 2 lon Sữa bột Bonecare xương và khớp 400g: dành cho người lớn bổ sung GLUCOSAMINE tạo dịch nhờn cho khớp, giúp phòng ngừa đau xương khớp, viêm khớp, đặc biệt là người bệnh xương và khớp.",2768.0,6532225940662,293400,489000,195600,40,430,bach-hoa-online
51571077,200gr Trà kỷ tử - Câu kỷ tử - Loại cao cấp,1340.0,6336801676361,59000,59000,0,0,285,bach-hoa-online
51571008,Trà kỷ tử - Câu kỷ tử - Loại cao cấp (500gr),980.0,3972724668484,129000,129000,0,0,191,bach-hoa-online
45812218,Bột diếp cá nguyên chất Goce - 72g (24 gói x 3g),1714.0,6133856792059,144500,170000,25500,15,182,bach-hoa-online
45263525,500gr Trà atiso đỏ,1.0,2015018239999,179000,179000,0,0,0,bach-hoa-online
32380314,COMBO 2 HŨ 1KG ĐẬU PHỘNG TỎI ỚT THƠM NGON (HŨ PET),747.0,3936505034479,130000,200000,70000,35,163,bach-hoa-online
26027110,Hạt Chia Shots hữu cơ Smile Nuts gói nhỏ tiện dụng (8g x 10 gói) - Organic Chia Seed Shots (8g x 10 bag) ,1419.0,6392958131900,35000,45500,10500,23,109,bach-hoa-online
20697897,"Thùng 12 Hộp Sữa Đậu Đen, Óc Chó, Hạnh Nhân Sahmyook Foods (950ml/Hộp)",1110.0,8646221119583,597000,879000,282000,32,206,bach-hoa-online
16344129,Ngăn phóng uế FAY Repell 200ml Xua đuổi chó mèo,894.0,8854231880977,58000,58000,0,0,105,bach-hoa-online
14709221,Trà Shan Tuyết Cổ Thụ Tà Xùa Lộc Tân Cương (100gr),186.0,8720332131785,119000,119000,0,0,24,bach-hoa-online
11336852,Muối Hồng Himalaya Nhập Khẩu Pakistan Loại Mịn (Túi 1kg),311.0,3228059135451,125000,139000,14000,10,65,bach-hoa-online
701964, Đồ Ăn Khô Cho Chó Trưởng Thành Hương Vị Thịt Bò Nướng SmartHeart (3kg),460.0,4737576615098,175000,175000,0,0,62,bach-hoa-online
658774,Đồ Ăn Cho Mèo Vị Cá Biển Whiskas Dạng Bao (7kg),690.0,4731674424965,625000,665000,40000,6,68,bach-hoa-online
277316388,Kẹo Dẻo Vị Cam Bổ Sung Vitamin và Lợi Khuẩn Genki Fami Nhật Bản Gói 28 Cái,9.0,2781481337113,108000,132000,24000,18,0,bach-hoa-online
276674851,"Xịt Khử Mùi, Khử Khuẩn Nước Tiểu Chó Mèo - Nano Bạc Khử Sạch Mùi Hôi An Toàn Cho Thú Cưng & Gia Đình",8.0,4585314105976,69000,69000,0,0,0,bach-hoa-online
276596571,"Five-Azicin for pet dùng cho bệnh nhiễm khuẩn hô hấp, tiêu hóa, da, mô mềm.",7.0,4073059197701,80000,80000,0,0,0,bach-hoa-online
276580838,"Áo Thun Ba lỗ cho Chó Mèo, Mỏng, nhẹ, Áo cho Thú Cưng",14.0,5412641791754,23999,23999,0,0,0,bach-hoa-online
276432512,Dầu hào cao cấp Maggi bào ngư mới,5.0,7660740037444,29100,31000,1900,6,0,bach-hoa-online
276138356,Cà phê viên nén Carraro - Single Origin Blend - Nhập khẩu từ Ý - Tương thích máy capsule Nespresso,22.0,1305261154014,92340,97200,4860,5,0,bach-hoa-online
276105392,Tã Lót Chuồng Miếng Lót Vệ Sinh Chó Mèo Thấm Hút Siêu Nhanh - Yonapets,47.0,4543478367007,127500,127500,0,0,2,bach-hoa-online
275945776,[TẶNG TÚI ĐA NĂNG] Thùng 48 hộp sữa lúa mạch Nestlé® MILO® Ít đường 180ml (8 hộp/lốc),13.0,2058948098361,378000,450000,72000,16,1,bach-hoa-online
275751025,"Sườn Chay Loại Ngon ( 1 Kg và 5 Kg ) , Thực Phẩm Chay Thành Phần Tự Nhiên Không Chất Bảo Quản Không Biến Đổi Gen Sườn Non Chay Làng Me",25.0,1428089425063,193700,193700,0,0,5,bach-hoa-online
275262052,Muối mè đậu phộng - hạt điều Mộc Lan (hũ 500g),20.0,8309367803762,96000,120000,24000,20,4,bach-hoa-online
275244478,Hạt Nêm Aji-ngon Gà 900g,4.0,2474494994346,69000,80000,11000,14,0,bach-hoa-online
274173481,"[Tặng Hộp đựng ngũ cốc 950ml] Ngũ cốc ăn sáng Fitnesse Granola Diêm Mạch, Hạnh Nhân & Sô Cô La (gói 300g)",12.0,5276003380165,113000,142000,29000,20,2,bach-hoa-online
274160719,"Cát Vệ Sinh Cho Mèo Nhiều Mùi Hương, Vón Nhanh Công Nghệ Hàn Quốc - W.O.N 8.8L",105.0,2683456120155,65000,65000,0,0,8,bach-hoa-online
252283623,Ngũ Cốc Yến Mạch Hạnh Nhân Hạt Chia Xuân An [ít đường] Túi 400G {25g*16 gói}(Tặng Kèm 1 Túi Yến Mạch 150G),81.0,2090544626865,67000,67000,0,0,1,bach-hoa-online
214163270,Combo Cà Phê Bột Truyền Thống Highlands Coffee 1kg và gói 200gr,120.0,1402216696728,529000,529000,0,0,9,bach-hoa-online
211949298,"Gạo Đặc Sản ST25 Trạng Nguyên – Dẻo nhiều, dai cơm, thơm dứa - Chuẩn HACCP, VietGAP",70.0,8381134626033,185000,192000,7000,4,8,bach-hoa-online
197636993,Thùng 48 Bịch Sữa Tươi Tiệt Trùng Dutch Lady Cô Gái Hà Lan Hương Socola 180ml,282.0,6415963166731,280000,433000,153000,35,41,bach-hoa-online
186312553,500g cà phê Arabica Cầu Đất dạng bột,175.0,7699252836947,189000,189000,0,0,16,bach-hoa-online
184247666,"Sữa xương khớp ,bổ sung canxi cal gold 400g topten milk",32.0,9338239497936,290000,290000,0,0,4,bach-hoa-online
166498708,Đặc Sản Kon Tum - Khổ qua rừng nguyên trái hỗ trợ tiểu đường hiệu quả - OCOP 3 Sao,100.0,7407654043444,144000,144000,0,0,9,bach-hoa-online
152815132,Hỗ trợ giảm đau họng Ricola Shweizer Krauterzucker chứa 13 loại thảo mộc đem đến cảm giác dịu nhẹ cổ họng và thơm mát (dạng kẹo) - OZ Slim Store,242.0,9594155269750,159000,159000,0,0,43,bach-hoa-online
142320916,1 set Trà sữa Trân châu đường đen Yoki 50g,146.0,8062131223151,12000,12000,0,0,13,bach-hoa-online
142310107,Cà Phê Arabica Cầu Đất Rang Mộc DalatFarm - Hộp 250Gr,636.0,8039468208889,170000,170000,0,0,63,bach-hoa-online
133683743,Dầu Đậu Nành Meizan  1L/2L/5L,10029.0,6848148572089,53000,65000,12000,18,380,bach-hoa-online
114467211,Thùng Fristi Hương Táo 48x80ml,1622.0,7040920381859,167000,255000,88000,35,70,bach-hoa-online
76526881,[HCM] Nước Cốt Chanh Thai Lime 500ml,195.0,3845077181972,55000,55000,0,0,9,bach-hoa-online
59201430,Ô mai Mơ - Xí muội mặn có hạt (200gr),8.0,9501343918515,57000,57000,0,0,0,bach-hoa-online
58910120,cafe LeeLong2 gu đậm (70 Robusta / 30 Arabica) 1kg,177.0,3943930117806,289000,289000,0,0,41,bach-hoa-online
56417254,Muối Hồng Himalaya DK Harvest,1553.0,1882418807230,119000,119000,0,0,320,bach-hoa-online
44901147,"Hạt Bí Xanh (Đã Tách Vỏ) Nhập Khẩu – DK Harvest - 100% nguyên chất và không ướp muối - 250g, 500g",2256.0,1501234816447,49000,49000,0,0,338,bach-hoa-online
33395816,Giấm táo hữu cơ Bragg 473ml,25.0,3953502693898,185000,185000,0,0,2,bach-hoa-online
29936637,Bột trà xanh Matcha Gold - túi 100g,48.0,9470072712261,185000,185000,0,0,9,bach-hoa-online
27929101,Thùng 30 Gói Mì Cung Đình Kool Spaghetti (105g X 30 Gói),186.0,9225937440465,236000,274000,38000,14,23,bach-hoa-online
10710958,Thùng 48 Hộp Sữa Tươi Tiệt Trùng Vinamilk 100% Có Đường (180ml),25.0,1761303380198,380000,380000,0,0,1,bach-hoa-online
10409781,Cà Phê Rang Xay Moka Highlands Coffee (200g),1026.0,9224416414409,138000,138000,0,0,28,bach-hoa-online
10298123,Khử mùi chuồng trại FAY Deodor - 650ml,33.0,6090362699398,105000,105000,0,0,2,bach-hoa-online
5444935,Bột Tỏi Natas Hũ 65g-Bột Gia Vị Tiện Dụng,315.0,4555698160636,20000,20000,0,0,38,bach-hoa-online
2454173,Sữa đặc có đường Dutch Lady cao cấp 380g,1397.0,2330680723738,34000,36000,2000,6,29,bach-hoa-online
1088274,Muối Hồng Himalaya Dạng Nhuyễn (500g) – Theo Tiêu Chuẩn Muối Ăn Bộ Y Tế,992.0,3744843206133,69000,90000,21000,23,72,bach-hoa-online
658751,Đồ Ăn Cho Chó Con Vị Gà Và Trứng Pedigree (8kg),224.0,4736858912528,520000,520000,0,0,25,bach-hoa-online
257855333,"Xà Đơn Treo Tường 60-150cm Gắn Cửa Đa Năng Độ Dài Tùy Chỉnh Giúp Bạn Tập Gym, Tập Cơ Bụng, Cơ Vai, Cơ Xô treo tường gắn cửa độ dài tùy chỉnh (hàng nhập khẩu)",933.0,4969196127032,99000,159000,60000,38,92,the-thao-da-ngoai
249568290,BG - thanh xà đơn gắn khung cửa 60-100cm Steel Pipe Pull Up Bar Doorway Chin Up Bar Horizontal Bar Home Gym maximum 150kg (hàng nhập khẩu）,18.0,6772981705375,99000,159000,60000,38,4,the-thao-da-ngoai
16974932,"Kính bơi chống tia UV , Chống sương mù , bảo vệ mắt YESURE Cleacco, Dây đeo được làm 100% silicone mềm mại, thoải mái, dành cho vận động viên chuyên nghiệp hoặc người có sở thích đi bơi - Hàng Chính Hãng",3546.0,1725311615550,249000,249000,0,0,649,the-thao-da-ngoai
257859695,"BG Bộ xà đơn, xà kép đa năng cao cấp đa năng Gym, lượng Kéo lên tại nhà dụng cụ tập thể dục phòng gym (hàng nhập khẩu)",533.0,1318317323393,1899000,3599000,1700000,47,164,the-thao-da-ngoai
273634436,"BG - Máy Chạy Bộ Trên Không Cỡ Lớn,Xe đạp thể thao, xe đạp gấp gọn người lớn tùy chỉnh độ nặng, tập thể dục tại nhà Chịu Lực Tốt Siêu Bền",123.0,3854427720620,1330000,1529000,199000,13,42,the-thao-da-ngoai
277449385,"Chiếu Bạc Ngủ Trưa Văn Phòng, Tấm Thảm Trải Lót Bạc Gấp Gọn Cách Nhiệt Du Lịch",6.0,3038614491928,69000,69000,0,0,1,the-thao-da-ngoai
277406265,"Con lăn tập bụng thế hệ mới RW001 có trợ lực, chống trơn trượt,dụng cụ plank tập gym giúp eo thon gọn hàng cao cấp",4.0,6684604001464,159000,159000,0,0,0,the-thao-da-ngoai
277397295,"( 1 ĐÔI )Quấn Cổ Tay Tập Xà Đơn Có Móc sắt sơn tỉnh điện,Hỗ trợ Tập Xà đơn Tập Tạ",12.0,1372756416974,119000,129000,10000,8,0,the-thao-da-ngoai
276745179,Nón Bơi ConQuest 100% Silicone Cao Cấp Trơn Siêu Co Giãn,4.0,5865201543402,45000,90000,45000,50,0,the-thao-da-ngoai
276635087,[Hoả tốc] Vợt pickleball Carbon T700 cao cấp phù hợp cho mọi người - Tặng kèm 2 trái banh Pickleball,26.0,2541206579201,545000,950000,405000,43,1,the-thao-da-ngoai
270974477,"BG Máy Chạy Bộ Điện Gia Đình Nhỏ Gọn, Gấp lại tiện lợi,  Màn Hình Điện Tử Có Điều Khiển ( hàng nhập khẩu)",59.0,6272169587683,1710000,2999000,1289000,43,16,the-thao-da-ngoai
272863081,"Giày thể thao nam, giày chạy bộ nam phong cách mới – GNA2012",32.0,5587061888832,290000,580000,290000,50,6,the-thao-da-ngoai
272310515,Xà đơn treo tường gắn cửa Cleacco bọc đệm PVC chống trượt BORO SPORT,586.0,4236447513375,379000,379000,0,0,9,the-thao-da-ngoai
273843185,"Thảm tập yoga chính hãng Yvonne, Geometric (TẶNG KÈM 3 PHẦN QUÀ) dày 4mm, bề mặt nhám, siêu bám, chống trơn trượt, thấm hút mồ hôi, càng nhiều mồ hôi càng bám, dễ vệ sinh, bề đẹp, sang trọng",0.0,9202700806809,1650000,1650000,0,0,0,the-thao-da-ngoai
175146761,"Phao tập bơi liền thân cho bé 2-10 tuổi, Áo phao tập bơi trẻ em, Phao tay đỡ ngực bé trai bé gái - Chính hãng MINIIN (Giao họa tiết, mẫu ngẫu nhiên)",313.0,9175096972021,175000,175000,0,0,37,the-thao-da-ngoai
276621406,"Dây Tập Bụng,Dây Kéo Đàn Hồi Kháng Lực  Ống Cao Su, Dây Kéo Tập Gym,Dây Đa Năng Tập Bụng, Thể Dục",19.0,1052363211109,49000,79000,30000,38,0,the-thao-da-ngoai
276603360,"Bóng pickleball chuẩn thi đấu, loại bóng đúc liền khối, 40 lỗ, 26 gram, đường kính 74mm, độ nảy ổn định, độ bền cao",89.0,9654590080271,20000,20000,0,0,1,the-thao-da-ngoai
275955767,"BG- Ghế ngoài trời S12 có túi đeo,có thể gập lại,Ghế cắm trại,ghế di động,ghế bãi biển,ghế dã ngoại",20.0,1632206010577,129000,199000,70000,35,1,the-thao-da-ngoai
275716418,"Bình Xăng Thơm Zippo Loại Xịn Chính Hãng 125ml Dùng Cho Hộp Quẹt Zippo, Bật Lửa Zippo Chuyên Dụng",108.0,8807483298146,70000,70000,0,0,11,the-thao-da-ngoai
274527087,"Quần bơi nam 2 lớp cao cấp, quần thể thao nam YUKE-YK12 (Hàng Chính Hãng)",69.0,3574115781978,115000,119000,4000,3,14,the-thao-da-ngoai
249568455,BG - thanh xà đơn gắn khung cửa 80-130cm Steel Pipe Pull Up Bar Doorway Chin Up Bar Horizontal Bar Home Gym maximum 150kg (hàng nhập khẩu）,3.0,9637194231647,199000,259000,60000,23,1,the-thao-da-ngoai
249848974,"BG Xà Đơn Treo Tường Gắn Cửa Đa Năng Độ Dài Tùy Chỉnh Giúp Bạn Tập Gym, Tập Cơ Bụng, Cơ Vai, Cơ Xô 60-150Cm - Chính Hãng",6.0,5961050446388,99000,159000,60000,38,0,the-thao-da-ngoai
68399004,"Băng Bảo Vệ Đầu Gối Bó Cơ VN09, Băng Gối Thể Thao Cao Cấp VNS (1 Đôi)",2707.0,3025994104463,128000,150000,22000,15,537,the-thao-da-ngoai
187619110,"Đèn Pin Đội Đầu Siêu Sáng US ARMY T6 Bóng Led,  Đa Chức Năng, Không Thấm Nước Dung Lượng Pin 5800 mAh Có Thể Sạc Lại Công Suất Đèn  10W- HÀNG CHÍNH HÃNG",435.0,9358507692558,149500,299000,149500,50,94,the-thao-da-ngoai
275307332,"Xà đơn treo tường gắn cửa đa năng cao cấp tập thể dục tại nhà,Tay Cầm Bọc Đệm PVC Chống Trượt",23.0,8656724925687,99000,151000,52000,34,0,the-thao-da-ngoai
274437898,Bộ Kìm Bóp Tay Đếm Số Điện Tử - Dụng Cụ Tập Gym Tập Cơ Bắp Cổ Tay Cao Cấp Tại Nhà Điều Chỉnh Lực Từ 10-100kg Phiên Bản Nâng Cấp- Hàng chính hãng ( Màu ngẫu nhiên),31.0,6730831008995,95200,154000,58800,38,4,the-thao-da-ngoai
262018137,"Kính Bơi Tráng Gương kèm bịt tai cao cấp VinBuy chống sương mù, chống tia UV Hàng chính hãng - Tặng kèm nón bơi Silicon (Màu ngẫu nhiên)",161.0,9546097869671,300000,300000,0,0,23,the-thao-da-ngoai
258669858,"Dụng Cụ Hít Đất Chống Đẩy 9 in 1,Dụng cụ tập hít đất đa năng nhiều Bài Tập Theo Màu Sắc-Vòng yoga 33cm-Bóng Tập Yoga, Bóng Yoga Tròn Cỡ Đại 65-Gậy Tập Yoga Chống Gù Lưng, Mở Vaicm Cao Cấp-(hàng nhập khẩu)",2188.0,3008640051279,191000,201000,10000,5,363,the-thao-da-ngoai
255464257,"Gu Energy Gel – Gói Gel Bổ Sung Năng Lượng Thể Thao Đạp Xe, Leo Núi, Trekking",380.0,6292292907213,35000,35000,0,0,4,the-thao-da-ngoai
252759382,Băng đô đeo cổ tay chặn mồ hôi thể thao Aolikes A0235 Chính hãng,60.0,5948969205229,25000,25000,0,0,1,the-thao-da-ngoai
252674181,Dây Cao Su Kháng Lực Powerband Tập Toàn Thân Chính Hãng miDoctor,15.0,1029331985711,29000,29000,0,0,0,the-thao-da-ngoai
249944288,"Quần bơi nam boxer  Cleacco màu đen Camo , chất vải  Poly co giãn 4 chiều , thoáng khí , thoát nước nhanh BORO SPORT - Tặng nón bơi vải",96.0,6915449692244,129000,129000,0,0,12,the-thao-da-ngoai
249941461,"Quần bơi lửng boxer dài cho nam Cleacco màu đen Camo , chất vải  Poly co giãn 4 chiều , thoáng khí , thoát nước nhanh BORO SPORT - Tặng nón bơi vải",106.0,5142615592502,129000,129000,0,0,14,the-thao-da-ngoai
217154667,"Băng Bảo Vệ Cổ Chân, Băng Quấn Cổ Chân, Đai Quấn Bảo Vệ Mắt Cá Chân Teement, Mỏng Nhẹ, Miếng Dán Chắc Chắn - Hàng Chính Hãng",378.0,6041125802286,120000,120000,0,0,42,the-thao-da-ngoai
214661792,Xăng Zippo (125ml) - Chính hãng 100%,605.0,6261716547174,84000,84000,0,0,49,the-thao-da-ngoai
181712934,Dụng Cụ Nhảy Dây Tập Thể Dục Chất Liệu PVC 2m7 Tùy Ý Điều Chỉnh Kích Thước - Chính Hãng ,25.0,4631746553852,39000,78000,39000,50,1,the-thao-da-ngoai
116410179,Áo Sát Nách Thể Thao Nam Tập Gym - Chất Liệu Thun Lỗ Kim Cao Cấp SZone SA108S,54.0,5308762066316,99000,99000,0,0,4,the-thao-da-ngoai
106893083,"Áo thun nam cổ tròn tay ngắn, chất thun lạnh mềm mát, thấm hút mồ hôi, thoải mái vận động – FORMEN SHOP – FMTY002",278.0,5538525913456,49000,159000,110000,69,56,the-thao-da-ngoai
87962285,Băng bảo vệ đầu gối Rhino 7718 (1 Đôi) Bó gối thể thao Đai bảo vệ khớp gối - Hàng chính hãng dành cho cả nam và nữ,216.0,2216940520865,97000,97000,0,0,49,the-thao-da-ngoai
77578726,"Găng Tay tập Gym Có dây Quấn Trợ Lực Cổ Tay VNS002 (WEIGHT LIFTING GLOVES), Găng Tay Tập Gym Cao Cấp Có Phủ Da Trên Mu bàn Tay, Chống Chai Sần Lòng Bàn Tay, Bảo Vệ Khớp Cổ Tay",69.0,7511042727724,225000,450000,225000,50,13,the-thao-da-ngoai
72129045,Băng cổ tay thấm mồ hôi cao cấp Aolikes - Tom Sport ,437.0,7991988190407,25000,25000,0,0,73,the-thao-da-ngoai
68837035,"Băng Quấn Tay Boxing Glofit GBX009 ( 5m ), Băng Đa Quấn Tay Võ Thuật Cao Cấp Glofit ( Một Đôi )",220.0,4616363150571,140000,250000,110000,44,38,the-thao-da-ngoai
55053644,"Kính bơi chống tia UV , Chống sương mù , bảo vệ mắt Cleacco, dành cho vận động viên chuyên nghiệp hoặc người có sở thích đi bơi mỗi ngày, màu sắc đa dạng - Hàng Chính Hãng",848.0,9676202938499,249000,348600,99600,29,150,the-thao-da-ngoai
28050767,Đồ Chơi Bóng Rổ Trẻ Em Cho Bé Trụ Sắt Kèm 2 Bóng - Chính Hãng Amalife,661.0,6732787018247,239000,239000,0,0,145,the-thao-da-ngoai
23307420,Quần bơi nam Vải dày đẹp - Quần bơi hè mẫu mới hot,1077.0,2276777646026,55000,55000,0,0,161,the-thao-da-ngoai
19585135,Kính Bơi Cận View V510,487.0,2490804076673,429000,720000,291000,40,109,the-thao-da-ngoai
16719308,"Quần Bơi Nam Thiết Kế Vảy Cá Mập Yesure Chống Thấm Nước , Nhanh Khô  Tặng Kèm Nón Bơi và Bịt Tai Silicon Cao Cấp ",929.0,1645279419352,129000,129000,0,0,120,the-thao-da-ngoai
11763808,"Kính Bơi Cận (CÓ THỂ LỆCH ĐỘ), Chống TRẦY, Chống UV, Chống Hấp Hơi",1238.0,1614740311907,118000,118000,0,0,157,the-thao-da-ngoai
6936677,"Combo đi phượt Chita CT1 - Goinglink cao cấp tiện dụng (Nón bảo hiểm, găng tay, khăn đa năng)",155.0,6183464877679,355000,355000,0,0,10,the-thao-da-ngoai
3941727,Chai xịt làm nóng cơ Starbalm - Hà Lan 150ml,28.0,8946974882520,215000,360000,145000,40,5,the-thao-da-ngoai
793832,Cặp Vợt Cầu Lông HT VHTTC - Tím ,187.0,5013751148315,316000,316000,0,0,21,the-thao-da-ngoai
277033812,Đệm Hơi Dã Ngoại Naturehike FC11- FC12 Đệm Đôi Đệm Đơn Cắm Trại Siêu Nhẹ,3.0,4521414540046,890000,890000,0,0,0,the-thao-da-ngoai
276861483,Bình xịt vệ sinh mặt vợt AKpro Pickleball,18.0,4651406051553,99000,99000,0,0,3,the-thao-da-ngoai
276704887,Nón Bơi ConQuest 100% Silicone Cao Cấp Có Gai Siêu Co Giãn,3.0,5206376179686,68000,135000,67000,50,0,the-thao-da-ngoai
276546514,Con Lăn 4 Bánh RW099 - RW100 Tập Bụng Trợ Lực Thế Hệ Mới - Khuỷu Tay - Plank Tại Nhà,14.0,9365051856553,272000,399000,127000,32,0,the-thao-da-ngoai
275863336,"Bịt mắt ngủ cao cấp AOLIKES MZ037 vải dệt kim cao cấp mềm mại, đàn hồi, thoáng khí",5.0,7339020715086,89000,159000,70000,44,2,the-thao-da-ngoai
275840855,"Đai đeo cánh tay phản quang có đèn led an toàn khi chạy bộ, đạp xe vào ban đêm - Băng đeo tay phản quang - Hàng chính hãng",3.0,3251865118989,52000,65000,13000,20,0,the-thao-da-ngoai
275376501,"Đai Treo Kéo Giãn Cột Sống Lưng, Đai Kéo Giãn Cột Sống - BẢN CẢI TIẾN - Cải Thiện Thoát Vị, Thoái Hóa...",25.0,6087401721773,275000,350000,75000,21,2,the-thao-da-ngoai
274824704,"Kính Bơi Tráng Gương kèm bịt tai cao cấp GroFa chống sương mù, chống tia UV Hàng chính hãng - Tặng kèm nón bơi Silicon (Màu ngẫu nhiên)",25.0,6101712987318,119000,119000,0,0,5,the-thao-da-ngoai
274603724,"Kính bơi người lớn YUKE 6032(Tặng Kèm Hộp), chống tia UV, chống sương, độ nét cao - ( 1 đổi 1 trong 7 ngày)",15.0,2999051252448,119000,119000,0,0,1,the-thao-da-ngoai
257845274,"Tạ đôi, Tạ tay (Chọn Lực Nặng Của Tạ 20kg ,30kg, 40kg Tùy chọn) tập tay đẩy kết hợp, tạ nam nữ tập gym tập thon tay Giá tốt Hàng Chuẩn ( hàng nhập khẩu）",1762.0,1896130112322,279000,429000,150000,35,563,the-thao-da-ngoai
190522787,"Băng Gối Thể Thao VNSPORT - VN011 (NEW) Bảo Vệ Tốt Hơn - Cao Cấp Hơn - Thiết Kế Đẹp Hơn, Phù Hợp Cho tất Cả Các Bộ Môn Thể Thao",78.0,2646069693634,128000,150000,22000,15,7,the-thao-da-ngoai
273843173,"Thảm tập yoga chính hãng Yvonne hoạ tiết Mandala (TẶNG KÈM 3 PHẦN QUÀ) dày 4mm, bề mặt nhám, siêu bám, chống trơn trượt, thấm hút mồ hôi, càng nhiều mồ hôi càng bám, dễ vệ sinh, bề đẹp, sang trọng",1.0,5367843688754,1650000,1650000,0,0,0,the-thao-da-ngoai
273711057,"Gậy Leo Núi Hợp Kim Nhôm, siêu nhẹ 230g, gấp gọn 30cm tiện lợi đem theo đi dã ngoại, trekking, phượt - Hãng dododios",15.0,2793842916268,118000,118000,0,0,1,the-thao-da-ngoai
273634235,"Miếng lót,Đệm Lót Khủy Tay dày 8mm - Gối Tập Yoga, Đệm PAD Cao Su Hỗ Trợ Giảm Đau Đầu Gối và Các Tư Thế YOGA",29.0,5311428058064,35000,60000,25000,42,1,the-thao-da-ngoai
273423770,"Thảm tập yoga gym  siêu dày 10mm & 15mm  chất liệu cao su NBR tập thể dục tại nhà, đệm văn phòng, thảm dã ngoại du lịch",60.0,8334730144042,157000,319000,162000,51,10,the-thao-da-ngoai
272620692,Gel Uống Bổ Sung Năng Lượng GU Energy Gel 32g/gói - Hổ trợ đạp xe và chạy bộ,1132.0,1562933894571,45000,45000,0,0,38,the-thao-da-ngoai
272445135,Sữa tăng cơ Rule 1 Protein Isolate/ Hydrolysate 1.9lb,115.0,2411540314162,900000,900000,0,0,19,the-thao-da-ngoai
272444481,Sữa tăng cơ Rule 1 Whey Blend 64-69 servings - 2.2kg tặng Rule 1 Shaker,207.0,7064693778572,1600000,1600000,0,0,62,the-thao-da-ngoai
270534727,Giày Thể Thao Thông Dụng Nam Nữ Biti's Basic BSM000600TRG/BSW000600TRG (Trắng),81.0,9627429567585,320000,350000,30000,9,19,the-thao-da-ngoai
270266406,Áo phao bơm hơi dạng vòng dùng tập bơi,9.0,3273867165773,150000,198000,48000,24,0,the-thao-da-ngoai
263066841,"Tạ đôi, Tạ tay + Tạ Đẩy kết hợp (2 in 1) 40kg tập tay đẩy kết hợp, tạ nam nữ tập gym ( hàng nhập khẩu）",79.0,1410521219878,248000,359000,111000,31,16,the-thao-da-ngoai
253412818,"BG Kìm Bóp Tay Có Đếm 5-60kg , Kìm Tập Cơ Tay, Kìm bóp tập tay dụng cụ hỗ trợ tập cơ tay, cẳng tay, Dụng Cụ Tập Gym Tại Nhà Điều Chỉnh Lực",223.0,6474533870934,40000,79000,39000,49,36,the-thao-da-ngoai
247245506,Áo Sát Nách Nam Tanktop áo thun ba lỗ cổ tròn tập gym U04,11.0,4743265285019,120000,120000,0,0,0,the-thao-da-ngoai
242741693,Con Lăn Yoga Massage Foarm Roller Ống Trụ Xốp Tập Thể Thao Giãn Cơ Có gai Roam Rollet Cao Cấp Chính Hãng Amalife,56.0,3927148200371,83500,83500,0,0,5,the-thao-da-ngoai
193549764,"Dây nhảy thể thao lõi thép cao cấp eXtreme DN101 tự động đếm số, tích hợp đo calo, quãng đường, độ dài dây tùy chỉnh, nhảy dây thể dục - Hàng chính hãng",344.0,2712388941538,79000,99999,20999,21,28,the-thao-da-ngoai
193268444,"Băng đầu gối, bó gối thể thao đàn hồi GoodFit GF518K",0.0,9755427093278,150000,150000,0,0,0,the-thao-da-ngoai
191375822,"Lều cắm trại tự bung , lều du lịch dã ngoại dành cho 3-5 người hoặc 6-8 người, chống thấm nước",16.0,9655538047716,945000,945000,0,0,2,the-thao-da-ngoai
186233104,"Còi Đồng Thể Thao Cao Cấp ARMY,Còi Đồng Huấn Luyện Viên, Trọng Tài Tiếng Kêu To Và Vang , Dùng Cho Hoạt Động Thể Thao Hàng Chính Hãng(HÌNH ẢNH TRUNG THỰC)",19.0,7587855208828,178000,178000,0,0,0,the-thao-da-ngoai
125448524,Đai bảo vệ đầu gối chạy bộ AOLIKES YE-7901 thiết kế kiểu Nhật Bản Knee Support Braces,80.0,9894791060943,189000,299000,110000,37,11,the-thao-da-ngoai
120423751,"Dây nhảy thể thao lõi thép cao cấp Rhino J501 tự động đếm số, tích hợp đo calo, quãng đường, độ dài dây tùy chỉnh - Dùng cho Muay | Boxing | Kickboxing - Hàng chính hãng",1027.0,9413981106625,89000,129000,40000,31,233,the-thao-da-ngoai
106791443,"Áo thun nam cổ tròn tay ngắn, chất thun lạnh mềm mát, thấm hút mồ hôi, thoải mái vận động – FORMEN SHOP – FMTY001",360.0,9662483935498,49000,89000,40000,45,72,the-thao-da-ngoai
102154941,Thảm Tập Yoga TPE 2 Lớp PEAFLO Cao Cấp dày 6mm Kèm Túi,578.0,1496595489929,129000,165000,36000,22,91,the-thao-da-ngoai
78514426,Khăn ống đa năng cotton tube co giãn 9 kiểu dùng có video hướng dẫn (chọn kiểu),13.0,5196298214789,15000,15000,0,0,2,the-thao-da-ngoai
67237288,Bộ Xà Đơn P90X Có Thêm Móc Để Treo Bao Cát (Tặng Kèm Kìm Bóp Cơ Tay Lực 5-60kg)- Xà Đơn Đa Năng Khoan Tường Có 6 Mút Tay Cầm Phiên Bản Cải Tiến Cao Cấp ,381.0,8795048845431,300000,600000,300000,50,103,the-thao-da-ngoai
43764552,Găng Tay Tập Gym Glofit GFST004. Găng Tay Tập Gym Cao Cấp Cho Nam Nữ (Hàng Chính Hãng),319.0,6468345863195,390000,490000,100000,20,77,the-thao-da-ngoai
38413079,"Thảm Tập Yoga, Gym Amalife 2 Lớp + Túi Đựng Thảm Tập Yoga Dây Buộc Thảm Tập Yoga (Giao Màu Ngẫu Nhiên)",854.0,7761825970178,99900,99900,0,0,185,the-thao-da-ngoai
16981203,"Băng Trán, Băng Đô Chặn Mồ Hôi Thể Thao Nam Nữ Sport Anti-Slip Sweatband AOLIKES YE-2101 - Hàng Chính Hãng",7.0,9416821970162,38000,38000,0,0,0,the-thao-da-ngoai
8073271,Mũ bơi người lớn cao cấp Aolikes AL5010,421.0,6052055019401,65000,65000,0,0,49,the-thao-da-ngoai
2282607,Xăng Zippo (125ml),554.0,4807455884966,90000,90000,0,0,67,the-thao-da-ngoai
277772039,"BG Sàn nhún, Đệm bật nhún cao cấp có tay cầm 50INCH Trampoline dành cho mọi lứa tuổi (hàng nhập khẩu)",45.0,3785198590060,1199000,1999000,800000,40,4,the-thao-da-ngoai
277542561,Bộ vợt 2 pickleball Và 4 Quả Bóng Pickleball Kèm túi đựng Phụ Kiện Thể Thao,6.0,5700004476321,89000,89000,0,0,0,the-thao-da-ngoai
277396880,"Quấn cổ tay Có Móc( 1 ĐÔI ) - Tập kéo xà, tập Tạ - TP-7684 - Nâng Tạ,Tập Xà Đơn",4.0,6543304856635,109000,129000,20000,16,1,the-thao-da-ngoai
276939024,[TẶNG 3 CẦU] Vợt cầu lông cán liền cao cấp chính hãng Agnite -  Tặng hộp cầu nhựa và bao đựng - 2 chiếc - F2131,5.0,9670562146616,428000,770400,342400,44,0,the-thao-da-ngoai
276604030,"Bóng pickleball X-ace pro 40 chuẩn thi đấu, loại bóng đúc liền khối, 40 lỗ, 26 gram, đường kính 74mm, độ nảy ổn định, độ bền cao",116.0,8469208214133,26000,26000,0,0,0,the-thao-da-ngoai
276496310,Đèn Pin Đội Đầu 2 Bóng Siêu Sáng Q5 PaKaSa Kèm Sạc - Hàng Chính Hãng ,48.0,8127049644565,59000,118000,59000,50,3,the-thao-da-ngoai
276344477,"Lưới Lồng Bát Quái 6 Khung - 7 Khung, Dài 1m - 1m5, mắt 4ly Đánh Bắt Các Loại Tôm Lươn Cá Nhỏ",13.0,8411788854120,40000,40000,0,0,0,the-thao-da-ngoai
276181130,Bộ 2 Vợt Chơi Bóng Pickleball Siêu Nhẹ Và Nhanh Chóng Kèm Túi Đựng 4 Quả Bóng {gồm 4 bóng 1 túi ( 2 vợt)},28.0,5419952053830,389000,389000,0,0,3,the-thao-da-ngoai
276024346,"Rọ Bẫy Cá, Cua, Lươn, Tôm 8 Cửa Nhựa PP - Lồng Bẫy Tôm, Cua, Cá, Lươn, Trạch Hiệu Quả Cao",47.0,3483546369687,25000,39000,14000,36,0,the-thao-da-ngoai
275726197,"Băng Keo Thể Thao Chất Thun Co Giãn Hỗ Trợ Cơ Bắp, Khớp (Kinesiology Tape)",18.0,7586234682102,28500,30000,1500,5,2,the-thao-da-ngoai
275654449,Cước câu cá Nhật Bản tàng hình dây câu cá 100% Nylon Super power tải cá tốt dùng làm dây trục câu cá,36.0,7673879880265,35000,35000,0,0,4,the-thao-da-ngoai
275376675,Dụng Cụ Kéo Giãn Cột Sống Cổ - Đai Treo Cổ Tại Nhà,46.0,8960959697266,235000,275000,40000,15,4,the-thao-da-ngoai
275307026,"Bảng chống đẩy, Dụng cụ hít đất đa năng, hỗ trợ đồ chống đẩy có vạch chia bài tập gym thể thao trong nhà",12.0,7023067175073,89000,99000,10000,10,0,the-thao-da-ngoai
275255817,"Quần chạy bộ nam Kiotool 2 lớp thoáng khí, thấm hút mồ hôi và khô nhanh, thoải mái vận động",92.0,7095576401714,95000,95000,0,0,10,the-thao-da-ngoai
274807941,"Dụng Cụ Tập Cơ Bụng, Con lăn Tập GYM Thế Hệ Mới,Có Đồng Hồ Tự Động,Đàn Hồi Cho Nam,Nữ Tại Nhà(Tặng thảm+Cáp Sạc)",46.0,2638508084947,758000,758000,0,0,7,the-thao-da-ngoai
274430287,"Vợt Vớt Cá Tam Giác Inox Rút, Gấp Gọn Lưới Mùng Lỗ 5mm Dài 2m1 - 2m5",21.0,2185837677374,65000,65000,0,0,2,the-thao-da-ngoai
273566461,"BG Ghế cắm trại model SD3-SD5, câu cá,dã ngoại, du lịch, có thể gập lại, có túi ghế cắm trại ( hàng nhập khẩu)",139.0,6740196861762,59000,59000,0,0,13,the-thao-da-ngoai
272933024,"Kính bơi trẻ em chống tia UV bản rộng góc nhìn 180 độ Cleacco  SG1885 dây đeo silicone êm ái , không kích ứng , an toàn với trẻ em  - Hàng chính hãng Boro Sport",36.0,1587521672643,129000,208600,79600,38,3,the-thao-da-ngoai
272047645,"Set 3 chiết mỹ phẩm, dầu gội, sữa tắm mang đi du lịch siêu tiện lợi tặng kèm túi zip",110.0,8909712218371,39000,65000,26000,40,10,the-thao-da-ngoai
258497053,"Dụng cụ hỗ trợ chống đẩy, hít đất tập thể thao tại nhà kèm bàng chỉ dẫn theo màu sắc tập trung các nhóm cơ chính - Kèm dây đàn hồi tập đa năng (hàng nhập khẩu)",45.0,7092431748182,75000,79000,4000,5,5,the-thao-da-ngoai
251282239,Bình nhiên liệu mini Namilux (250 Gram/bình),157.0,5217783174915,33000,33000,0,0,1,the-thao-da-ngoai
230207546,Băng đô đeo cổ tay chặn mồ hôi thể thao Aolikes A0235 Chính hãng,113.0,1436917060431,25000,25000,0,0,16,the-thao-da-ngoai
206082913,Dụng Cụ Tập Cơ Tay Có Núm Điều Chỉnh Lực GroFa - Chính hãng,19.0,4666109303206,39000,39000,0,0,2,the-thao-da-ngoai
199058773,Vỏ Trụ Đấm Bốc Tự Cân Bằng Tặng Kèm Bơm Hơi - Trụ Đấm Bốc Cân Bằng Chính Hãng Amalife,30.0,2554640357361,172000,172000,0,0,1,the-thao-da-ngoai
194804899,Đèn Pin LED Đội Đầu Sạc USB - Chính Hãng ,12.0,3881290646345,75000,75000,0,0,3,the-thao-da-ngoai
155021614,Kính bơi chống sương mù có nút bịt tai cao cấp Tặng kèm mũ bơi - HENRYSA (màu sắc ngẫu nhiên),46.0,1645291134534,126500,190000,63500,33,6,the-thao-da-ngoai
95278227,THUN GIỮ CUỐN CÁN VỢT TENNIS BABOLAT (giao màu ngẫu nhiên ),86.0,1277332323273,45000,45000,0,0,6,the-thao-da-ngoai
94867193,"Khung Nắn Chỉnh Cột Sống, Khung Định Hình Cột Sống, Dụng Cụ Hỗ Trợ Thoát Vị Đĩa Đệm, Đau Mỏi Lưng, Đau Vai Gáy - Chính Hãng VinBuy",652.0,2040065995671,86000,160000,74000,46,138,the-thao-da-ngoai
89754166,"Kìm Bóp Tay, Dụng Cụ Tập Cơ Tay Cao Cấp, Kìm Tập Gym Bấm Số Tự Động (5-60 Kg) Hàng Cao Cấp Tay Cầm Dài ",505.0,3981336952819,39000,39000,0,0,72,the-thao-da-ngoai
89475796,"Xà đơn treo tường, gắn cửa 2021 điều chỉnh 72cm-110cm và 93cm-140cm nặng 2kg, 2.8kg -Mẫu TG02",268.0,4018226697197,227000,227000,0,0,73,the-thao-da-ngoai
86999917,Băng bảo vệ đầu gối Rhino P7720 (1 Đôi) Bó gối thể thao Đai bảo vệ đầu gối khớp gối Băng quấn đầu gối khớp gối hàng chính hãng dành cho cả nam và nữ,382.0,2379606294944,99000,99000,0,0,82,the-thao-da-ngoai
85095747,Giày Bata Học Sinh Học Thể Dục Chạy Bộ Cao Cấp,198.0,4297840555118,250000,250000,0,0,74,the-thao-da-ngoai
76673066,"Băng Bảo Vệ Khớp Gối Thể Thao 360º VN017 | ATHLETE'S KNEE PROTECTOR ( 1 ĐÔI ). Phù hợp đá banh, chạy bộ, bóng chuyền, bóng rổ, cầu lông, leo núi, đạp xe, tập luyện thể hình, chấn thương đau nhức gối",204.0,2477128120801,290000,500000,210000,42,55,the-thao-da-ngoai
54624624,Combo 1 xăng 1 đá zippo chính hãng Mỹ bao bì mới,648.0,3311799771376,160000,160000,0,0,177,the-thao-da-ngoai
50707951,Bộ 2 Tạ Tập Tay Nhựa VN Sportslink - Xanh,7689.0,6847685095174,20000,20000,0,0,242,the-thao-da-ngoai
41333562,GEL LÀM NÓNG STARBALM WARM GEL,21.0,4075959550179,170000,220000,50000,23,7,the-thao-da-ngoai
39065778,Khăn rằn thời trang Cambodia Caro BlacknWhite 60x180cm (Trắng đen),59.0,5772643791205,70000,70000,0,0,3,the-thao-da-ngoai
21947276,Thảm Tập YoGa miDoctor + Bao Thảm Tập Yoga + Dây Thảm Tập Yoga (Giao Màu Ngẫu Nhiên),13491.0,7239853490109,112000,112000,0,0,2310,the-thao-da-ngoai
13853076,Túi Ngủ Cao Cấp Văn Phòng + Đi Phượt GSTN02 (Hàng Xuất Khẩu),1393.0,9368152722463,389000,389000,0,0,225,the-thao-da-ngoai
708419,Bao Tay Tập Yoga Chống Trượt Sportslink,269.0,1120647917765,54000,54000,0,0,8,the-thao-da-ngoai
276937639,"[Hộp 6 quả] Cầu lông nhựa chính hãng Agnite - siêu bền - phù hợp tập luyện, chơi thể thao - F2212",8.0,3017077213084,72000,129600,57600,44,0,the-thao-da-ngoai
276508642,"Kìm Bóp Tay, Kìm Tập Cơ Tay, Dụng Cụ Tập Gym Tại Nhà Điều Chỉnh Lực Có Đếm 10-60kg",3.0,2409248926158,35000,35000,0,0,1,the-thao-da-ngoai
275874608,"Tất Vớ Chạy Bộ Cao Cấp AOLIKES JCB3008 Thoáng Khí, Chống Trượt Tối Ưu",3.0,6852288348685,79000,149000,70000,47,0,the-thao-da-ngoai
275235511,Kính Bơi Góc Rộng VIEW V800 Chống Tia UV Chống Sương Mù - Hàng chính hãng 100% sản xuất tại Nhật Bản,11.0,3696827534236,359000,595000,236000,40,3,the-thao-da-ngoai
274470368,"Túi đeo tay đựng điện thoại chạy bộ, túi đeo chéo đựng đồ dùng dành cho nam và nữ phong cách thể thao ngoài trời",21.0,4214993341228,99000,99000,0,0,0,the-thao-da-ngoai
273848229,Đai Chống Gù Lưng Thể Thao Bảo Hành 12 Tháng Hỗ Trợ Tập Ngực Chống Gù Chữ X Giữ Form Khi Tập Cleacco DCGL Boro Sport,8.0,1216861101270,119000,154700,35700,23,3,the-thao-da-ngoai
271590145,"Vớ đệm lõm bàn chân giảm mỏi chân khi đi đứng quá lâu,  bảo vệ đôi chân của bạn - Buybox - BBPK289",12.0,5329645081804,77000,77000,0,0,2,the-thao-da-ngoai
257866630,"Bộ 2 tạ tay lõi sắt bọc cao su, tạ tập tay cao su 1kg 2kg 3kg 4kg 5kg BG (hàng nhập khẩu)",630.0,2328266006739,199000,299000,100000,33,126,the-thao-da-ngoai
207300691,Bình lắc Shaker Pha Whey Mass - LOGO MUSCLETECH & TC Sport Food - Màu Sắc Ngẫu Nhiên,190.0,3126422589088,99000,99000,0,0,12,the-thao-da-ngoai
206103327,"Dây Dù 10m Dùng Để Phơi Quần Áo , Cắm Trại Du Lịch Dã Ngoại GroFa ( Giao màu ngẫu nhiên)",45.0,5960155439814,19000,19000,0,0,2,the-thao-da-ngoai
205502926,Đai Bảo vệ Khớp Gối - Dây Chằng Gối - Sụn Chêm VNSPORT | VNS931 (NEW). Đai Bảo Vệ Đầu Gối Cao Cấp - Hàng Chính Hãng (1 Chiếc),496.0,7210761311289,270000,350000,80000,23,60,the-thao-da-ngoai
202009974,"10 dây quấn cán vợt cầu lông, dây quấn cán vợt tennis chống trượt thấm hút mồ hôi, tạo cảm giác êm ái và trợ lực khi đánh bóng - Chính hãng dododios",36.0,1524014110325,117000,117000,0,0,6,the-thao-da-ngoai
198246007,Tất vớ thể thao nam nữ cổ ngắn AOLIKES A-7599,14.0,2511736562494,79000,129000,50000,39,0,the-thao-da-ngoai
192987140,"Thanh Tập Chống Gù Lưng, Gậy Tập Yoga Chống Gù Lưng Bằng Thép Không Gỉ - Hàng Loại 1 - Chính Hãng MINIIN",54.0,8588609729376,99000,99000,0,0,7,the-thao-da-ngoai
192693103,Đai miếng bảo vệ đầu gối AOLIKES A-0219 Sponge knee protector,11.0,4775786526953,169000,299000,130000,43,2,the-thao-da-ngoai
177626346,"Con Lăn Massage Foam Gai Dẹt 45x14 cm Ống Lăn Giãn Cơ Tập Yoga, Gym",42.0,6874052560973,238000,238000,0,0,3,the-thao-da-ngoai
175850022,"Kìm Bóp Tay, Kìm Tập Cơ Tay, Dụng Cụ Tập Cơ Tay Tập Gym Điều Chỉnh Lực 10-60kg Có Đếm",107.0,1069313025220,58000,58000,0,0,10,the-thao-da-ngoai
164414622,Băng Cánh Tay Thể Thao VNSPORT - VNS006 (1 Chiếc),61.0,3193954768930,49000,90000,41000,46,10,the-thao-da-ngoai
161237585,"Bó Gối Dài Chính Hãng, Băng Gối Dài Thể Thao Ôm Cơ Glofit VN030A | Long Knee Sleeves Glofit VN030A (1 Chiếc)",287.0,5053029370969,180000,290000,110000,38,31,the-thao-da-ngoai
147406452,"Xà Đơn Treo Tường Gắn Cửa Điều Chỉnh Độ Dài Linh Hoạt, Mẫu Mới Chất Liệu Thép Không Gỉ Chịu Lực 150kg, Tay Cầm Bọc Đệm PVC Chống Trượt - Chính hãng dododios",249.0,4231293816028,362000,362000,0,0,50,the-thao-da-ngoai
115905451,"Dây Nhảy Thể Dục PVC Lõi Thép - YOGA QG, Có Thể Tùy Chỉnh Độ Dài Tối Đa 3m, Giúp Tăng Cường Thể Lực và Sự Dẻo Dai Của Cơ Thể",269.0,8098513975479,59000,59000,0,0,40,the-thao-da-ngoai
112332707,Đèn Pin Đội Đầu 3 Bóng Led T6 2 Pin Sạc 16850 - Hàng Chính Hãng ,20.0,4421904747896,146370,220000,73630,33,3,the-thao-da-ngoai
91205581,Quần bơi nam tam giác Sportslink Desmiit DMS01,25.0,7703327776383,165000,165000,0,0,6,the-thao-da-ngoai
87726995,Whey từ 7 loại protein Rule 1 Source 7 Protein 1.9lb,43.0,6032554603388,630000,630000,0,0,5,the-thao-da-ngoai
85025758,Quả bóng rổ cao su gerustar số 5,9.0,7666971685690,105000,105000,0,0,2,the-thao-da-ngoai
78513066,Khăn ống bandana cotton tube đa năng co giãn 9 kiểu dùng có video hướng dẫn,22.0,1688260999521,15000,15000,0,0,3,the-thao-da-ngoai
71929064,Mút ngực cho Áo tập Yoga Gym Hibi Sports MUT007 - Loại bầu siêu nâng - 1 cặp,447.0,3449469005183,40000,40000,0,0,42,the-thao-da-ngoai
67320997,"Bó gối thể thao, băng đầu gối đệm silicone, co giãn 4 chiều, thanh trợ lực lò xo GoodFit GF513K",12.0,8413137099427,165000,165000,0,0,1,the-thao-da-ngoai
54896822,"Kính bơi chống sương mờ, chống UV Cleacco, dây đeo được làm 100% silicone mềm mại, thoải mái, thiết kế không trơn trượt, độ co giãn và độ bền thách thức thời gian, dành cho vận động viên chuyên nghiệp hoặc người thích người đi bơi hằng ngày",2545.0,9058248109307,201000,201000,0,0,490,the-thao-da-ngoai
38303053,Giày vải đinh Thượng đình đá bóng màu đen BD16,89.0,5528647337297,129000,239000,110000,46,15,the-thao-da-ngoai
35813362,Thảm Yoga ADIDAS ADYG-10100,710.0,1261018216886,658000,769000,111000,14,59,the-thao-da-ngoai
33432482,Băng Bảo Vệ Đầu Gối Thể Thao Kneepad Aolikes AL-7718 (1 Đôi),57.0,6479486984496,99000,99000,0,0,4,the-thao-da-ngoai
24471823,Kính Bơi Phoenix 203,78.0,3887641041091,47000,47000,0,0,14,the-thao-da-ngoai
6715255,Thảm Tập Yoga 2 Lớp - Tặng Kèm Túi Đựng Thảm,11.0,7025748365948,85000,85000,0,0,1,the-thao-da-ngoai
6537327,Sữa Whey Protein Hammer Nutrition 24 serving - Whey Isolate duy trì và phục hồi cơ nhanh chóng,33.0,9540298823215,1050000,1050000,0,0,7,the-thao-da-ngoai
6425767,Giày đá banh Prowin S50,86.0,8445959398853,169500,169500,0,0,2,the-thao-da-ngoai
1416813,Giày Thượng Đình KK14-1 White,62.0,9328891360098,105000,105000,0,0,11,the-thao-da-ngoai
708544,Dây Nhảy Muay - Boxing - Kickboxing Sportlink (2m6),1349.0,4938409469721,111000,111000,0,0,173,the-thao-da-ngoai
639504,Phao Tim Tập Bơi Sportslink PHAOTIM - Màu Ngẫu Nhiên,372.0,1157134163770,65000,113000,48000,42,21,the-thao-da-ngoai
276669624,Vợt Pickleball TOUR-SPEED Carbon T700,4.0,4234132117223,790000,790000,0,0,4,the-thao-da-ngoai
276634565,"[Hoả tốc Hà Nội] Vợt pickleball trẻ em sợi thuỷ tinh siêu nhẹ, tay cầm chống trơn trượt, bề mặt fiber glass - Hàng chính hãng",6.0,1720227240106,275000,450000,175000,39,1,the-thao-da-ngoai
276621450,Giày sneaker Thể Thao Nữ Biti's Hunter Street HSW008600NAD (Nâu đậm),1.0,3590215713191,687000,687000,0,0,0,the-thao-da-ngoai
276594544,Vợt Pickleball Franklin Sports Hàng chính hãng,2.0,6239434518661,2890000,2890000,0,0,0,the-thao-da-ngoai
276569144,Đèn Pin Đội Đầu Dây Vải Co Giãn Tích Hợp Pin Nhiều Chế Độ Sáng Kèm Sẵn Pin Và Sạc - Hàng chính hãng ,8.0,3956258154652,94000,94000,0,0,1,the-thao-da-ngoai
276224815,"Bóng rổ cao su Size 5,6,7 dành cho học sinh sinh viên tặng kèm lưới+kim bơm bóng",14.0,9333319294657,109000,109000,0,0,0,the-thao-da-ngoai
275727690,"Hộp Quẹt Zippo Trơn Bóng Cổ Điển Đẹp Mắt, Bật Lửa Zippo Trơn USA Đẹp Độc Lạ Thiết Kế Nhỏ Gọn",80.0,2727541549749,39000,39000,0,0,5,the-thao-da-ngoai
275126324,"Vợt pickleball AMA JP80, mặt vợt từ sợi carbon dày 13mm, tặng kèm bao da, cuốn cán, cuốn viền vợt và 2 bóng cao cấp",10.0,2166776248285,1836000,1836000,0,0,2,the-thao-da-ngoai
275080715,"Vợt Pickleball 3K Carbon dày 13,5mm bề mặt carbon nhám bám bóng đạt tiêu chuẩn USAPA ",21.0,4613436028318,750000,750000,0,0,3,the-thao-da-ngoai
274552379,Dây đeo BIB Thể Thao Chạy Bộ MOTIVE BIB,8.0,4620741656524,89000,89000,0,0,1,the-thao-da-ngoai
274020725,Túi Ngủ Có Mũ Naturehike Y150 NH21MSD08 Túi Ngủ 3 Mùa Siêu Nhẹ Xếp Gọn,5.0,6111903346505,485000,485000,0,0,1,the-thao-da-ngoai
273711216,"Combo 2 Vợt Bóng Bàn Tặng Kèm 3 Quả Bóng Bàn + Kẹp Trụ Lưới Bóng Bàn Rút Gọn Nhựa ABS 1,7m Chính Hãng dododios",7.0,5118247088101,307000,307000,0,0,1,the-thao-da-ngoai
272404400,Tấm Trải Du Lịch Cách Nhiệt Chống Nước Sportslink Nhiều Kích Cỡ ,592.0,6281556851210,47000,47000,0,0,19,the-thao-da-ngoai
272105880,Dây Kháng Lực Tập Gym Powerband Đàn Hồi Cao Su Tập Tay Và Tập Toàn Thân Chính Hãng PROIRON - SHOP TOÀN CHÂU,4.0,4210492336142,52000,52000,0,0,0,the-thao-da-ngoai
270646204,"Dây Nhảy Thể Thao Lõi Thép Cao Cấp Teement Tự Động Đếm Số, Tích Hợp Đo Calo, Quãng Đường, Độ Dài Dây Tùy Chỉnh - Kèm Bóng Xoay Và Tạ Điều Chỉnh Khối Lượng, Có Tay Cầm Chống Trượt Tiện Lợi - Hàng Chính Hãng",17.0,8172612959928,170000,170000,0,0,2,the-thao-da-ngoai
263581164,Kính Bơi Nhật Bản VIEW V610 Chống Tia UV Chống Sương Mù - Hàng Chính Hãng 100% Sản Xuất Tại Nhật Bản,50.0,5227484608327,295000,495000,200000,40,8,the-thao-da-ngoai
246730703,Quần short thể thao nam 2 lớp không xuyên thấu 3 trong 1 - Gym - Bơi-Ngủ,7.0,8347998248102,99000,99000,0,0,0,the-thao-da-ngoai
202605142,Mút Nâng Tam Giác Triangle Cho Áo Tập Yoga Gym Hibi Sports MUT010 - 1 Cặp,57.0,8475353257896,30000,30000,0,0,4,the-thao-da-ngoai
197368023,Đai chống ngủ ngáy AOLIKES A-2107 Stop Snoring belt,18.0,6493127349305,89000,159000,70000,44,1,the-thao-da-ngoai
191648646,Dây giày thông minh phản quang 3 vạch LiveFit Lock Laces không cần buột I vừa với mọi loại giày I Chất liệu dây Nylon bền chắc với thời gian,30.0,6085068803491,99000,99000,0,0,3,the-thao-da-ngoai
188915910,Quần đùi nam ngắn chạy bộ Fasvin R21451.HN vải Dù Gió nhẹ mát tiện dụng thể thao hay mặc nhà,242.0,3392513877233,85000,138000,53000,38,66,the-thao-da-ngoai
186218478,Ghế tập tạ đa năng kết hợp giá đỡ tạ (CHƯA BAO GỒM TẠ),8.0,6937163953581,3300000,3300000,0,0,0,the-thao-da-ngoai
185966772,Bộ Tăng Dã Ngoại Cắm Trại Lục Giác Naturehike NH16T012-S,9.0,7596849256616,1490000,1490000,0,0,1,the-thao-da-ngoai
184235684,Xà Đơn Treo Tường gắn Cửa Đa Năng PEAFLO,21.0,5398891091976,135000,190000,55000,29,2,the-thao-da-ngoai
176628987,"Bộ 2 Băng Tạ đeo cổ chân, cổ tay hỗ trợ tập thể thao, tập gym, chạy bộ ,Loại mới nhất năm",37.0,7647993898592,159000,159000,0,0,8,the-thao-da-ngoai
172538266,Bao Tay Tập Gym Có Đệm Tay Và Quấn Cổ Tay Chắc Chắn,18.0,8267579321088,145000,145000,0,0,4,the-thao-da-ngoai
162042284,Giàn Tạ Đa Năng Zasami Có xà đơn xà kép gồm 1 đòn tạ 1m5 - Lựa chọn mức tạ đĩa nhựa ngẫu nhiên,6.0,7028892688210,7700000,7700000,0,0,1,the-thao-da-ngoai
132171283,"Thảm Du Lịch Dã Ngoại Gấp Gọn Chống Thấm Nước 150 x 200cm - Thảm Gấp Gọn Du Lịch Đi Biển, Bạt Trải Picnic- Hàng Chính Hãng MINIIN",353.0,3508764610521,99000,99000,0,0,51,the-thao-da-ngoai
88216202,"Thanh xà đơn gắn cửa, xà đơn treo tường GoodFit chịu lực 200kg, chốt khóa an toàn chông trượt tập luyện tại nhà GF201PU",44.0,9519921810355,327000,327000,0,0,9,the-thao-da-ngoai
87094552,Vợt Tennis Babolat PURE STRIKE LiTE 265gram 3rd Gen (101408),1.0,6787500250796,4490000,4490000,0,0,1,the-thao-da-ngoai
84482722,Cuốn cán vợt cầu lông và TENNIS Joto màu ngẫu nhiên ,196.0,5425903211725,18000,18000,0,0,7,the-thao-da-ngoai
76528209,Quần giữ nhiệt COMBAT PRO Quần Legging Nam tập Gym bóng đá bóng rổ SQ518,606.0,1873061246538,89000,89000,0,0,82,the-thao-da-ngoai
68484619,Giày Bata Thể Thao Nam Nữ Cao Cấp,17.0,3654622868653,250000,250000,0,0,3,the-thao-da-ngoai
53497722,Bóng chuyền Molten V5M4200,67.0,6675039264583,664050,699000,34950,5,20,the-thao-da-ngoai
20847679,Bật lửa ZIPPO 207 –Bật lửa ZIPPO STREET CHROME,125.0,8200012781344,535000,535000,0,0,29,the-thao-da-ngoai
19584938,Kính Bơi View V560A,216.0,1731514068673,252000,385000,133000,35,40,the-thao-da-ngoai
6658395,Xe đạp tập thể dục kết hợp tay chân tập luyện trong nhà BG,1567.0,6511115375111,1682000,1699000,17000,1,297,the-thao-da-ngoai
6495813,Bật Lửa Zippo 1935 Replica Brushed Chrome 1935.25,15.0,2287400103137,955000,955000,0,0,4,the-thao-da-ngoai
2282571,Bộ 3 Xăng 2 Đá Zippo,9.0,2386029411729,380000,380000,0,0,2,the-thao-da-ngoai
1599729,Ghế Tập Bụng Cong Muse Màu Có Chốt Gập BG SU-118 (hàng nhập khẩu),1099.0,6542230229461,699000,1099000,400000,36,172,the-thao-da-ngoai
277406131,"BG - Thảm Tập Yoga cao cấp  TPE - 4MM  , chống trượt, thảm Tập Gym và Yoga Chuyên Nghiệp",4.0,6026711726951,59000,79000,20000,25,0,the-thao-da-ngoai
277304912,"Giày thể thao nam nữ, giày chạy bộ đế êm nhẹ, thoáng khí đế cao su đúc, chống trơn trượt hạn chế mòn  – G1013",1.0,9231015293717,710000,1420000,710000,50,0,the-thao-da-ngoai
276718958,Giày thể thao Biti's nam (39-45)1259k,1.0,3612676372252,1259000,1259000,0,0,0,the-thao-da-ngoai
276617033,"Giày Patin Trẻ Em Centosy Measin ,Có Bánh Đèn Phát Sáng, Tặng Kèm Cánh Thiên Thần",1.0,7528728101643,399000,550000,151000,27,0,the-thao-da-ngoai
275949678,"Quả bóng đá ngoại hạng Anh - Banh bóng đá da số 5 - Tặng bơm, kim bơm và túi lưới",7.0,8364096059290,300000,300000,0,0,0,the-thao-da-ngoai
275489681,Con lăn tập cơ bụng TDR95 1 bánh - Con lăn TDR100 2 bánh Perfect AB Carver Pro,11.0,1871146183672,109000,199000,90000,45,3,the-thao-da-ngoai
275322239,Bộ Kìm Bóp Tay Đếm Số Điện Tử - Dụng Cụ Tập Gym Tập Cơ Bắp Cổ Tay Cao Cấp Tại Nhà Điều Chỉnh Lực Từ 10-100kg,19.0,4004329157855,78000,78000,0,0,0,the-thao-da-ngoai
275270541,Thảm Tập Yoga 2 Lớp TPE 6mm Cao Cấp - Thảm Tập Gym và Yoga Chuyên Nghiệp QS - Giao ngẫu nhiên,39.0,5490986450825,109000,145000,36000,25,1,the-thao-da-ngoai
275155529,"Trụ bóng rổ học sinh TT01 điều chỉnh 205 -255cm tặng kèm quả bóng rổ số 5, trụ bóng rổ gia đình nhỏ gọn, tháo lắp dễ dàng",2.0,8028331701904,2389000,2389000,0,0,0,the-thao-da-ngoai
275135647,Kính bơi người lớn LI-NING tráng gương chống sương mù - Hàng chính hãng,12.0,8594998800732,219000,400000,181000,45,1,the-thao-da-ngoai
275113682,"Thảm xốp tập võ EVA dày 3cm, thảm xốp ghép 1m*1m, thảm trải sàn cho phòng tập, CLB võ thuật hoặc kê lót nền khi lắp đặt máy tập thể dục cho gia đình hoặc phòng tập Gym.",5.0,1716680461699,262000,262000,0,0,0,the-thao-da-ngoai
275045185,Bóng rổ Cao su AKpro ABX1 - màu Đen,6.0,8918914823585,114000,120000,6000,5,1,the-thao-da-ngoai
274470464,"Băng Keo Vá Lều Trại, Vải Dù, Vải Bạt, Chống Nước và Chống Rách",11.0,7639079622616,47500,50000,2500,5,2,the-thao-da-ngoai
273942102,Thực phẩm tăng cơ Rule 1 Protein Isolate/Hydrolysate 9.8lb tặng bình lắc R1 Shaker,92.0,9046931335707,3600000,3600000,0,0,23,the-thao-da-ngoai
272620721,Viên sủi điện giải GU Hydration Drink Tabs - 12v / ống - Hổ trợ đạp xe và chạy bộ,78.0,9714515372471,199000,199000,0,0,12,the-thao-da-ngoai
262731615,"Ghế Mini Gập Gọn Đút Túi, Ghế Câu Cá, Du Lịch, Cắm Trại, Ngồi Chờ Tàu Hỏa Chọn Màu – Chọn Size Chính Hãng miDoctor",14.0,3572030621612,98000,98000,0,0,3,the-thao-da-ngoai
261005322,Con lăn tập bụng trợ lực thế hệ mới - Chính hãng dododios,5.0,4071396433505,118000,118000,0,0,2,the-thao-da-ngoai
248683156,Iso Surge 5lbs - Sữa tăng cơ Whey Protein Iso Surge,3.0,7784446344655,1870000,1870000,0,0,0,the-thao-da-ngoai
214824208,Ghế Ngồi Câu Cá Xếp Gọn Ghế Dã Ngoại Picnic Camping Du Lịch Cắm Trại Ngoài Trời Có Thể Gấp Gọn Kèm Túi Đựng Agnite - Nhiều Màu Sắc Kích Cỡ - VS901 VS902,6.0,3998335791083,149000,322200,173200,54,0,the-thao-da-ngoai
206718630,"Nệm Gấp Ngủ Trưa Văn Phòng Tiện Lợi, Đệm Ngủ Trưa Văn Phòng Gấp Gọn - Nệm Ngủ Du Lịch Gấp Gọn - Đệm Gấp Kèm Túi",3.0,8668612075339,346500,350000,3500,1,0,the-thao-da-ngoai
196597277,Băng dán cơ thể thao Kinesiology Tape AOLIKES A-MT002,26.0,1176273613225,139000,199000,60000,30,2,the-thao-da-ngoai
184766241,Giày Bata Học Sinh Học Thể Dục Chạy Bộ Cao Cấp Mẫu Mới,19.0,1040397931612,249000,249000,0,0,3,the-thao-da-ngoai
152365362,￼Babolat Syntec Pro - quấn cốt trắng/đen (670051),9.0,6888662995941,249000,259000,10000,4,0,the-thao-da-ngoai
124895225,Giày thể thao chơi Cầu lông Promax PR-19004 Phân phối chính hãng,12.0,9332802732123,399000,550000,151000,27,6,the-thao-da-ngoai
115270977,"Dây Nhảy Tập Thể Dục Cao Cấp Tại Nhà Lõi Thép Cao Cấp, Viền Tay Cầm Hình Kim Cương Chính Hãng Cao Cấp KitAcoom",56.0,1635200363451,39000,39000,0,0,17,the-thao-da-ngoai
100369682,Quần đùi nam Fasvin Q20207.HN quần short thể thao vải gió chun chất lượng cao mềm mại thoáng mát không bai không xù,29.0,9248382253664,93000,170000,77000,45,1,the-thao-da-ngoai
95306626,Áo phao bơi hình đôi cánh cho bé Sportslink,24.0,2100824494815,115000,152000,37000,24,4,the-thao-da-ngoai
89877527,BĂNG BẢO VỆ KHỚP ĐẦU GỐI 360º VNSPORT - VN019 (Pro) - KNEE SUPPORT 360º VN019 PROFESSIONAL. Độc Quyền Tại VNSport - Hàng Cao Cấp Chính Hãng (1 Chiếc ),56.0,7062734978171,390000,490000,100000,20,9,the-thao-da-ngoai
89475840," Xà đơn treo tường, gắn cửa điều chỉnh 72cm - 105cm và 93cm-140cm nặng 2kg, 2.5kg(tặng găng tay tập xà dày)",15.0,5685969429064,478000,478000,0,0,4,the-thao-da-ngoai
71898962,Sữa bổ sung đạm dành cho người ăn chay Vegan Blend Protein Myprotein vị Chocolate - Nutrition Depot Vietnam,166.0,1014072486197,950000,990000,40000,4,45,the-thao-da-ngoai
70638093,BĂNG ĐẦU GỐI MUEllER GỌN NHẸ 58677,15.0,6284337536485,579000,590000,11000,2,3,the-thao-da-ngoai
66907970,"Xà Đơn  Treo Tường Gắn Cửa Điều Chỉnh Độ Dài Linh Hoạt ,Mẫu Mới Chất Liệu Thép Không Gỉ Chịu Lực 150kg , Tay Cầm Bọc Đệm PVC Chống Trượt",2796.0,9694566793455,670600,670600,0,0,740,the-thao-da-ngoai
51996077,Bật Lửa Zippo 49184 – Zippo Wood Mandala Design Brown,4.0,1524097196198,900000,900000,0,0,2,the-thao-da-ngoai
35346876,"Áo thể thao, đồ tập GYM nam ngắn tay 02",29.0,3347367499168,149000,149000,0,0,8,the-thao-da-ngoai
34562466,Bật Lửa ZIPPO KHẮC HỔ 05 – ZIPPO 250.HO05,1.0,4381344912409,915000,915000,0,0,0,the-thao-da-ngoai
12488652,Bó gối đai dán có nẹp neoprene United Medicare (F12),31.0,2309951658499,890000,990000,100000,10,8,the-thao-da-ngoai
10075672,Sữa tăng cơ Impact Whey Protein Myprotein 1kg - Nutrition Depot,375.0,5367902048390,920000,920000,0,0,84,the-thao-da-ngoai
3795621,Kính Bơi View V610,426.0,9838776199861,295000,495000,200000,40,74,the-thao-da-ngoai
2066903,Viên sủi điện giải  -  Hammer  Nutrition Endurolytes Fizz Vị  Bưởi HM199,80.0,9370535980988,179000,179000,0,0,12,the-thao-da-ngoai
1694261,Băng Bảo Vệ Đầu Gối Khi Chơi Thể Thao Sportslink Litian Loại Dài - Màu Lính ,105.0,1068663293930,59000,77000,18000,23,1,the-thao-da-ngoai
277400528,[NỮ] Áo Thun Thể Thao Chạy Bộ Nữ MOTIVE WM Mix Color T-Shirt - Màu Trắng,1.0,9085727032775,320000,320000,0,0,0,the-thao-da-ngoai
276634104,[Nữ] Quần Short Thể Thao Chạy Bộ Nữ MOTIVE WOMEN SHORT TRAINING (Có lót tam giác) - Xanh Rêu,1.0,9255848031806,350000,350000,0,0,0,the-thao-da-ngoai
276620817,Giày Thể Thao Nam Biti's Hunter Street HSM004700TRG (Trắng),1.0,9059104584647,693000,745000,52000,7,0,the-thao-da-ngoai
276594379,"Túi Nước Balo Trekking Naturehike CNK2450CF011 1,5L 2L 3L Kháng Khuẩn",2.0,7763654008549,280000,280000,0,0,0,the-thao-da-ngoai
276282321,"Đai võ karate - đai taekwondo, đai judo trơn không thêu chữ",17.0,5175930060184,30000,30000,0,0,0,the-thao-da-ngoai
275948509,Giày đá bóng Prowin H21 tặng kèm tất bóng đá chính hãng,1.0,2845796314953,239000,239000,0,0,0,the-thao-da-ngoai
275842294,Đai hỗ trợ nâng tạ cao cấp ADIDAS ADGB-1228,1.0,6055061744409,1110000,1290000,180000,14,0,the-thao-da-ngoai
275693226,Giày Thể Thao Nam Bitis hunter  X LiteDash 2k24 HSM007500 (tặng vớ cao cấp),3.0,7052625441526,1069000,1069000,0,0,0,the-thao-da-ngoai
275192924,"Dụng cụ tập bụng hút chân không, Dụng cụ tập cơ bụng đa năng có đế hút chân không siêu chắc và bền, TẶNG kèm thước dây (Giao màu ngẫu nhiên)",5.0,3286779922201,95000,95000,0,0,0,the-thao-da-ngoai
275158060,Gậy Bóng Chày BAT Hợp Kim Cao Cấp (25 inchs - 28 inchs),9.0,6206988797682,129000,129000,0,0,2,the-thao-da-ngoai
274474270,Băng Quấn Thể Thao Co Giãn Tự Dính Tiện Dụng - Hàng chính hãng dododios,3.0,5748836516913,174000,174000,0,0,1,the-thao-da-ngoai
274448144,Giỏ Đựng Cá _Rọng Đựng Cá_Túi Đựng Cá,14.0,5828490412740,40000,40000,0,0,0,the-thao-da-ngoai
274430200,Kéo cắt dây thẻo gấp gọn thép không rỉ,6.0,3329543030005,15000,15000,0,0,0,the-thao-da-ngoai
273844075,"Thảm tập yoga chính hãng Yvonne, Piha Beach (TẶNG KÈM 3 PHẦN QUÀ) dày 4mm, bề mặt nhám, siêu bám, chống trơn trượt, ưa mồ hôi",3.0,6925565220785,1650000,1650000,0,0,0,the-thao-da-ngoai
273688707,GIày cầu lông Mira chính hãng,9.0,1525217064914,359000,449000,90000,20,2,the-thao-da-ngoai
271392535,Viên Sủi GU ENERGY Hydration Drink Tabs - Ống 12 Viên - Bổ Sung Nước Và Điện Giải Khi Hoạt Động Thể Thao - Ống 12 viên,82.0,1853322029917,198999,198999,0,0,13,the-thao-da-ngoai
262731858,"Khung nắn chỉnh cột sống, chống thoát vị đĩa đệm, thoái hóa, đau lưng, vai gáy (Giao màu ngẫu nhiên) - Gai Nhỏ miDoctor",54.0,1840641447899,48000,48000,0,0,3,the-thao-da-ngoai
249006127,"Kìm Tập Cơ Tay, Kìm Bóp Tay, Phụ Kiện Hỗ Trợ Tập Gym Tại Nhà Điều Chỉnh Lực 10-60 KG - Chính hãng dododios",14.0,6308504297215,40000,40000,0,0,2,the-thao-da-ngoai
214730242,Giày Đá Bóng WIKA QH19 NEO Chính Hãng Da Microfiber  Mới 2025,1.0,1411516407687,420000,420000,0,0,0,the-thao-da-ngoai
207910621,Bình nước thể thao 550ml AOLIKES A-SC550 Water bottles,2.0,3983473157026,129000,219000,90000,41,1,the-thao-da-ngoai
203897935,"Bộ Băng Quấn Bảo Vệ Cổ Tay Cleacco Street Workout Wrist Wraps , Tập gym , Thể dục dụng cụ , Yoga , thiết kế quấn đặc biệt giúp cổ tay linh hoạt , giảm chấn thương – Hàng chính hãng .BORO SPORT",309.0,5859012428770,69000,110600,41600,38,56,the-thao-da-ngoai
195968541,Ba lô leo núi Sportslink - 68L,2.0,3637878508222,550000,690000,140000,20,0,the-thao-da-ngoai
194141041,Đai quấn bảo vệ mắt cá chân AOLIKES A-7130 chống lật cổ chân Sport ankle pads,12.0,9094965636128,159000,309000,150000,49,1,the-thao-da-ngoai
192909067,TẠ TAY SẮT BỌC CAO SU PROCARE,8.0,6589127684841,218000,218000,0,0,1,the-thao-da-ngoai
192395467,"Tất Chống Trượt Cao Cấp VNSPORT - VNS008 | Tất Tập Yoga, Tất Tập Múa Có Thiết Kế Hở Ngón Và Có Hạt Silicone Chống Trượt Lòng Bàn Chân. Sản Phẩm Cao Cấp Chính Hãng (1 Đôi)",33.0,4435816842588,75000,120000,45000,38,0,the-thao-da-ngoai
184475792, Dây nhảy đếm số Defeeat 6213,3.0,8387151109338,95000,95000,0,0,1,the-thao-da-ngoai
183500376,"Kính bơi chống sương mờ, chống UV, dây được làm 100% silicone mềm mại, thiết kế không trơn trượt, độ co giãn, độ bền thách thức thời gian, dành cho vận động viên chuyên nghiệp, kính bơi cận thị có độ - Chính hãng DODODIOS",832.0,5280632020687,96000,96000,0,0,126,the-thao-da-ngoai
183375288,Túi đựng bình nước giữ nhiệt có dây đeo tiện ích - HENRYSA,34.0,2704329354130,31900,58000,26100,45,8,the-thao-da-ngoai
178221433,"Tạ đĩa, tạ bánh gang Zasam lỗ tạ phi 27 với các mức tạ (  bánh )",65.0,5272363456965,300000,425000,125000,29,8,the-thao-da-ngoai
174662966,"Lăn Tập Cơ Bụng 2 Bánh VNSPORT - VN022, Tập Bụng 6 Múi Hiệu Quả, Đánh Tan Mỡ Bụng, Thon Gọn Vòng Eo (Hàng Chính Hãng)",8.0,2621177096017,220000,350000,130000,37,0,the-thao-da-ngoai
146628884,Con lăn tập cơ bụng - Con lăn tập bụng 4 bánh tặng kèm thảm tập (Giao màu ngẫu nhiên) - Chính hãng dododios,98.0,9904684454388,118000,118000,0,0,23,the-thao-da-ngoai
141816705, Bình nước xe đạp thể thao 500ml Cách Nhiệt Có Ống Hút,16.0,3212265550511,169000,169000,0,0,3,the-thao-da-ngoai
135434089,"[Loại Tốt – Lõi Thép] Dây nhảy thể dục có thể điều chỉnh dây, Dây nhảy lõi thép, không bị rối dùng để tập thể dục độ dài 2.9m, hỗ trợ giảm cân – Chính hãng Amalife",269.0,1680494472086,19300,19300,0,0,73,the-thao-da-ngoai
133562554,"Combo Khung Vành bóng rổ + quả bóng rổ Prostar cao cấp đủ kích cỡ + quả bóng rổ số 3,5,6,7 vành bóng rổ",1.0,3668631926056,259000,429000,170000,40,0,the-thao-da-ngoai
114011454,Băng Đô Chơi Thể Thao ️FREE SHIP️ Băng trán chơi thể thao Aolikes (1 Cái),24.0,3158342610396,31700,31700,0,0,0,the-thao-da-ngoai
109366925,[Riêng Tư] Túi Ngủ Cá Nhân KhoNCC Hàng Chính Hãng - Sử Dụng Tại Văn Phòng - Du Lịch Dã Ngoại - Gọn Nhẹ Tiện Lợi - KLM-TNVPDL (Nhiều màu),4.0,7290844548394,159000,228000,69000,30,0,the-thao-da-ngoai
53405655,Bộ 3 dây kháng lực tập cơ mông đùi chân Hip Resistance bands Aolikes YE-3604,80.0,9427048496359,319000,539000,220000,41,8,the-thao-da-ngoai
20346552,Bóng Phản Xạ Treo Đầu miDoctor - Bóng Phản Xạ Chính Hãng,661.0,1353891525534,89000,89000,0,0,111,the-thao-da-ngoai
13891977,Quấn Bảo Vệ Hỗ Trợ Khớp Cổ Tay Nam Nữ Khi Chơi Thể Thao Sport Pressure Wrist AOLIKES YE-7936,133.0,2525236364613,69000,119000,50000,42,10,the-thao-da-ngoai
277502472,"Xe trượt scooter cho trẻ em có  đèn, ghế ngồi 2in1 có giỏ đồ mẫu mới - Xe đồ chơi cho bé",1.0,6445554895087,285000,285000,0,0,1,the-thao-da-ngoai
277396742,Găng Tay Tập Gym Trợ Lực VALEO {Tặng Tước Dây} Dây Kéo Lưng Lifting Straps Deadlift Tập Tạ Tập Xà Hàng Chính Hãng (1 Đôi ),1.0,1040394105615,139000,159000,20000,13,1,the-thao-da-ngoai
276662303,VỢT PICKLEBALL SYPIK GEN 2 COLLECTION -2025,1.0,1221192416001,3999000,4590000,591000,13,0,the-thao-da-ngoai
276064010,BĂNG BẢO VỆ CÁNH TAY ADIDAS ADSL-1301BK,6.0,3959065100069,359000,359000,0,0,0,the-thao-da-ngoai
275586233,"Giày Pickleball Speed Art 28013 Trắng Xanh - Thiết Kế Hiện Đại, Êm, Nhẹ, Bảo Vệ Chân Tối Ưu, Chống Trượt Tốt",1.0,2203680691258,1100000,1100000,0,0,1,the-thao-da-ngoai
275338922,"Dây đeo thảm Yoga,dây buộc thảm Yoga gọn nhẹ.",1.0,7769914180023,175000,175000,0,0,1,the-thao-da-ngoai
275077426,"Giầy đá cầu da lộn 3 lớp, giầy mỏ vịt đá cầu tiêu chuẩn thi đấu T THIEN TRUONG SPORT ",6.0,6821376043995,448000,448000,0,0,0,the-thao-da-ngoai
274855672,"Giày Kumpoo E301 Chuyên dụng chơi bóng chuyền, cầu lông, bóng bàn, pickleball - Đế kếp 2 lớp cày sân betong siêu bền",2.0,3990646694841,669000,820000,151000,18,0,the-thao-da-ngoai
274170221,Chài Đĩa Bay Sợi Dù Mắt Mau Bắt Được Tất Cả Các Loại Tôm Cá Nhỏ - Tuấn Phi Fishing,22.0,1887725609113,200000,200000,0,0,1,the-thao-da-ngoai
274021621,Đai Lưng Quai Đeo Bảo Vệ Cột Sống Điều Chỉnh Tư Thế Lưng,10.0,8872137373380,145000,169000,24000,14,2,the-thao-da-ngoai
273937997,(Khám Phá) Mặt Nạ Lặn Cao Cấp KhoNCC Hàng Chính Hãng - Chống Sương Mù - Nhìn Bao Quát 180 độ Cho Trải Nghiệm Tuyệt Vời - KLM-MNLCC,2.0,9409127450509,209000,302000,93000,31,1,the-thao-da-ngoai
273880498,Túi ngủ đơn siêu nhẹ có mũ NatureHike NH20MSD07,10.0,4224942029012,470000,470000,0,0,1,the-thao-da-ngoai
273711120,Gậy Leo Núi Dã Ngoại Gậy Trekking Có Thể Điều Chỉnh Độ Cao Làm Từ Hợp Kim Nhôm Chắc Chắn - Hãng dododios,11.0,4878530882957,118000,118000,0,0,1,the-thao-da-ngoai
273439115,"Giày thể thao nam đế êm nhẹ, thoáng khí đế cao su đúc, chống trơn trượt hạn chế mòn  – BEE GEE - GNA2015",2.0,3720179965213,280000,560000,280000,50,0,the-thao-da-ngoai
263584917,Kính Bơi VIEW V730J Cho Trẻ Em Từ 4-9 Tuổi Chống Tia UV Chống Sương Mù - Hàng Chính Hãng 100% Sản Xuất Tại Nhật Bản,32.0,4888366492021,309000,509000,200000,39,2,the-thao-da-ngoai
261021593,"Gel Uống Bổ Sung Năng Lượng và Điện giải dành cho Chạy Bộ, Đạp Xe - GU Energy Hộp 24 gói Nhiều Mùi Vị",22.0,1382954280649,1152000,1152000,0,0,5,the-thao-da-ngoai
252674199,"Bình lắc inox shaker tập gym, tập thể thao, có giữ nhiệt và quai xách – Kèm Bóng Lò Xo Lắc - Chính hãng miDoctor",6.0,9334283810771,159000,159000,0,0,1,the-thao-da-ngoai
246730524,Quần Bơi Nam Đen Họa Tiết Vảy Cá Phong Cách Chuyên Nghiệp SZone SQB109,11.0,6988551766852,50000,50000,0,0,1,the-thao-da-ngoai
213958778,"Túi đeo bụng chạy bộ chống nước, đai đeo điện thoại chạy bộ, túi đeo hông chạy bộ phản quang, Túi đeo bụng chạy bộ đựng điện thoại chống nước chính hãng, Túi đeo hông chạy bộ thể thao nam, nữ , túi đeo bụng chạy bộ thiết kế dây nịt, không thấm nước",35.0,8960557571342,52000,52000,0,0,8,the-thao-da-ngoai
204330173,"Băng dán cơ thể thao Kinesiology - Chính hãng dododios, Băng keo thể thao quấn cổ chân giày đá bóng, băng bảo vệ cổ chân tự dính cuốn bó gối dán cơ thể thao cổ tay ngón tay, Băng Dán Cơ Thể Thao, Băng Keo Dán Cơ, Băng dán cơ, băng keo thể thao cao cấp",29.0,5061361752351,40000,40000,0,0,3,the-thao-da-ngoai
192483788,GOLF SWING IMPACT FULCRUM TEACHING (Gậy tập luyện điểm tựa impact) - Phiên bản tiêu chuẩn,4.0,8240297453722,1850000,1850000,0,0,0,the-thao-da-ngoai
188915353,Áo thun thể thao nam Fasvin TS20236.HN chất vải thoáng mát mềm mại,6.0,7844500437135,109500,219000,109500,50,1,the-thao-da-ngoai
188585791,"Dây Nhảy Thể Thao Lõi Thép Cao Cấp Besti Tự Động Đếm Số, Tích Hợp Đo Calo, Quãng Đường, Độ Dài Dây Tùy Chỉnh - Kèm Bóng Xoay Và Tạ Điều Chỉnh Khối Lượng - Hàng Chính Hãng",621.0,7765819848117,170000,170000,0,0,67,the-thao-da-ngoai
176623637,Đai Treo Kéo Giãn Cột Sống Chữa Thoát Vị Đĩa Đệm Chính Hãng Đại Nam Sport Thế Hệ Mới ( Chưa Kèm Xà),426.0,2948661784999,259000,259000,0,0,54,the-thao-da-ngoai
116817858,Cặp vợt cầu lông Sportslink Bokai BK-9105,8.0,9818922665719,179000,283000,104000,37,2,the-thao-da-ngoai
108701287,"Dây kháng lực loại dài AOLIKES A-3607 tập gym, yoga Long Resistance Bands",29.0,2028294571046,129000,229000,100000,44,4,the-thao-da-ngoai
96202540,Đai bảo vệ xương bánh chè đầu gối AOLIKES YE-7928 Sport compression patella band,49.0,5501677734018,159000,259000,100000,39,5,the-thao-da-ngoai
90835781,Đồng hồ giảm chấn Elbow -TENEX ELBOW SHOCK ABSORBER,14.0,3312583737854,2099000,2590000,491000,19,1,the-thao-da-ngoai
77149883,Giảm rung Babolat Flag Damp (700033) Màu ngẫu nhiên ,19.0,7738278679770,67000,67000,0,0,1,the-thao-da-ngoai
71197190,Băng Khủy Tay PJ 2 chiều ,10.0,9925376317341,35000,35000,0,0,2,the-thao-da-ngoai
58405491,DỤNG CỤ MASSAGE CHÂN BẰNG GỖ 6 ĐẠI TOANANH TA-6Đ,64.0,1812978977203,209000,259000,50000,19,12,the-thao-da-ngoai
48583619,Giày lội nước dã ngoại chống trượt PAN Goinglink M-1888,51.0,6856835456819,255000,383000,128000,33,9,the-thao-da-ngoai
35772549,Dây Nhảy Thể Dục Adidas ADRP-11011,141.0,9487057762357,702000,739000,37000,5,24,the-thao-da-ngoai
33979580,Kính Bơi Người Lớn Nam Nữ Cao Cấp miDoctor,965.0,9972050649021,88000,88000,0,0,230,the-thao-da-ngoai
33256023,Thảm Yoga Fitness Adidas 6mm ADMT-12237,13.0,2674999527657,1035000,1035000,0,0,0,the-thao-da-ngoai
27844774,"Khung Nắn Chỉnh Cột Sống, Khung Định Hình Cột Sống, Trị Thoát Vị Đĩa Đệm, Đau Lưng, Vai Gáy, Dụng Cụ Hỗ Trợ Tập Lưng - Chính Hãng Amalife - LƯỢN SÓNG",386.0,2703775277407,172900,172900,0,0,106,the-thao-da-ngoai
9996463,Combo Khung Bóng Rổ + Bóng + Lưới,61.0,2042299745192,259000,399000,140000,35,10,the-thao-da-ngoai
2282579,Bộ 2 Xăng 2 Đá Zippo,23.0,3973055278182,280000,280000,0,0,6,the-thao-da-ngoai
693450,Máy Tập Bụng New AB Slider ,27.0,4925807083284,199000,199000,0,0,0,the-thao-da-ngoai
277543032,"Dây nhảy tốc độ sport chất liệu PVC 6mm, Tập thể lực, Cadio tại nhà. Dây Nhảy Chống Xoắn",1.0,1044035636169,69000,69000,0,0,0,the-thao-da-ngoai
275940441,"Khăn lau kính nano chống bám hơi nước, chống mờ Sportslink",5.0,5754742178817,6000,10000,4000,40,0,the-thao-da-ngoai
275870138,Quần bơi dài nữ liền váy ngoài kín đáo chống nắng kín đáo,1.0,1057212023295,139000,139000,0,0,0,the-thao-da-ngoai
275654815,"Mặt Vợt Bóng Bàn Victas V20 Extra 47 Độ Xanh Lá - Ổn Đinh, Kiểm Soát Tốt, Tạo Ra Những Cú Đánh Xoáy Uy Lực",1.0,8401820797354,1120000,1120000,0,0,0,the-thao-da-ngoai
275589975,"Giày Pickleball Speed Art 28020 Trắng Đỏ - Chống Trượt, Êm Chân, Hiệu Suất Cao, Phong Cách Đẳng Cấp",1.0,2076453236086,1100000,1100000,0,0,1,the-thao-da-ngoai
275079284,"Găng tay robot phục hồi chức năng cho người bị liệt bàn tay do tai biến, tai nạn",2.0,1216537468308,1833000,1950000,117000,6,0,the-thao-da-ngoai
274761768,"[1 CÁI] Tạ Bình Vôi, Tạ Chuông 2kg Tập Squat, Tạ Ấm Dụng Cụ Thể Thao Tại Nhà Chống Đẩy",3.0,9082087457474,118000,118000,0,0,0,the-thao-da-ngoai
273481167,"Gậy Bẻ Tập Cơ Tay Gậy Lò Xo Lực 20kg,25kg,30Kg,40kg,50kg,60kg - Thanh Lò Xò Tập Tay Tại Nhà Cao Cấp - Hàng Chính Hãng MINIIN",2.0,9787893922819,47200,47200,0,0,0,the-thao-da-ngoai
272445794,Thực phẩm tăng cơ Rule 1 Protein Isolate/ Hydrolysate 4.8-5.01lb tặng Rule 1 Shaker,848.0,2661381189231,1950000,1950000,0,0,239,the-thao-da-ngoai
271170259,"gậy lò xo 5kg 10kg 20kg, Gậy Bẻ Tập Cơ Tay Gậy Lò Xo Lực 20kg, 25kg, 30Kg, 40kg, 50kg, 60kg - Hàng chính hãng dododios - gậy lò xo 100kg màu vàng",157.0,1313515926404,52000,52000,0,0,24,the-thao-da-ngoai
270298494,"Cặp bông cổ vũ, cổ động (Loại 40gr)",9.0,4404487728763,29000,39000,10000,26,1,the-thao-da-ngoai
270102883,"Túi Thể Thao Đa Năng CLEACCO Đựng Điện Thoại , Kháng Nước Nhiều Kiểu Đeo Phù Hợp Cho Nhiều Môn Thể Thao",51.0,9287719627630,129000,208600,79600,38,9,the-thao-da-ngoai
261005569,Bật Lửa Zippo Armor Lucky Cat Design 49802,0.0,7861349947598,1825000,1825000,0,0,0,the-thao-da-ngoai
252674201,"Con lăn Foam Roller massage có gai 33cm giãn cơ tập Gym, Yoga, thể hình miDoctor",9.0,3979830450111,86000,86000,0,0,1,the-thao-da-ngoai
242741641,Băng Đô Thể Thao Chặn Mồ Hôi Trán Nam Nữ Headband - Hàng Chính Hãng AOLIKES,22.0,6726696422179,28800,28800,0,0,0,the-thao-da-ngoai
242731023,Thảm Tập YOGA Chống Trượt Tập GYM Tại Nhà Tập Thể Dục Chất Liệu Tpe 2 Lớp Chống Trơn Cao Cấp Chính Hãng Amalife,8.0,1102673393384,95600,95600,0,0,1,the-thao-da-ngoai
225214746,DODODIOS Thanh tập xà đơn treo tường gắn cửa nhiều cỡ từ 62-150cm tùy chỉnh phù hợp tập gym tại nhà tăng cơ bắp,7.0,5420741698131,125000,125000,0,0,2,the-thao-da-ngoai
222557318,"Quấn Cổ Tay, Đai Bảo Vệ Cổ Tay Teeement, Chất Liệu Vải Polyester Sợi Cao Cấp, Co Dãn Thoải Mái, Thoáng Mát - Hàng Chính Hãng",76.0,7661959186297,89000,89000,0,0,8,the-thao-da-ngoai
221277239,Quần thun thể thao nam Fasvin DT22548.HN vải thun 01 lớp co giãn thoải mái,15.0,8536774241562,189000,348000,159000,46,3,the-thao-da-ngoai
212231333,Ruột Zippo Gas Butane  Hai Tia Lửa-Double Torch - Chính hãng 100%,25.0,1945426950389,540000,540000,0,0,6,the-thao-da-ngoai
210155151,"Bó gối cao cấp nano AATH Nhật Bản, giảm đau nhức viêm sưng",12.0,5882690329647,960000,960000,0,0,2,the-thao-da-ngoai
207774551,Bọc ống đồng ống quyển đá bóng AOLIKES A-0116 football shin pads,17.0,6043039223167,89000,159000,70000,44,2,the-thao-da-ngoai
192694047,Băng bảo vệ mắt cá chân AOLIKES A-7529 Taekwondo Pressurized elastic ankle,1.0,6393285048198,159000,259000,100000,39,1,the-thao-da-ngoai
179496408,"Thanh xà đơn gắn cửa, xà đơn treo tường Thước Thăng Bằng, chịu lực 200kg, chốt khóa an toàn chông trượt tập luyện tại nhà TP201PU",39.0,8036318565485,458000,458000,0,0,6,the-thao-da-ngoai
177631015,"Gậy Lăn Massage Dãn Cơ Bắp Roller Stick tập Gym Yoga,Lăn Massage Cơ Bắp 3 Bóng Roller Stick Tập Gym Yoga",4.0,5658325787890,158000,158000,0,0,0,the-thao-da-ngoai
174406926,"SÁCH HƯỚNG DẪN CHƠI GOLF ""Love golf - Love life""",43.0,4413815188537,350000,350000,0,0,4,the-thao-da-ngoai
156112897,"Xà Đơn Treo Tường Gắn Cửa Đa Năng Độ Dài Tùy Chỉnh Giúp Bạn Tập Gym, Tập Cơ Bụng, Cơ Vai, Cơ Xô 60-120Cm - Chính Hãng MINIIN (Màu Ngẫu Nhiên)",69.0,2927144643416,119000,119000,0,0,9,the-thao-da-ngoai
136765525,"Băng Bảo Vệ Cổ Chân 360º VNSPORT, Băng Cổ Chân Chuyên Dụng Phòng Các Chấn Thương Cổ Chân Cho Các Bộ Môn Thể Thao - Cầu Lông, Bóng Rổ, Bóng Chuyền, Chạy Bộ, Đạp Xe, Tennis, Leo Núi, Dã Ngoại (1 Đôi)",34.0,4338123086881,500000,700000,200000,29,5,the-thao-da-ngoai
127687152,Quần Tập Thể Thao Nam RUNNING Cao Cấp SZone SQ494 - Quần Tập Gym - Quần Chạy,15.0,2521998219209,69000,69000,0,0,2,the-thao-da-ngoai
75950830,Bộ tạ miếng nhựa đen PVC 10KG đa năng thiết kế mới nhất Cao Cấp ,194.0,4976161070410,299000,299000,0,0,52,the-thao-da-ngoai
74687213,"Combo Vòng yoga 33cm +2 gối yoga+1 Dây tập 1,83m Tiện Dụng (Bản Tiêu Chuẩn)",584.0,6985815162294,249000,249000,0,0,175,the-thao-da-ngoai
72541263,Balo Tennis Babolat PURE AERO 2021 (753094),22.0,8200904043666,1979000,1979000,0,0,2,the-thao-da-ngoai
54549801,Giày đá bóng chính hãng Kamito Quang Hải QH19 Premium Pack,141.0,3029724280342,580800,580800,0,0,48,the-thao-da-ngoai
52377020,"Đai Bảo Vệ Khủy Tay Tập GYM, Chơi Thể Thao Elbow Support Có Lò  Xo Chịu Lực Aolikes 7946 (1 Chiếc)",62.0,7596196510292,115000,115000,0,0,9,the-thao-da-ngoai
48723344,Thực Phẩm Tăng Sức Bền BCAA ZERO – 360g BiotechUSA,9.0,9343140398981,650000,650000,0,0,3,the-thao-da-ngoai
6625365,Khung bóng rổ thi đấu - có kèm lưới,54.0,6919394628766,167000,169000,2000,1,7,the-thao-da-ngoai
6355379,Dây nhảy thể dục tay cầm hợp kim nhôm cao cấp Aolikes AL3202,168.0,3694804448365,115000,115000,0,0,48,the-thao-da-ngoai
4935805,Bộ 2 tạ tay  3kg cao cấp tập Gym BG (hàng nhập khẩu),469.0,3065070407194,326000,599000,273000,46,77,the-thao-da-ngoai
2282595,"Bộ 2 Sản Phẩm Xăng, Đá Zippo",443.0,4793391211969,160000,160000,0,0,49,the-thao-da-ngoai
1374137,Kính Bơi View V500S,1138.0,8572358939995,295000,495000,200000,40,146,the-thao-da-ngoai
276151697,"Quần boxer nam, combo quần lót nam cao cấp chất thun lạnh kháng khuẩn co giãn 4 chiều phong cách nam tính - Faapas",204.0,4094459343804,45000,50000,5000,10,15,thoi-trang-nam
277350164,"Combo 5 quần boxer nam, quần lót nam cao cấp chất thun lạnh siêu mềm mịn kháng khuẩn co giãn 4 chiều thấm hút mồ hôi tốt - Ares Shop",19.0,1710028450165,225000,250000,25000,10,3,thoi-trang-nam
99958075,"Quần đùi short gió nam thể thao Basic trẻ trung năng động, thoáng mát co giãn 4 chiều MRM Manlywear",3073.0,4345512315085,119000,199000,80000,40,539,thoi-trang-nam
99968881,"Set 2 quần đùi nam, quần Short Gió nam thể thao Basic trẻ trung năng động, thoáng mát co giãn 4 chiều MRM Manlywear",2372.0,4423892093285,245000,399000,154000,39,620,thoi-trang-nam
186133766,"Quần Short Kaki Nam US ARMY, Quần Túi Hộp Nam Phong Cách Lính Chất Liệu KaKi Cao Cấp, Kiểu Dáng Trẻ Trung Năng Động -HÀNG CHÍNH HÃNG",260.0,2104326663312,299000,598000,299000,50,69,thoi-trang-nam
275566896,áo khoác nam cao cấp vải xịn mẫu mới ra hot nhiều màu a13,118.0,2612822755816,165000,165000,0,0,5,thoi-trang-nam
273768361,"Áo vest blazer Linen nam công sở, form chuẩn đẹp, chất vải linen tự nhiên mềm thời trang trẻ Đũi Việt",14.0,9703432514257,299250,299250,0,0,3,thoi-trang-nam
267556901,"Quần dài gym nam DO GYM SHOP dáng quần ôm thể thao, thun polyester co giãn thoáng mát không xù lông",3.0,6499255060661,179000,179000,0,0,2,thoi-trang-nam
52184516,Combo 3 quần lót nam Boxer sợi Organic mềm mịn thoáng mát co giãn 4 chiều MRM Manlywear ( TẶNG Đôi Tất Nam Cao Cấp Giao Ngẫu Nhiên),4253.0,4058196943911,195000,285000,90000,32,1236,thoi-trang-nam
138748093,Áo thun nam cổ tim ngắn tay đẹp nhiều màu đủ size ( có size lớn cho người 100 kg ),442.0,4595853918221,79000,79000,0,0,95,thoi-trang-nam
31638135,"Combo 4 quần lót nam Boxer sợi cạp 1cm sợi tre tự nhiên mềm mịn thấm hút mồ hôi, co giãn 4 chiều MRM Manlywear - Màu ngẫu nhiên",5663.0,5847364002357,245000,340000,95000,28,1348,thoi-trang-nam
31637590,Combo 4 quần lót nam tam giác Bamboo Organic mềm mịn thoáng mát thấm hút mồ hôi - MRM Manlywear - Màu Ngẫu Nhiên,3623.0,9283065092857,239000,340000,101000,30,887,thoi-trang-nam
103076103,"áo ba lỗ nam, áo 3 lỗ nam sợi cotton Organic mềm mịn siêu thoáng mát thấm hút mồ hôi JAMANO",1308.0,5310742640502,79000,99000,20000,20,132,thoi-trang-nam
265177928,"Áo ba lỗ Tank Top Lụa Lưới TOBA Boutique Siêu Mát Lạnh, nhanh khô thoáng khí thông hơi mặc nhà, tập gym, tập thể thao TB3LO1",79.0,4396990765547,69000,69000,0,0,9,thoi-trang-nam
252869644,"Quần ngắn con voi, quần đùi du lịch elephant short cute, quần dumpo unisex trẻ trung, hoạt hình Anime, có tiếng kêu",20.0,8115570872996,162000,162000,0,0,1,thoi-trang-nam
249215436,Quần Kaki túi hộp nam trung niên - Quần Jogger kaki vải dày dặn full size,100.0,2355623184035,179000,179000,0,0,18,thoi-trang-nam
247338520,"Áo sơ mi nam chấm bông, họa tiết nhỏ, tay ngắn, dáng rộng, tà bằng, chất liệu vải mềm mát, Amazing, big size",9.0,9265957873070,203000,312000,109000,35,1,thoi-trang-nam
207854920,"Quần lót nam cao cấp Boxer Seamless ROCK 516 không đường may cotton 100% thấm hút, thoáng mát thoải mái vận động cả ngày",23.0,4457670051327,149000,149000,0,0,3,thoi-trang-nam
276233156,"Combo quần lót nam, quần sịp nam chất thun lạnh kháng khuẩn co giãn 4 chiều phong cách nam tính - Ares Man",288.0,1826524006318,135000,150000,15000,10,18,thoi-trang-nam
111850645,"Bộ Quần Áo KaKi Lính Mỹ US ARMY U569 Kiểu Dáng Túi Hộp Chiến Thuật, Chất Liệu Kaki Cao Cấp Phong Cách Lính Cực Ngầu - HÀNG CHÍNH HÃNG",18.0,6462314065582,899000,1798000,899000,50,2,thoi-trang-nam
43333663,"Combo 2 áo ba lỗ nam/áo 3 lỗ nam, sợi cotton mềm mịn siêu thoáng mát, thấm hút mồ hôi cực tốt, co giãn 4 chiều MRM FASHION -MM",991.0,5060363935062,219000,250000,31000,12,250,thoi-trang-nam
276132695,"Combo quần lót nam, quần boxer nam chất thun lạnh kháng khuẩn co giãn 4 chiều - Ares Man",303.0,5245028071848,135000,150000,15000,10,16,thoi-trang-nam
52189164,Combo 3 quần lót nam sợi cotton Organic mềm mịn thoáng mát co giãn 4 chiều MRM Manlywear (TẶNG Đôi Tất Nam Cao Cấp màu ngẫu nhiên),3354.0,7478317183861,189000,255000,66000,26,965,thoi-trang-nam
203931181,"Áo thun trơn polo cổ trụ, form unisex cho nam nữ. Áo phông hàng hiệu Goking, quà tặng cao cấp cho gia đình, cặp đôi, doanh nghiệp",24.0,3781007431066,99000,99000,0,0,3,thoi-trang-nam
187574051,"Combo 3 quần lót nam boxer CITYMEN lưng Thái cao cấp vải cotton 100% co dãn mềm mại thoáng khí thấm hút tốt, quần xịp sịp đùi nam - Giao màu ngẫu nhiên",96.0,4494004207737,140000,140000,0,0,17,thoi-trang-nam
176251118,"Combo 2 Áo thun nam Cotton Compact Premium trẻ trung thấm hút mồ hôi, co giãn 4 chiều MRM Manlywear",567.0,3547655566726,279000,499000,220000,44,161,thoi-trang-nam
162033134,Combo 5 quần đùi nam mặc nhà Cotton thoải mái thoáng mát Họa Tiết Ngẫu Nhiên - JAMANO,836.0,8621242878659,229000,350000,121000,35,186,thoi-trang-nam
140461766,"Áo Sơ Mi Nam Caro Dài Tay Trà Sữa ZF03 Thời Trang Cao Cấp PONIVA Phong Cách Trẻ Trung, Nam Tính",3.0,7402371020916,115000,115000,0,0,0,thoi-trang-nam
124635780,"Áo sơ mi nam trơn tay dài cao cấp Lados - 779 chất kate lụa mềm mát, thấm hút mồ hôi",3357.0,6126520628631,235000,235000,0,0,982,thoi-trang-nam
117059903,Áo thun Teeworld Ủa em Tay Lỡ Nam Nữ Form Rộng Unisex,116.0,3306564366439,299000,299000,0,0,25,thoi-trang-nam
117031543,Áo thun Teeworld ỦA Version 2 T-Shirt Nam Nữ Form Rộng Unisex,90.0,3694806011001,299000,299000,0,0,22,thoi-trang-nam
114446808,"Quần tây nam màu xanh đen, ống đứng, không ly, đồng phục học sinh, công sở, thương hiệu Amazing, có size 100kg",243.0,1617400905717,226000,348000,122000,35,41,thoi-trang-nam
110704393,Combo 2 quần đùi nam Cotton mặc nhà thoải mái thoáng mát JAMANO- MÀU NGẪU NHIÊN,1505.0,7723437911225,99000,140000,41000,29,279,thoi-trang-nam
107411611,"Áo thun Nam Nữ Vonesa, áo phông Unisex Nam Nữ có Size từ 25-84kg B9",293.0,2958202934041,30000,30000,0,0,78,thoi-trang-nam
104904605,Quần short nam big size quần sọt nam thể thao quần đùi nam mặc nhà quần thun nam cotton 4 chiều co giãn cao cấp ShopN6 - TSB2,688.0,7571508599883,59000,90000,31000,34,124,thoi-trang-nam
100367931,Quần đùi nam Fasvin Q21462.HN vải gió chun co giãn mềm mại thoải mái vận động,9.0,5676435963220,99000,198000,99000,50,1,thoi-trang-nam
90979601,"Áo Khoác Dù Nam chống nước ( TẶNG QUẦN LÓT HÀNG HIỆU ) Dokafashion Cao Cấp 2 Lớp Vải Dù Ấm Áp Cản Gió Đi Nắng, Chống Nước EZDS23",361.0,6689725315076,209000,209000,0,0,173,thoi-trang-nam
90423124, Áo Thun Unisex Tay Ngắn ICON Cực Phong Cách | Hàng Bao Chất AT06,3.0,4943507312341,59000,59000,0,0,1,thoi-trang-nam
79435123,"Áo chống nắng nam cao cấp, thông hơi, chống nắng, chống tia UV, chống bám bụi – FORMEN SHOP – FMTHT024",1390.0,3125033798367,99000,215000,116000,54,340,thoi-trang-nam
58962353,"Áo Polo nam cổ bẻ ngắn tay, chất liệu vải cá sấu cotton cao cấp, trẻ trung, năng động – FORMEN SHOP – FMPS131",224.0,2494799316691,99000,195000,96000,49,82,thoi-trang-nam
55411656,Quần Bơi Nam Dáng Đùi Cao Cấp SZone SQB105 Vải Mềm Mại Co Giãn Cực Tốt Phong Cách Chuyên Nghiệp,218.0,7472481407822,55000,55000,0,0,41,thoi-trang-nam
42899542,"Áo ba lỗ nam/ 3 lỗ nam cao cấp, sợi cotton mềm mịn siêu thoáng mát, thấm hút mồ hôi cực tốt, co dãn 4 chiều MRM FASHION",1691.0,7867989982603,109000,125000,16000,13,307,thoi-trang-nam
36574835,Áo Sơ Mi Nam ,36.0,6899218427976,95000,95000,0,0,2,thoi-trang-nam
24503371,Quần lót Boxer nam SQB200,107.0,1804099267141,39000,39000,0,0,5,thoi-trang-nam
17912482,"Áo khoác nam chống nắng gió thu đông Doka (DBLS102) chất liệu dù giữ ấm cao cấp màu đen , màu xanh đen , màu xanh rêu ",28.0,5859724321299,215000,215000,0,0,7,thoi-trang-nam
7925353,Quần Lót Nam KENDO TOGO Classic,388.0,4743640295875,70000,70000,0,0,29,thoi-trang-nam
277165667," Quần boxer nam , quần lót đùi nam ALPHA 2.0 được làm bằng chất thun lạnh mềm mịn thấm hút mồ hôi co giãn 4 chiều",9.0,2280567604884,45000,50000,5000,10,0,thoi-trang-nam
154292862,"Quần đùi short gió nam thể thao Họa Tiết Rằn Ri trẻ trung năng động, thoáng mát co giãn 4 chiều MRM Manlywear",385.0,9759298343756,129000,199000,70000,35,110,thoi-trang-nam
276803334,"Quần Lót Nam Thương Hiệu Samaki SF04 Chất Liệu Lưới 100%, Thông Thoáng, Không Bị Bí, Nóng, Bản Lưng 3.0cm Mạnh Mẽ",6.0,4915325629430,48000,48000,0,0,0,thoi-trang-nam
275710680,AS - ÁO THUN VUI KHỎE SIZE L,166.0,5398005400188,122000,122000,0,0,0,thoi-trang-nam
274355534,"Combo 4 Quần Đùi Nam TOBA Boutique Thun Cotton, Mặc Nhà, Quần Ngủ TBDUI02",12.0,8774631183014,189000,189000,0,0,3,thoi-trang-nam
271389536,"Hộp 5 quần lót boxer nam thun lạnh 4 chiều, cạp bo dệt gân cao cấp - FORMEN SHOP - FMPS224",67.0,6316999839649,199000,319000,120000,38,16,thoi-trang-nam
268454843,Áo chống nắng nam CARDINA 2 lớp chất thun lạnh cao cấp viền thể thao chống tia UV thiết kế lưới tản nhiệt 2NM02,3.0,8103491837374,385000,385000,0,0,1,thoi-trang-nam
205231567,"Combo 3 Quần Lót Nam Thun Cotton OneZ Dáng Trunk Co Giãn, Thoải Mái - QL1",208.0,1401628520714,75000,75000,0,0,32,thoi-trang-nam
203145770,"Quần tây nam cao cấp Amazing màu đen và xanh đen, form truyền thống công sở, không ly, ống đứng",32.0,1421057783291,359000,552000,193000,35,8,thoi-trang-nam
195192891,Quần Gió Nam Thể Thao FASVIN Vải Gió Đẹp Hàng Nhà Máy Chất Lượng Cao Dùng Khi Thể Thao Hay Mặc Nhà DC20423.HN,155.0,6938858625781,185000,298000,113000,38,39,thoi-trang-nam
68202834,"Combo 2 áo ba lỗ nam, áo sát nách nam,sợi cotton cao cấp mềm mịn, thấm hút mồ hôi, siều thoáng mát, co giãn 4 chiều Mrm Manlywear - MM",836.0,5037327813223,229000,310000,81000,26,274,thoi-trang-nam
154298071,"Combo 2 quần đùi nam, quần Short Gió nam thể thao Họa Tiết Rằn Ri trẻ trung năng động, thoáng mát co giãn 4 chiều MRM Manlywear",899.0,2240352549120,259000,399000,140000,35,238,thoi-trang-nam
193993947,Quần Jean nam Leman màu đen rách gối JD20 - Slim Form,63.0,6879622531724,549000,549000,0,0,11,thoi-trang-nam
178107571,Quần tây học sinh việt tiến cấp 2 - 3,20.0,9420689509357,189000,189000,0,0,2,thoi-trang-nam
176250783,Áo thun nam Cotton Compact Premium trẻ trung năng động thấm hút mồ hôi co giãn 4 chiều MRM Manlywear,959.0,2018052320603,139000,249000,110000,44,182,thoi-trang-nam
174593731,"Quần Short NamThể Thao Thanh Lịch US ARMY 8898 Trẻ Trung, Năng Động, Nam Tính -HÀNG CHÍNH HÃNG",65.0,8743597504871,150000,300000,150000,50,27,thoi-trang-nam
174029817,ÁO SƠ MI KAKI NAM NỮ,35.0,4515962741172,279000,279000,0,0,9,thoi-trang-nam
169120359,"Combo 5 quần sịp nam, kiểu dáng ôm mông chất thun cotton thấm hút co giãn tốt - FORMEN SHOP - FM5QS005",391.0,9037512200969,149000,245000,96000,39,79,thoi-trang-nam
166132556,"Áo đoàn viên, đồng phục thanh niên Việt Nam, thêu cờ đỏ sao vàng, tay dài và tay ngắn, có 2 túi có nắp và cầu vai",89.0,8149001267678,122000,187000,65000,35,24,thoi-trang-nam
163716292,"Bộ bơi nam khóa kéo size lớn, quần áo bơi bigsize cho nam giới, chất thun bơi lạnh Hàn dầy dặn, dáng thể thao mạnh mẽ | BN016",58.0,7089881760713,480000,480000,0,0,13,thoi-trang-nam
149980106,"Quần tây nam form body, ống côn, không ly, chất liệu co giãn, đồng phục học sinh màu đen và xanh đen, Amazing",24.0,3654028767995,418000,418000,0,0,7,thoi-trang-nam
143579343,Quần jean nam ống suông MĐ Q62 màu xanh nhạt loại tốt,52.0,9624754843269,170000,170000,0,0,15,thoi-trang-nam
138750990,Áo Phông Nam cổ tim Chất cotton mềm Mịn Dáng Ôm Nhẹ Thời Trang,20.0,5496168781481,99000,99000,0,0,1,thoi-trang-nam
134757633,Áo Sơ Mi Form Rộng GIẤU NÚT Tay Dài Hàn Quốc Áo Unisex Nam Nữ Vải Lụa Mềm Mịn Thoáng Mát Ít Nhăn - SMD02,99.0,7197276587245,105000,210000,105000,50,34,thoi-trang-nam
98642412,Áo thun Teeworld Saigonese Cô Ba Form Rộng Nam Nữ Unisex,148.0,1686419818772,299000,299000,0,0,34,thoi-trang-nam
94659387,Quần Lót Nam- Sịp Cotton Cạp To Mềm Mại Thoáng Khí K465,357.0,3948712060043,55000,55000,0,0,94,thoi-trang-nam
90483633,Combo 5 Áo thun nam ngắn tay cổ tim cotton thoáng mát FREEMAN TSF315,24.0,8634139099976,420750,495000,74250,15,6,thoi-trang-nam
84826648,Quần Sịp Lưới Nam Mỏng Mát Sexy K165,307.0,9604574228130,69000,69000,0,0,64,thoi-trang-nam
83616147,Quần ngủ nam có miếng lót nâng đỡ - vải lỗ thoáng mát - quần lót 2in1 cao cấp - quan ngu nam co lot trong,222.0,9834322947756,88900,88900,0,0,44,thoi-trang-nam
82646137,Áo Sơ Mi Nam Ngắn Tay Phối Caro ,97.0,8674839387214,125000,125000,0,0,29,thoi-trang-nam
74493882,Áo thun unisex tay lỡ form rộng - phông thêu 4 logo,121.0,9257031052916,79000,125000,46000,37,54,thoi-trang-nam
73214429,Áo Khoác Nam Áo Khoác Dù Nam Nữ Hai Lớp Chống Nước Chống Nắng Chống Gió Phối Nón Cao Cấp QD54 - ShopN6 (Nhiều Màu),442.0,1446981514287,189000,189000,0,0,181,thoi-trang-nam
71985742,Áo khoác dù UV mẫu mới 2024 ( Tặng 1 áo khoác kaki ) - Áo Khoác Chống Nắng đến 98% Chống Thấm Nước Có Túi Trong Kèm Túi Khóa Kéo Phong Cách Trẻ Trung,479.0,3507445342582,298000,298000,0,0,238,thoi-trang-nam
67526051,MAY 10 - Quần ĐÙI mặc nhà + mặc ngủ (HÀNG HIỆU GIÁ SHOCK),264.0,1550751178248,75000,100000,25000,25,49,thoi-trang-nam
43333515,"Combo 2 áo ba lỗ nam/áo 3 lỗ nam, sợi cotton mềm mịn siêu thoáng mát, thấm hút mồ hôi cực tốt, co giãn 4 chiều MRM FASHION -CM",168.0,4982106440880,189000,250000,61000,24,39,thoi-trang-nam
24038276,Áo ba lỗ cổ vuông nam phong cách Hàn Quốc SA455,189.0,1593274079593,50000,50000,0,0,15,thoi-trang-nam
4426117,Quần Dài Jogger Nam Phối Sọc 1041_xanh,194.0,6932797984291,95000,95000,0,0,18,thoi-trang-nam
276569649,"Quần dài nam chất linen cao cấp, quần suông trơn nam phù hợp  mọi lứa tuổi, có chun rút eo",6.0,5648304291277,299000,299000,0,0,1,thoi-trang-nam
275481818,quần jean nam cao cấp hàng hót,4.0,6262914539335,149000,149000,0,0,2,thoi-trang-nam
273298764,"Quần short nam FM NEWBASIC, chất thun Pique cao cấp, thời trang năng động - FORMEN SHOP - FMPS229",13.0,6816318601416,189000,280000,91000,33,4,thoi-trang-nam
262029621,Bộ Quần Áo Mặc Nhà Thể Thao Nam Phong Cách Cao Cấp Y- JIE - FORMEN SHOP - FMPS218,10.0,7290682515055,219000,349000,130000,37,0,thoi-trang-nam
240592615,Quần tây nam quần âu nam đen KING hàn quốc cho công sở học sinh giá rẻ vải mịn thoáng mát Q04,8.0,9253092934894,190000,190000,0,0,3,thoi-trang-nam
206664470,Áo phao nam công sở trẻ trung NAP37,6.0,9660946847966,750000,750000,0,0,0,thoi-trang-nam
197675716,Áo sơ mi nam dài tay màu đen dáng suông May 10 mã 010122912L2,6.0,6306586509825,295000,295000,0,0,2,thoi-trang-nam
197139408,"Áo khoác gió 2 lớp cao cấp chống nắng, chống nước thiết kế phối sọc trẻ trung - FORMEN SHOP - FMTHT051",18.0,6124451309970,79000,350000,271000,77,5,thoi-trang-nam
196467846,"Áo Lót Nam Dệt Kim Đông Xuân Cộc Tay Vicci Màu Trắng, Vải Sợi Cotton Mềm Mịn, Co Giãn, Thấm Hút Mồ Hôi, Siêu Thoáng Mát",273.0,2139200891906,72000,80000,8000,10,16,thoi-trang-nam
196207027,Áo thun Teeworld Sài Gòn Retro Nam Nữ Trắng Đen Form Rộng Unisex,6.0,4552949728677,359000,359000,0,0,3,thoi-trang-nam
193504415,Combo 2 Áo thun thể thao nam MRM Active Pro thấm hút mồ hôi tốt co dãn thoải mái vận động,148.0,9814032886517,219000,399000,180000,45,66,thoi-trang-nam
187579216,"Combo 3 quần lót đùi nam boxer CITYMEN lưng Thái cao cấp vải thun lạnh co dãn mềm mại thoáng khí thấm hút tốt, quần xịp sịp đùi nam bao đổi trả 90 ngày ",37.0,7444970589061,140000,140000,0,0,10,thoi-trang-nam
184822619,Áo Thun Trơn Andromeda Cổ Tròn Ngắn Tay Nhiều Màu Cho Cả Nam và Nữ Vải Dày Mịn,16.0,7724635815098,49000,49000,0,0,0,thoi-trang-nam
179163530,(big size<130kg) Áo sơ mi nam tay dài big size màu đen,10.0,8381884693570,195000,195000,0,0,4,thoi-trang-nam
179161990,(big size < 130kg) sơ mi nam tay dài màu xanh đen big size,6.0,8717215326113,195000,195000,0,0,3,thoi-trang-nam
174026921,Áo thun nam T-Shirt Leman Cotton Compact màu đen Regular Form,62.0,6024874292667,299000,299000,0,0,6,thoi-trang-nam
174024710,Quần Short Jean nam Leman xanh trơn JL07 - Slim straight Form,34.0,7029778605219,459000,459000,0,0,10,thoi-trang-nam
150493348,ÁO CHỐNG NẮNG KAKI LOẠI SIÊU ĐẸP CHO NAM - ÁO KHOÁC NAM,38.0,3071915869101,149000,149000,0,0,8,thoi-trang-nam
145717928,Áo khoác phao nam hà nội NAP09,10.0,4383061874635,850000,850000,0,0,3,thoi-trang-nam
144170857,"Quần nam,quần nỉ nam ống bó chun 2 màu Q03",11.0,7104978506542,99000,99000,0,0,3,thoi-trang-nam
141663347,Áo len nam hàn quốc lót lông LNA05,13.0,8288714289005,520000,520000,0,0,4,thoi-trang-nam
140464110,Áo Sơ Mi Nam Dài Tay Công Sở Mẫu VS01 Thời Trang Cao Cấp PONIVA Form Đẹp Chuẩn VNXK,5.0,4401103245702,105000,105000,0,0,1,thoi-trang-nam
140463315,Quần Short Nam Phối Túi Hộp Mẫu GV01 Thời Trang Cao Cấp PONIVA Chất Liệu Kaki Dày Dặn Chuẩn Form,106.0,8452984852583,145000,145000,0,0,26,thoi-trang-nam
138748869,"Áo thun nam tay dài cổ tròn, chất cotton 4 chiều , áo dài tay nhiều màu dáng ôm thời trang",18.0,7344679039352,129000,129000,0,0,7,thoi-trang-nam
138748071,"Áo phông nam tay dài mặc thu đông, giữ nhiệt, chất cotton co giãn, áo dài tay dáng ôm cao cấp",134.0,3662345449471,99000,99000,0,0,39,thoi-trang-nam
121252846,"Quần Boxer Nam sợi thun lạnh kháng khuẩn, Quần Lót Nam co giãn 4 chiều thấm hút mồ hôi cực tốt thương hiệu BAW (combo 3 màu ngẫu nhiên) NH79",232.0,5984703216674,159000,159000,0,0,63,thoi-trang-nam
118900403,Áo sơ mi nam tay dài ADINO màu xanh than vải sợi sồi modal dáng slimfit trẻ trung S305,15.0,1404556859002,279000,350000,71000,20,7,thoi-trang-nam
107338883,"Áo thun Nam Nữ Vonesa, áo phông Unisex Nam Nữ có Size từ 25-84kg B7",275.0,3549379659714,40000,40000,0,0,71,thoi-trang-nam
98986504,Áo thun Teeworld Sài Gòn - Everything you need to know Form Rộng Unisex Nam Nữ,33.0,1103947244249,299000,299000,0,0,11,thoi-trang-nam
87094676,"Bộ bơi đôi dài tay Nam và Nữ, set 3 chi tiết quần dài chống nắng, đồ bơi cho couple, có size nhỏ cho bé mặc đồ gia đình | KT022 | BN022",54.0,6171651698736,520000,520000,0,0,17,thoi-trang-nam
84826006,Quần Lót Nam- Sịp Lụa Nam Trơn Không Đường May Mỏng Mát K176,1077.0,2926836563965,64900,64900,0,0,200,thoi-trang-nam
83517269,Bộ áo khoác thể thao thu đông cao cấp ,11.0,6513297180246,505700,505700,0,0,3,thoi-trang-nam
75983158,Quần Jean Nam Skinny Đen Trơn SZone SQ602B,27.0,2067440531639,129000,129000,0,0,6,thoi-trang-nam
75659874,BỘ ĐỒ NỈ NAM COTTON DÀI DÀY DẶN CỰC ĐẸP,2.0,1437751498883,345450,345450,0,0,0,thoi-trang-nam
58263440,Áo Thun Nam Cổ Bẻ Họa Viết EYE999 Nam Tính,96.0,2004973123955,95000,95000,0,0,37,thoi-trang-nam
50701079,Aó vest nam Titishop AVN150,6.0,5760497121927,499000,499000,0,0,3,thoi-trang-nam
13677604,Áo khoác nam không bo lai Phúc An 2026,70.0,8319591756558,195000,195000,0,0,7,thoi-trang-nam
13635998,Quần jean nam ống suông Muidoi Q63 (Xanh đậm),109.0,7434410109641,170000,170000,0,0,12,thoi-trang-nam
6927817,Quần thun dài jogger nam Phúc An 1011 màu xám,50.0,1600105587254,82800,82800,0,0,11,thoi-trang-nam
3714997,Combo 5 Quần Lót Boxer Nam Freeman 6516-CB5,121.0,6493836578470,340000,425000,85000,20,18,thoi-trang-nam
276876769,Quần ngắn_short túi hộp chiến thuật_dã ngoại_du lịch,4.0,6314694849159,379000,379000,0,0,0,thoi-trang-nam
276584954,Áo len nam cổ tim tay dài thời trang LNA30,3.0,4290387473035,310000,310000,0,0,1,thoi-trang-nam
276583678,"Quần lót nam ,quần sịp nam tam giác chất thun lạnh mềm mịn siêu mát, thấm hút mồ hôi - LOCATSE -",23.0,6033428322499,45000,50000,5000,10,2,thoi-trang-nam
275463376,áo thun nam đẹp hottren 11,3.0,4122379067283,69000,69000,0,0,0,thoi-trang-nam
274019587,Quần suông ống rộng nam nữ chất liệu linen thời trang cao cấp Đũi Việt,2.0,2368902896260,249000,249000,0,0,0,thoi-trang-nam
273584426,Áo Sơ Mi Nam Tay Dài Khatoco A1MD320T1-CNTR012-2501-D-TRẮNG TRƠN,5.0,9351299668413,320000,320000,0,0,2,thoi-trang-nam
248688298,Quần tây nam không ply ống ôm đen Khatoco Q1M528S0-CNMA046-2411-0,21.0,5656154609217,528000,528000,0,0,3,thoi-trang-nam
248688230,Quần tây nam không ply ống vàng xám ôm Khatoco Q1M578S0-CNVA221-2411-0,9.0,9763794972466,578000,578000,0,0,2,thoi-trang-nam
245768155,Áo thun ba lỗ nam 3 lỗ sát nách cổ vuông dáng ôm body tập gym chất thun co giãn U07,29.0,1007826094260,100000,100000,0,0,3,thoi-trang-nam
213541798,"Quần bơi nam boxer lửng form dài giữa đùi, đồ bơi nam cao cấp trẻ trung phối màu đẹp QBL00110",4.0,4328433406038,235000,235000,0,0,0,thoi-trang-nam
205486844,"Quần tây nam thương hiệu Amazing cao cấp, form công sở truyền thống, ống đứng, không ly, màu xám lông chuột, có vân chìm",7.0,1287270213082,265000,408000,143000,35,3,thoi-trang-nam
197720611,Quần đùi nam quần short thể thao CITYMEN mặc nhà tập gym vải thun lạnh dày đẹp co giãn 4 chiều - Giao màu ngẫu nhiên,64.0,5912791977633,83000,83000,0,0,17,thoi-trang-nam
188916076,Áo Thun Trơn Nam COTTON FASVIN Vải Mềm Mát Co Giãn Hàng Nhà Máy TS20218.HN,24.0,2768335105539,119000,199000,80000,40,4,thoi-trang-nam
181566777,Áo sơ mi nam sọc tay ngắn dáng ôm body chuẩn form nhiều màu sắc - MON01,23.0,7690760583461,125000,250000,125000,50,5,thoi-trang-nam
150214417,Quần kaki tím than túi hộp bảo hộ lao động SHUNI loại dày,39.0,9346697390665,129000,129000,0,0,6,thoi-trang-nam
140579763,QUẦN KAKI NAM NỮ CHẤT VẢI DÀY,4.0,2994873279462,219000,219000,0,0,0,thoi-trang-nam
138749504,Áo thun nam cổ tim dài tay đẹp nhiều màu ( hàng cao cấp ),18.0,5396378991827,129000,129000,0,0,6,thoi-trang-nam
137912762,Áo Sơ Mi Nam Dài Tay Caro MR265 Thời Trang PONIVA Thiết Kế Nam Tính Lịch Lãm Hàng Chất Lượng XNK,13.0,6361333295491,125000,125000,0,0,4,thoi-trang-nam
115101947,quần baggy nam dài ống côn chất đũi mềm mại nhiều màu,240.0,5245086994068,85000,85000,0,0,82,thoi-trang-nam
111710370,Áo thun nam FREESHIP Áo phông nam có cổ TT03 Chất thun đẹp chuẩn shop,6.0,6119472205224,85000,85000,0,0,0,thoi-trang-nam
103049077, (Có size lớn) Hộp 4 quần lót boxer nam William WS60 - Quần sịp đùi lưới thông hơi thoáng mát,7.0,7883677619107,125000,125000,0,0,2,thoi-trang-nam
95054251,Quần Short Nam Big Size Quần Sọt Nam Thể Thao Cotton 4 Chiều Quần Đùi Nam Trên 100kg Quần Thun Nam Cao Cấp Giá Tốt WSB1 - ShopN6 (Sọc Ngẫu Nhiên),243.0,5627607016305,69000,105000,36000,34,43,thoi-trang-nam
93010173,Áo thun Polo trơn nam có cổ Phúc An 2033 có size lớn (over size),11.0,7002050125621,135000,135000,0,0,1,thoi-trang-nam
90419755," ÁO PHÔNG, ÁO THUN AMI BỤNG BỰ BẮN TIM SIÊU CUTE | AMI CAT TSHIRT",1.0,5534592676111,59000,59000,0,0,0,thoi-trang-nam
90414907,BST Áo Thun Ami Bựng Bự Dễ Thương | Áo Phông Ami Cat Tshirt,1.0,4632458258152,59000,59000,0,0,0,thoi-trang-nam
82643340,Quần Sọt Kaki Nam Túi Hộp Phối Họa Tiết Lính,17.0,6684941209849,149000,149000,0,0,3,thoi-trang-nam
74595171,Áo sơ mi nam tay dài form tailor đen trơn Khatoco A1MD360T1-CNDE003-2501-D,18.0,8798732574204,360000,360000,0,0,4,thoi-trang-nam
74441629,"Áo Sơ Mi Nam Dài Tay In 3D625 Thời Trang Nam Lịch Lãm, Sang Trọng Chuẩn Form",15.0,2411836699494,95000,95000,0,0,5,thoi-trang-nam
71171098,Áo thun nam cổ bẻ vải cá sấu thời trang SITAKI cao cấp ATN09,17.0,5539579907618,125000,125000,0,0,7,thoi-trang-nam
68938308,Áo  Sơ Mi Nam Vải Lụa Thái Không Nhăn Dài Tay Nhiều Màu,6.0,4221536857388,157000,157000,0,0,2,thoi-trang-nam
67838126, Áo khoác dù nam 2 lớp SAM ANGELS - M098,3.0,7468764516091,120750,120750,0,0,2,thoi-trang-nam
59326166,ÁO KHOÁC NAM 08,3.0,5405071322214,292950,292950,0,0,0,thoi-trang-nam
57796167,Áo Khoác Nhẹ Nam Phối Nón Chất Nỉ Chống Nóng Lạnh Xếp Túi Balo Cao Cấp AN11 - ShopN6 (Nhiều Màu) ,54.0,9306317991521,199000,240000,41000,17,11,thoi-trang-nam
54761601,Áo sơ mi nam tay dài trơn Khatoco A1MD360T1- CNTR011-2409-D - Trắng,75.0,6420011653882,360000,360000,0,0,17,thoi-trang-nam
52198192,Combo 3 Quần Sịp Nam Quần Lót Nam Sợi Cotton Cao Cấp MRM FASHION 1 Màu TẶNG Đôi Tất Nam Cao Cấp,39.0,7499324555663,189000,255000,66000,26,9,thoi-trang-nam
47099868,Quần Đùi Đi Biển Nam Đẹp,278.0,1908285121313,109000,109000,0,0,59,thoi-trang-nam
31512541,Quần Jean Nam,26.0,7840010677082,129000,129000,0,0,3,thoi-trang-nam
28940218,COMBO 3 QUẦN LÓT NAM - COTTON 4 CHIỀU ,3.0,9574381106343,139000,139000,0,0,0,thoi-trang-nam
13720669,Quần jean nam Q224 quần jean nam đẹp muidoi,56.0,6976436264481,167000,167000,0,0,17,thoi-trang-nam
9730171,"Combo 10 Quần Lót Nam nhiều lưng vải cotton 2 chiều hiệu CITYMEN, màu ngẫu nhiên, sịp nam - LMTK-MULTI2C",2699.0,7081138271015,180000,180000,0,0,584,thoi-trang-nam
277544802,"Áo Chống Nắng Nam ,Chất Vải Thun Lạnh, Chống Tia UV, Thoáng Mát, Thấm Hút Mồ Hôi",2.0,5283488999170,185000,185000,0,0,0,thoi-trang-nam
277282212,Áo khoác kaki nam lót dù hàn quốc vonesa,2.0,1749319779501,215000,215000,0,0,0,thoi-trang-nam
277271844,Đèn Pha Xe Máy LED CYT 3 Tim Siêu Sáng - Xài Điện Máy | Đèn Pha LED Siêu Sáng Cho Xe Máy & Ô Tô,1.0,7228689644479,225000,225000,0,0,0,thoi-trang-nam
276875609,Quần dài kaki_túi hộp_dã ngoại_du lịch,2.0,6814626553174,578000,578000,0,0,0,thoi-trang-nam
276461300,Áo sơ mi nam tay ngắn form suông vạt ngang Khatoco A1MN468T2-CNMK524-2605-N,1.0,7185717930348,468000,468000,0,0,1,thoi-trang-nam
276354650,Áo khoác dạ nam cao cấp lịch lãm thương gia NAD126,1.0,8912246458625,6698000,6698000,0,0,0,thoi-trang-nam
275478570,áo thun nam hottren 45678,3.0,9084693307060,69000,69000,0,0,1,thoi-trang-nam
274444395,Combo 4 Quần Lót Nam thun lạnh Đùi Nam Life Work BOXER nam co dãn 4 chiều (Che Tên) - HPXS1,5.0,4232827434089,99000,99000,0,0,1,thoi-trang-nam
273196231,"Áo sơ mi công sở Amazing, thời trang nam cao cấp form rộng, chất liệu nhập khẩu từ India, đường may sắc sảo",1.0,3446436071296,195000,300000,105000,35,0,thoi-trang-nam
252157171,"Quần bơi nam 2 lớp cao cấp, phong cách boxer ống ngắn rộng rãi, họa tiết da cá nam tính, lớp trong thun bơi co giãn, lớp ngoài trượt nước dày dặn nhanh khô | BN026",25.0,1325033022872,240000,240000,0,0,2,thoi-trang-nam
250768326,Quần Jogger Nam Lỗ Kim Phong Cách Thể Thao Sporty Năng Động SZone SQ530,3.0,3940639518960,89000,89000,0,0,0,thoi-trang-nam
249724558,Quần Jean nam cao cấp ống đứng le511 màu xanh rêu vải xuất khẩu xướt nhẹ dáng slimfit vải co giãn,3.0,6766049982613,410000,410000,0,0,1,thoi-trang-nam
246730077,Áo Ba Lỗ Tập Gym Nam Vải Cotton Rộng Nách SA471,33.0,2110255142625,99000,99000,0,0,6,thoi-trang-nam
221277014,Quần đùi nam thể thao BIG SIZE  FASVIN Từ 80 Đến 120KG vải co giãn mềm mát D21166.HN,32.0,4241443419039,189000,209000,20000,10,1,thoi-trang-nam
208755693,"Áo thun nam tay dài cổ tim giữ nhiệt KING chất thun co giãn , form rộng , giá rẻ  W02",1.0,8883887024583,130000,130000,0,0,0,thoi-trang-nam
205302540,"Quần tây Amazing, hoạ tiết vân chìm, không ly, ống suông, màu xám trung, vải spandex ít nhăn, dày, mềm",4.0,2873805247726,265000,408000,143000,35,2,thoi-trang-nam
199941761,Quần lót nam vòi voi,6.0,5467542132028,49000,49000,0,0,1,thoi-trang-nam
198262015,Áo thun nam dài tay Aligro màu navy co giãn 4 chiều chất thun cao cấp ALGAPD059,1.0,6901173389711,195000,195000,0,0,0,thoi-trang-nam
188914852,Áo Phông Nam Thun Lạnh Cao Cấp FASVIN TS20237.HN Dáng Thể Thao Vải Mềm Mát Co Giãn Tốt,18.0,1284639761108,110000,219000,109000,50,5,thoi-trang-nam
184827544,Quần Đùi Bò Nam Andromeda Phom Đứng Wash Nhẹ Vải Dày Không Ra Màu,1.0,6660651011398,98000,98000,0,0,0,thoi-trang-nam
174406721,Áo Chống Nắng Nam Coolair Laroma| UPF50+ | Vải Thơm | Làm Mát | Thời Trang | Đa Dụng,41.0,8754423191197,449000,449000,0,0,14,thoi-trang-nam
164081070,"TOKYO JAPAN, mã G27. Áo thun in chữ siêu đẹp, form unisex cho nam nữ, trẻ em. Áo phông GOKING hàng hiệu. Quà tặng cao cấp cho gia đình, cặp đôi, hội nhóm, doanh nghiệp",41.0,4952499365320,69000,69000,0,0,12,thoi-trang-nam
163713265,Áo Sơ Mi Nam Công Sở Trung Niên Thương Hiệu Anton Dài Tay Vải Cotton Xanh Đậm Trơn Có Túi -XA13,18.0,9721433892313,280000,280000,0,0,7,thoi-trang-nam
117176114,Sịp Đùi- Quần Lót Nam Boxer Cotton Sọc Ngang Phong Cách Nhật Bản Thanh Lịch K141,17.0,9100423916673,44000,44000,0,0,0,thoi-trang-nam
97823540,Áo Khoác Big Size Áo Khoác Dù Nam Có Cổ Trụ Chống Nắng Chống Nóng Chống Lạnh Chống Gió 2 Lớp Phối Logo Sọt Thời Trang Nam Tính Hàn Quốc Giá Tốt AD70 ,723.0,5730555154421,169000,169000,0,0,271,thoi-trang-nam
95052893,Quần short nam big size quần sọt nam thể thao chống nóng quần đùi nam mặc nhà quần thun nam cotton 4 chiều co giãn cao cấp WSB2 ,1434.0,9372611536157,115000,115000,0,0,283,thoi-trang-nam
91848059,"Quần jogger kaki cao cấp Amazing, lưng thun có dây rút, ống bo, thời trang unisex, màu sắc classic dễ phối đồ, có big size ",457.0,5232702008229,196000,385000,189000,49,140,thoi-trang-nam
90483736,Áo thun nam ngắn tay không cổ cotton FREEMAN TSF317,5.0,8353372795731,113050,119000,5950,5,0,thoi-trang-nam
83160773,Áo Thun Nam Cổ Bẻ Thêu Ong ,5.0,1195715497777,95000,95000,0,0,1,thoi-trang-nam
81694400,"Quần Jean Nam đẹp dẫn đầu xu hướng Thương Hiệu Chandi , mẫu mới form đẹp tôn dáng không quá ôm MR9043",239.0,1949296938430,159000,299000,140000,47,102,thoi-trang-nam
73744766,"Quần tây nam ống côn Amazing màu xám, dáng trẻ ôm gọn slimfit, chất liệu co giãn, trẻ trung, năng động",332.0,5954024060739,229000,418000,189000,45,149,thoi-trang-nam
70937555,Áo khoác kaki nam 2 lớp thời trang SITAKI cao cấp AKK18,303.0,7387392423406,175000,175000,0,0,102,thoi-trang-nam
68938543,Áo Sơ Mi Nam Vải Lụa Không Nhăn Nhiều Màu Tay Dài,5.0,6015858329320,157000,157000,0,0,3,thoi-trang-nam
56471284,Áo Khoác Dù Dày Nam 2 Lớp Chống Nắng Chống Gió Lạnh Cổ Trụ Cao Cấp AD51 - ShopN6 (Nhiều Màu),63.0,6342186474348,169000,240000,71000,30,9,thoi-trang-nam
52629244,combo 4 chiếc quần lót đùi ( boxer) nam thông hơi co dãn thoáng mát,1.0,4499636767955,148000,148000,0,0,0,thoi-trang-nam
52198505,Combo 4 Quần Sịp Nam Quần Lót Nam Sợi Cotton Cao Cấp MRM FASHION Mix 2 Màu TẶNG Đôi Tất Nam Cao Cấp,101.0,6422875968508,239000,340000,101000,30,24,thoi-trang-nam
50614559,Combo 4 Sịp Đúc Nam Lụa Sữa Cao Cấp Vải Siêu Mát thiết kế U Lồi phía trước mặc Thoải Mái Dễ Chịu - Nhiều Size Nhiều Màu để lưa chọn,38.0,6404046072160,319000,319000,0,0,10,thoi-trang-nam
17911356,"Áo khoác nam chống nắng gió thu đông Doka (DBLS101) chất liệu dù giữ ấm cao cấp có 3 màu đen , xanh đen , xanh rêu ",142.0,3532478854443,200000,200000,0,0,51,thoi-trang-nam
11270937,Áo thun nam dài tay cổ sơ mi SITAKI - ATD01,212.0,3759398539971,130000,130000,0,0,22,thoi-trang-nam
7078761,Bộ 5 Quần Lót Nam Nhật Cao Cấp (Giao Màu Ngẫu Nhiên),42.0,9727314391747,156000,156000,0,0,4,thoi-trang-nam
276871305,Quần jogger kaki túi hộp dã ngoại_có thun,5.0,3470114338204,528000,528000,0,0,0,thoi-trang-nam
276870972,Quần jogger túi hộp_dã ngoại_sinh tồn,5.0,9876056568207,578000,578000,0,0,0,thoi-trang-nam
276851314,"Combo 5 quần lót nam, quần sịp nam TG chất thun lạnh kháng khuẩn co giãn 4 chiều phong cách nam tính - Ares Shop",12.0,5497745118375,225000,250000,25000,10,1,thoi-trang-nam
276584510,"Quần lót nam, combo quần boxer nam cao cấp chất thun lạnh kháng khuẩn co giãn 4 chiều phong cách nam tính - KELVIN CELIN -",5.0,8170600187289,45000,50000,5000,10,0,thoi-trang-nam
276584084,"Quần lót nam ,quần sịp nam tam giác chất thun lạnh mềm mịn siêu mát, thấm hút mồ hôi - KELVIN CELIN -",9.0,1999213513664,45000,50000,5000,10,0,thoi-trang-nam
276580150,"Quần đùi nam, quần short linen nam nhiều màu, thoải mái, dễ mặc",4.0,6814353726053,279000,279000,0,0,0,thoi-trang-nam
276311369,Áo khoác nam - áo khoác thể thao nam cao cấp chất liệu vải poly cao cấp sang trọng- ARES SHOP,141.0,4642193992647,225000,250000,25000,10,16,thoi-trang-nam
276150571,Quần kaki xám túi hộp nam chất liệu kaki cotton bền bỉ thấm hút mồ hôi tốt style bụi bặm,73.0,2527059467830,360000,400000,40000,10,5,thoi-trang-nam
273395259,"Quần Đùi HUONGTAM  nam cao cấp(QDN). Chất liệu vải loại tốt: mềm mại, thoáng mát, không phai màu.",30.0,1881252336277,47600,47600,0,0,6,thoi-trang-nam
270743291,Hộp 5 quần lót nam xuất Nhật màu ngẫu nhiên siêu đẹp,25.0,1389569401300,73000,73000,0,0,1,thoi-trang-nam
196313090,"Áo khoác dù chống nắng nam, túi khóa kéo, nón có thể tách rời tiện lợi - FORMENSHOP - FMTHT050",41.0,4394607133467,89000,300000,211000,70,15,thoi-trang-nam
185842484,Áo ba lỗ nam 100% cotton - Áo cộc tay nam 100% cotton,25.0,2758476179499,35000,35000,0,0,2,thoi-trang-nam
184824763,Áo Ba Lỗ Thể Thao Thun Lạnh Thấm Hút Thoáng Mát Áo Sát Nách Cho Nam và Nữ,125.0,3105078590082,45000,45000,0,0,11,thoi-trang-nam
183901382,Viettien - Áo sơ mi công sở nam ngắn tay màu trắng mới 340 vạt bầu regular,29.0,3036421153248,340000,340000,0,0,11,thoi-trang-nam
172210350,"Hộp 4 quần boxer nam thun lạnh, quần lót nam co dãn 4 chiều- Formen Shop- FMQS017",994.0,7062974494025,159000,280000,121000,43,221,thoi-trang-nam
160903200,"Quần Jogger Nam LAMPOS Túi Hộp, Ống Zipper Cao Cấp, Cotton Co Giản 4 Chiều",38.0,3530260708633,195000,195000,0,0,11,thoi-trang-nam
160902809,"Quần Jogger Nam LAMPOS, Cotton Cao Cấp, Siêu Co Giản - Thoáng Mát - Siêu Bền (Màu đen)",22.0,1763012004231,195000,195000,0,0,10,thoi-trang-nam
148994401,"Quần Lót Nam Tam Giác Thun Lạnh, Quần Sịp Nam Tam Giác Cao Cấp, Chất Thun Lạnh Đẹp, Co Dãn 4 Chiều",221.0,8090803703214,40000,40000,0,0,38,thoi-trang-nam
143694820,Áo Sơ Mi Nam Sọc Chữ Dài Tay Mã Q889 Thời Trang Nam Công Sở PONIVA Cao Cấp Chất Liệu Mềm Mịn Thoáng Mát Hàng Chất Lượng VNXK,26.0,3120123109409,105000,105000,0,0,13,thoi-trang-nam
138752406,Áo thu đông nam cổ tròn dài tay chất cotton co giãn dáng body thời trang,111.0,9750802794838,129000,129000,0,0,30,thoi-trang-nam
119056035,Áo polo nam màu trắng phối viền chìm ADINO vải cotton polyester mềm dáng slimfit trẻ trung năng động AP81,93.0,1727478801381,159000,318000,159000,50,42,thoi-trang-nam
113052759,Áo khoác nam kaki chống nắng - from rộng trơn ,56.0,4605051716448,145000,145000,0,0,19,thoi-trang-nam
112099693,"Áo Sơ Mi Dài Tay Lính Mỹ U458 US ARMY, Chất Liệu Vải Kaki Cao Cấp Thiết Kế Túi Hộp Phong Cách Loại Xịn- HÀNG CHÍNH HÃNG",48.0,9419250044865,399000,798000,399000,50,22,thoi-trang-nam
110309352,"ÁO LÓT TAY NGẮN COTTON CATRIO LÀ ÁO THUN, ÁO PHÔNG, ÁO NGẮN TAY CỦA NAM TỪ 50KG ĐẾN 83KG thuộc đồ mặc đi ngủ, mặc ở nhà, mặc lót bên trong áo sơ mi, vải 100% cotton an toàn ",775.0,1512296163042,65000,65000,0,0,50,thoi-trang-nam
107154629,Quần lót nam Boxer Cotton co dãn 4 chiều Thông hơi thấm hút,15.0,6573416984099,7000,7000,0,0,11,thoi-trang-nam
101949588,Quần lót nam 292,29.0,2515127739942,27500,27500,0,0,2,thoi-trang-nam
100368290,Quần đùi nam Fasvin Q20263.HN vải gió chun co giãn mềm mại thoải mái,9.0,7919206186584,99000,179000,80000,45,0,thoi-trang-nam
91467052,"Quần bơi nam boxer cao cấp, dáng ngắn thể thao, eo kép dễ chịu, chất thun bơi đẹp không thấm nước nhanh khô, đàn hồi cao | BN006",40.0,1775408078013,199000,199000,0,0,7,thoi-trang-nam
87981660,"Combo 2 áo ba lỗ nam, áo 3 lỗ nam, sợi cotton mềm mịn, thấm hút mồ hôi tốt, thoáng mát, mặc thoải mái JAMANO",1881.0,5596176579261,149000,198000,49000,25,329,thoi-trang-nam
83518046,ÁO THUN NAM DÀI TAY CỔ SƠ MI PHONG CÁCH HÀN QUỐC ATD01-XÁM ĐEN,21.0,5509070211928,193700,193700,0,0,1,thoi-trang-nam
76705126,Áo thun nam có cổ cá sấu vải loại tốt nhập từ loại áo thun tay lỡ size 55kg đến 85kg,6.0,7473712874579,109000,109000,0,0,0,thoi-trang-nam
76121693,Áo khoác nam áo gió vải dù DOKA STORE cao cấp 2 lớp chống nắng tia UV và chống nước khoát phong cách Hàn Quốc - PS21,219.0,8489183733790,209000,209000,0,0,91,thoi-trang-nam
70662020,Áo khoác dù nam dấu nón 2 lớp lót nỉ thời trang SITAKI cao cấp AKD38,59.0,5415273573864,155000,155000,0,0,26,thoi-trang-nam
68200548,"Áo ba lỗ nam, áo sát nách nam,sợi cotton cao cấp mềm mịn, thấm hút mồ hôi, siều thoáng mát, co giãn 4 chiều Mrm Manlywear",393.0,3302988027824,119000,155000,36000,23,94,thoi-trang-nam
67294572,Áo Sơ Mi Nam Dài Tay Vải Lụa Chống Nhăn,275.0,5793387286062,109000,109000,0,0,78,thoi-trang-nam
54711023,"Quần Bơi Nam Thiết Kế Vảy Cá Mập Cleacco Chống Thấm Nước , Nhanh Khô Tặng Kèm Nón Bơi và Bịt Tai Silicon Cao Cấp",775.0,5241339162723,129000,201000,72000,36,150,thoi-trang-nam
52188800,Combo 4 Quần Sịp Đùi Nam Quần Lót Nam Boxer Sợi Cotton Cao Cấp MRM FASHION Mix 3 Màu TẶNG Đôi Tất Nam Cao Cấp,115.0,7198207073781,255000,380000,125000,33,27,thoi-trang-nam
51551126,Áo Sơ Mi Nam Cao Cấp Túi Hộp Ngắn Tay,138.0,7317348013719,95000,95000,0,0,35,thoi-trang-nam
31512583,Quần Jean Nam,19.0,5338697900781,99000,99000,0,0,5,thoi-trang-nam
277811715,"Áo cờ đỏ sao vàng, áo thun cổ tròn nền đỏ in sao vàng, unisex, size từ 10 đến 100kg, Amazing",2.0,3421927993967,51000,70000,19000,27,0,thoi-trang-nam
274905023,Quần short khaki nam Khatoco Q3M378R0-ININ147-2410-0,8.0,7026740852716,378000,378000,0,0,1,thoi-trang-nam
274904980,Quần short khaki nam Khatoco Q3M378R0-ININ145-2410-0,7.0,3670706789513,378000,378000,0,0,0,thoi-trang-nam
274429646,"Quần Jogger Nam Chất Kaki 2 Lớp Ống Xuông, Kiểu Dáng Hàn Trẻ Trung Thương Hiệu CHANDI CDA1",7.0,3786867979734,149000,250000,101000,40,0,thoi-trang-nam
251771032,"Combo 2 Áo thun Polo Nam Coolmax - Premium nam tính, thanh lịch sang trọng MRM Manlywear",20.0,2845961584400,479000,899000,420000,47,5,thoi-trang-nam
251572799,"Think Outside The Box, mã G282. Áo thun siêu đẹp cho cả gia đình. Form unisex cho nam nữ, trẻ em, bé trai gái",17.0,6500509619694,69000,69000,0,0,1,thoi-trang-nam
246729940,Áo ba lỗ cổ vuông nam cá tính SA455,22.0,3893231839144,49000,49000,0,0,9,thoi-trang-nam
240590851,Áo gile len nam nư KING ghile len nam cao cấp form rộng cao cấp giá rẻ T001,12.0,2594954630113,165000,165000,0,0,8,thoi-trang-nam
221277354,Quần Đùi Nam FASVIN Vải Gió Đẹp Hàng Nhà Máy Chất Lượng Cao Thể Thao Hay Mặc Nhà Q23556.HN,44.0,6127903168591,129000,179000,50000,28,9,thoi-trang-nam
221277189,Quần Đùi Nam FASVIN dáng lửng Vải Đẹp Hàng Nhà Máy Chất Lượng Cao Thể Thao Hay Mặc Nhà T23557.HN,38.0,4084878362996,149000,209000,60000,29,4,thoi-trang-nam
217176750,Áo khoác nỉ bông cotton dày mịn - hoodie form rộng unisex 1885 - 2N Unisex,15.0,9760944861789,239000,275000,36000,13,2,thoi-trang-nam
208750332,Áo ghile nam 6 nút bigsize 6XL KING Áo gile nam đen hàng may đo cá nhân cao cấp Z1-10,3.0,7412923843249,255000,255000,0,0,1,thoi-trang-nam
203177188,"Quần tây âu cao cấp, thời trang công sở không ly, form dáng chuẩn, họa tiết vân chìm, có size đại, Amazing",2.0,4278328143169,359000,552000,193000,35,1,thoi-trang-nam
197058539,Áo khoác măng tô nam cổ đức phong cách trẻ trung công sở NMT31,10.0,6198254720448,780000,780000,0,0,2,thoi-trang-nam
195947484,Áo sơ mi ngắn tay nam màu xanh nhạt ADINO vải nến lụa sợi sồi modal dáng công sở slimfit hơi ôm trẻ trung CT04,13.0,9096521830638,259000,380000,121000,32,3,thoi-trang-nam
177274778,Áo sơ mi rộng tay dài nam nữ unisex phong cách trẻ trung hàn quốc vải lụa mềm mịn mát ít nhăn -MRD01,15.0,9750304229172,105000,190000,85000,45,7,thoi-trang-nam
176769589,"Quần bơi big size cho nam giới béo mập, có size lớn đến 125kg, dáng sooc đùi dài, chất thun bơi lạnh dày dặn co giãn 4 chiều | BN017",31.0,5959453862559,180000,180000,0,0,7,thoi-trang-nam
138751282,Áo thun nam cổ tim dài tay hàng cao cấp nhiều màu đủ size,190.0,5353392799089,85000,85000,0,0,33,thoi-trang-nam
138749879,"Áo phông nam cổ tròn chất cotton thun lạnh mềm, mịn , dáng body thời trang",12.0,9174070580431,99000,99000,0,0,2,thoi-trang-nam
138748825,"Áo thun nam tay ngắn cổ tròn, chất cotton 100% , áo ngắn tay nhiều màu dáng ôm thời trang",24.0,9339999654336,79000,79000,0,0,3,thoi-trang-nam
137863363,Áo Sơ Mi Nam Caro Phối Chữ Ngắn Tayoe Mã 01 Thời Trang Nam Công Sở Thiết Kế Lịch Lãm Nam Tính Và Sang Trọng,8.0,9949459802811,125000,125000,0,0,3,thoi-trang-nam
134750203,Áo Sơ Mi Trắng Form Rộng Unisex Nam Nữ Tay Dài Hàn Quốc Kiểu Cổ Bẻ Vải Lụa Nhiều Màu - SMD01,126.0,6967880032948,105000,210000,105000,50,46,thoi-trang-nam
109403033,"Áo khoác gió nam nữ Goking, ngoài vải dù, trong lót lưới. 3 túi tiện dụng. Mã akg.goking4",162.0,3940236970411,155000,155000,0,0,56,thoi-trang-nam
100368214,Quần short thể thao nam Fasvin T21437.HN vải co giãn thoải mái thiết kế mạnh mẽ khoẻ khoắn,4.0,3687926310299,129000,209000,80000,38,1,thoi-trang-nam
100366611,Bộ thể thao nam Fasvin AT20252.HN chất vải mềm nhẹ co giãn mát mẻ không bai không xù,26.0,9803358685502,174000,348000,174000,50,5,thoi-trang-nam
95071208,"Quần Short Jean Nam co dãn kiểu dáng trẻ trung đơn giản Thương Hiệu Chandi, quần sọt mẫu mới xu hướng NT5050",12.0,8043864390992,139000,220000,81000,37,6,thoi-trang-nam
90483788,Combo 3 Áo thun nam ngắn tay cổ tim cotton FREEMAN TSF315,26.0,1492203494039,267300,297000,29700,10,5,thoi-trang-nam
82642262,Áo Sơ Mi Nam Ngắn Tay Ô Kẻ Thời Trang Poniva,11.0,3709655411514,105000,105000,0,0,4,thoi-trang-nam
78488562,"Quần Jean Nam siêu cấp thương hiệu Chandi,  chất jean co dãn mẫu mới mã HD89",99.0,8221396390025,159000,299000,140000,47,46,thoi-trang-nam
75628604,"Áo khoác dù nam, áo gió nam cao cấp, chống nắng, chống bám bụi – FORMEN SHOP – FMHN005",54.0,5450982416705,79000,250000,171000,68,19,thoi-trang-nam
57711438,Quần Bơi Nam 2 Lớp SZone 469,59.0,7723355219813,99000,99000,0,0,18,thoi-trang-nam
51638534,Áo Sơ Mi Nam Trơn Ngắn Tay Form Chuẩn,179.0,7655541124130,105000,105000,0,0,60,thoi-trang-nam
35236973,Combo 3 quần lót nam Freeman 6053 - Chất liệu thun lạnh cao cấp,55.0,3341224235944,240300,267000,26700,10,14,thoi-trang-nam
35193606,[FREEMAN] Combo 5 quần lót nam 6034,179.0,6109261725197,156000,195000,39000,20,46,thoi-trang-nam
35087712,"Quần lót nam thun lạnh không đường may, sịp nam tam giác cao cấp chất liệu thoáng mát, mềm mịn QLW606",430.0,5171560809893,69000,69000,0,0,86,thoi-trang-nam
25281818,Áo len dài tay nam thời trang Hàn Quốc SAL214 Xanh than,28.0,9049271216551,189000,189000,0,0,9,thoi-trang-nam
20680707,Quần Dài Jogger Nam Phối Sọc 1066,134.0,8041206479445,85500,85500,0,0,13,thoi-trang-nam
7989432,Áo khoác chống nước nam KTOM,158.0,7065865404915,680000,680000,0,0,42,thoi-trang-nam
3073221,Quần Tây Nam Cao Cấp CLASIC 03,19.0,1480562331535,99000,99000,0,0,0,thoi-trang-nam
276150761,Quần Kaki Túi Hộp Retro (nam nữ ) chất liệu kaki bền bỉ mềm mịn,133.0,4277071555446,360000,400000,40000,10,10,thoi-trang-nam
275478609,áo thun nam hottren đẹp 951,2.0,5817716120519,69000,69000,0,0,1,thoi-trang-nam
274960088,"Quần đùi nam huong tam cao cấp (QDNN6). Chất liệu vải loại tốt: mềm mại, thoáng mát, không phai màu.",7.0,3894200445394,47600,47600,0,0,0,thoi-trang-nam
273398705,Viettien - Quần Jeans nam dài Regular fit Màu Xám đậm 6S7023,1.0,6511345061947,840000,840000,0,0,0,thoi-trang-nam
270758519,Quần jean túi hộp ống rộng nam nữ 2N Unisex cargo pants màu xám thời trang Q02,7.0,4275599855240,309000,390000,81000,21,2,thoi-trang-nam
248689686,Áo sơ mi nam tay dài form suông Khatoco A1MD398T1-CNCR164-2410-D,7.0,9136172640605,398000,398000,0,0,2,thoi-trang-nam
206717258,Bộ trang phục ông già Noel nhung 7 món/ quần áo ông già Noel hoá trang giáng sinh,6.0,8055636017700,135000,135000,0,0,0,thoi-trang-nam
203404415,"Bộ quần áo đũi trung niên nam cho ông cho bố, Bộ mặc nhà cổ tàu nhẹ mát thêu long phượng sum vầy, Phong cách sang trọng",15.0,5190941993020,300000,300000,0,0,4,thoi-trang-nam
196586343,Quần tây nam 1ply Novelty màu nâu NQTMMDMPRR1600181,19.0,1546378119787,395000,395000,0,0,5,thoi-trang-nam
187644697,Áo thun tay lỡ form rộng - phông nam nữ cotton oversize - T shirt hồng pastel a - 2N Unisex,32.0,7725292106351,99000,125000,26000,21,3,thoi-trang-nam
184915041,ÁO BA LỖ NAM là áo may ô nam từ 40_83kg vải 100% cotton thiết kế 3 lỗ thoáng mát lót trong áo sơ mi,156.0,4140775218672,59000,59000,0,0,11,thoi-trang-nam
150494070,QUẦN ÂU NAM VẢI CO GIÃN CHẤT ĐẸP - QUẦN TÂY NAM - QUẦN NAM,5.0,4437349007902,148000,148000,0,0,1,thoi-trang-nam
141660170,Áo vest dạ nam trẻ trung cao cấp NAD70,5.0,2286701100518,1480000,1480000,0,0,1,thoi-trang-nam
141657282,Áo khoác măng tô nam cổ đức trẻ trung công sở NMT54,6.0,4502657492557,1030000,1030000,0,0,2,thoi-trang-nam
140464696,Áo Sơ Mi Nam Dài Tay Họa Tiết Caro Màu Xanh Lá Mẫu Không lên lai Thời Trang PONIVA Chất Vải Mềm Mại Thấm Hút Mồ Hôi,94.0,5106097246149,115000,115000,0,0,24,thoi-trang-nam
134656633, Áo sơ mi form rộng tay ngắn tay lỡ unisex nam nữ cá tính form Hàn Quốc vải lụa - SMN02,21.0,5163460686823,95000,190000,95000,50,7,thoi-trang-nam
119064764,Áo polo nam màu xanh bích đậm phối viền chìm ADINO vải cotton polyester mềm dáng slimfit công sở trẻ trung năng động AP83,50.0,8315621521990,159000,318000,159000,50,22,thoi-trang-nam
111972654,Quần Túi Hộp Tháo Ống US ARMY U880 Chuyên Phượt Chất Vải Gió Cao Cấp Mau Khô Ống Có Thể Tháo Rời Làm Quần Short -HÀNG CHÍNH HÃNG,364.0,9418895924007,349000,698000,349000,50,99,thoi-trang-nam
106764912,"Quần Lót Nam Boxer Xuyên Thấu Thông Hơi Lưng Nhật Thoáng Mát, Quần Sịp Đùi Thông Hơi Cao cấp",113.0,8120888676837,40000,40000,0,0,22,thoi-trang-nam
106700356,"Quần Jean Nam Vovesa Mẫu Mới, Dáng Ôm Trẻ Trung, Nam Tính Q4",16.0,9649933220469,115000,115000,0,0,5,thoi-trang-nam
101949803,Quần boxer nam,13.0,8793604940933,31500,31500,0,0,4,thoi-trang-nam
94351100,"Quần Lót Nam Boxers Thương Hiệu Brave Person B1176 - Thiết kế cá tính, form dáng tinh tế, hợp thời trang, chất vải siêu mát mẻ, thoáng và thấm hút mồ hôi tốt, 3 màu cho bạn thoải mái lựa chọn",25.0,9236317185357,139000,199000,60000,30,12,thoi-trang-nam
90722180,Quần short đũi nam dáng ngắn mặc hè Đũi Việt DV06,15.0,6077880035052,149000,149000,0,0,3,thoi-trang-nam
84823077,Quần Sịp Pump Cotton Kiểu Dáng Thể Thao Mới K222,36.0,4955107287089,65000,65000,0,0,13,thoi-trang-nam
83517309,ÁO THUN NAM DÀI TAY NỈ DA CÁ PHỐI MÀU ,8.0,8312637268517,297700,297700,0,0,5,thoi-trang-nam
81715297,Quần Short Kaki Nam Túi Hộp,102.0,5010617127291,159000,159000,0,0,24,thoi-trang-nam
79369713,"Quần Lót Nam, Quần Sịp Nam Cao Cấp - Chất Liệu Mềm Mịn Thoáng Mát - Thiết Kế Cạp Liền - Thương Hiệu Brave Person B1151",62.0,4734877713291,159000,260000,101000,39,18,thoi-trang-nam
71168734,Áo thun nam ngắn tay cổ tim body thời trang SITAKI cao cấp ATN06,328.0,4372632571880,80000,80000,0,0,105,thoi-trang-nam
59080911,ÁO KHOÁC KAKI NAM,6.0,5092900254558,345450,345450,0,0,1,thoi-trang-nam
58838015,Quần bơi nam vảy da cá thể thao chuyên nghiệp YOUYOU,63.0,9220567705632,130000,130000,0,0,12,thoi-trang-nam
57758774,"Quần short nam có Big Size 115kg lưng thun co giãn 4 chiều ,quần đùi nam thể thao cao cấp ShopN6 - QSB1 (sọc ngẫu nhiên)",347.0,3590128799513,59000,105000,46000,44,63,thoi-trang-nam
56919853,Áo Len Cổ Lọ Nam SZone SAL222 Phong Cách Hàn Quốc,640.0,4679141074421,129000,129000,0,0,199,thoi-trang-nam
56614642,"Combo 5 quần sịp boxer chất cotton mềm mịn, thoải mái, nhiều màu - FORMEN SHOP - FMCB5QS007",525.0,4202361302953,189000,245000,56000,23,144,thoi-trang-nam
55887530,Quần Jeans Nam Phong Cách Trẻ Trung Đơn Giản,4.0,6359514865464,109000,109000,0,0,2,thoi-trang-nam
52253824,Quần short thun Nam tập GYM thể thao - Q0003,84.0,9557976024123,110000,110000,0,0,28,thoi-trang-nam
50456519,"Quần ngủ nam lưới thể thao vải mát lịm thêm miếng lót nhỏ bên trong nâng đỡ phần nhạy cảm, lỗ thoáng mát sexy kiểu dáng thể thao nam tính",77.0,1624098388155,99000,99000,0,0,17,thoi-trang-nam
41654783,Áo Len Cổ Lọ Nam Phong Cách Hàn Quốc Siêu Ấm SAL222,315.0,2126844584617,129000,129000,0,0,78,thoi-trang-nam
23296068,Quần Lót BOXER Nam,593.0,4797799622136,199000,199000,0,0,120,thoi-trang-nam
23062614,COMBO 2 QUẦN SHORT NAM WINFA - 2 MÀU,2.0,9687145456216,209000,209000,0,0,0,thoi-trang-nam
7989720,Áo gió nam,55.0,8022298935613,250000,250000,0,0,13,thoi-trang-nam
276886830,"Quần dài nam ống suông, phong cách đường phố, chất linen bột premium cao cấp, có dây rút eo dễ mặc thoải mái Qd10",2.0,6005935154783,280000,280000,0,0,0,thoi-trang-nam
276832011,Quần Mặc Nhà Nam SKD02 Vải Kate Co Giãn Nhẹ,1.0,8890951193163,65000,65000,0,0,0,thoi-trang-nam
276233070,"Quần lót nam ,quần sịp nam tam giác Ares chất thun lạnh mềm mịn siêu mát, thấm hút mồ hôi - ARES SHOP",272.0,8984601375719,45000,50000,5000,10,18,thoi-trang-nam
276123170,"Quần lót nam, quần boxer nam Ares Man chất thun lạnh mềm mịn siêu mát, thấm hút mồ hôi Ares man 2.0",305.0,6766733442605,45000,50000,5000,10,14,thoi-trang-nam
275567018,áo khoác nam cao cấp vải xịn mẫu mới ra hot nhiều màu a50,3.0,1302877658276,189000,189000,0,0,0,thoi-trang-nam
274145329,"Quần suông ống rộng nam nữ Đũi Việt chất liệu linen thời trang cao cấp, trẻ trung",6.0,2233965384044,249000,249000,0,0,0,thoi-trang-nam
248644330,Áo khoác nam nhung tăm mã AKN12  ,2.0,4203291505788,195000,195000,0,0,0,thoi-trang-nam
246730745,QUẦN JEAN NAM HÀN QUỐC SZONE B552,3.0,3174631240154,145000,145000,0,0,1,thoi-trang-nam
221277381,Quần Đùi Nam FASVIN Vải Gió Đẹp Hàng Nhà Máy Chất Lượng Cao Thể Thao Hay Mặc Nhà Q22553.HN,27.0,9766685923342,129000,179000,50000,28,11,thoi-trang-nam
217176888,Áo thun tay lỡ form rộng - phông nam nữ oversize - T shirt in tọa độ - 2N Unisex,159.0,7001187929797,91000,125000,34000,27,32,thoi-trang-nam
192218094,"Áo thun nam dài tay cổ tròn mặc thu đông, giữ nhiệt, chất cotton co giãn, dáng ôm thời trang",5.0,1616165318312,129000,129000,0,0,1,thoi-trang-nam
191777258,ÁO THUN ĐEN CỔ TRÒN IN LƯNG ĐẸP CHẤT COTTON MỊN BIG SIZE NAM TỚI 130KG,4.0,3397126793585,180000,180000,0,0,1,thoi-trang-nam
190154762,Viettien - Quần tây nam màu xanh đen không ly regular fit 650k quần âu việt tiến phom vừa không ôm không rộng,1.0,3923195610579,650000,650000,0,0,1,thoi-trang-nam
188914423,Bộ quần áo nam Fasvin AT22505.HN chất vải thun mềm mát co giãn phù hợp thể thao hay mặc nhà,21.0,9799813071158,199000,358000,159000,44,0,thoi-trang-nam
179216239,"Combo 3 quần lót boxer trơn, chất thun mềm mịn thấm hút mồ hôi tốt, co giãn tốt,  - FORMEN SHOP - FMQS018",158.0,6393893040078,89000,250000,161000,64,42,thoi-trang-nam
179162754,(Big size <130kg) Áo sơ mi nam cổ trụ tay ngắn big size,11.0,3768900392690,235000,235000,0,0,1,thoi-trang-nam
177055613,Áo sơ mi rộng cổ vest nam nữ unisex tay dài phong cách hàn quốc trẻ trung vải lụa mềm mát-VRD01,7.0,5152241431593,105000,190000,85000,45,2,thoi-trang-nam
172324846,"Enjoy Your Life, mã G146. Áo thun nam nữ in chữ siêu đẹp, form unisex. Áo phông GOKING hàng hiệu, quà tặng cao cấp cho gia đình, cặp đôi, hội nhóm, doanh nghiệp",72.0,2685054374982,69000,69000,0,0,13,thoi-trang-nam
148845226,Đồ bộ thể thao nam thun lạnh siêu mát,3.0,9030880851552,249000,249000,0,0,1,thoi-trang-nam
146458764,Áo khoác hoodie nỉ bông cotton dày mịn - hoodie form rộng unisex thỏ bunny,7.0,2677831427453,239000,275000,36000,13,2,thoi-trang-nam
144523087,"Áo dạ nam - kiểu dáng hiện đại, style Hàn Quốc (R8)",41.0,6437598631153,298000,298000,0,0,13,thoi-trang-nam
138381315,"Áo thun dài tay nam giữ nhiệt co giãn mặc lót chơi thể thao, đá bóng Micado",359.0,1745360238412,60000,60000,0,0,23,thoi-trang-nam
112086654,"Quần Túi Hộp Nam Lính Mỹ US ARMY U768 Cao Cấp, Chất Liệu Vải Kaki,Bền Màu, Ống Rộng Phong Cách, Thiết kế Túi Hộp- HÀNG CHÍNH HÃNG",92.0,2820363870141,500000,1000000,500000,50,38,thoi-trang-nam
111709849,Áo thun nam Áo polo nam ngắn tay có cổ PN01 Cotton 100% cao cấp phong cách Hàn Quốc,9.0,8620742795866,85000,85000,0,0,5,thoi-trang-nam
110429809,Quần đùi nam Cotton mặc nhà thoải mái thoáng mát JAMANO- 1 Chiếc MÀU NGẪU NHIÊN,75.0,8526319592775,55000,70000,15000,21,9,thoi-trang-nam
107801368,"Combo 2 quần đùi nam May 10 phiên bản có túi 2 bên, màu ngẫu nhiên",1150.0,2201245004321,150000,200000,50000,25,236,thoi-trang-nam
102086317,"Quần tây nam Amazing form body Hàn Quốc, ống ôm, vải co giãn, phong cách năng động, trẻ trung",49.0,3916288610459,229000,418000,189000,45,16,thoi-trang-nam
90483829,Combo 2 Áo lót nam cổ tim tay ngắn FREEMAN TSF311,41.0,1588029529780,245100,258000,12900,5,7,thoi-trang-nam
83161649,QUẦN TÂY NAM THỜI TRANG ,4.0,3120652017240,145000,145000,0,0,1,thoi-trang-nam
83161336,Áo Thun Nam Cổ Bẻ Viền Tay Thời Trang Poniva,19.0,5314110383526,95000,95000,0,0,4,thoi-trang-nam
78945633,"Quần Lót Nam Tam Giác Chất Liệu Mềm Mại Thoáng Mát, Co Dãn 4 Chiều Thương Hiệu Brave Person B1129",95.0,7536294225279,169000,240000,71000,30,25,thoi-trang-nam
73742258,"Combo 5 Quần Lót Nam nhiều lưng co giãn 2 chiều vải cotton hiệu CITYMEN, màu ngẫu nhiên, đồ lót - LMTK-MULTI2C",821.0,4226489460746,90000,90000,0,0,289,thoi-trang-nam
52198702,Combo 4 Quần Sịp Nam Quần Lót Nam Sợi Cotton Cao Cấp MRM FASHION Mix 3 Màu TẶNG Đôi Tất Nam Cao Cấp,22.0,1312797188892,239000,340000,101000,30,1,thoi-trang-nam
39725831,Combo 2 gói Quần Lót Giấy Nam Procare TC PRMG002  - Trắng,106.0,8713062048492,65000,65000,0,0,6,thoi-trang-nam
32988061,Hộp Combo 5 Sịp Đùi Loại Đẹp,338.0,5098716599685,199000,199000,0,0,66,thoi-trang-nam
25097546,ÁO KHOÁC DA NAM LÓT LÔNG SITAKI - AD14 NÂU,23.0,6459010409947,299000,299000,0,0,8,thoi-trang-nam
24004714,Áo sơ nam việt tiến dài tay,131.0,8239227592339,440000,440000,0,0,34,thoi-trang-nam
21436280,Áo sơ mi việt tiến,70.0,5620004034389,440000,440000,0,0,18,thoi-trang-nam
6187707,Bộ 5 quần đùi lót nam xuất Nhật chất lụa cao cấp,102.0,6182041585747,74098,74098,0,0,10,thoi-trang-nam
3714935,Combo 5 Quần Lót Nam Freeman 6043-CB5,22.0,6944199606336,276000,345000,69000,20,1,thoi-trang-nam
276950426,"Sách - Iron Flame - The fiery sequel to the Sunday Times bestseller and TikTok by Rebecca Yarros (UK edition, paperback)",6.0,6913213870582,351000,351000,0,0,1,cross-border-hang-quoc-te
273776621,"Sách - The Science of Interstellar by Kip Thorne (US edition, paperback)",2.0,6518489904048,1226000,1226000,0,0,0,cross-border-hang-quoc-te
248361175,"Sách - The Art of Learning - An Inner Journey to Optimal Performance by Josh Waitzkin (US edition, paperback)",30.0,2844000318633,431000,431000,0,0,1,cross-border-hang-quoc-te
196056817,"Sách - Where the Crawdads Sing (Movie Tie-In) by Delia Owens (US edition, paperback)",6.0,6630716080070,489000,489000,0,0,0,cross-border-hang-quoc-te
190313245,"Sách - Heart Bones by Colleen Hoover (US edition, paperback)",5.0,2005269771452,493000,493000,0,0,0,cross-border-hang-quoc-te
173910621,"Sách - Effortless : Make it Easier to Do What Matters by Greg McKeown (UK edition, paperback)",4.0,9819133821203,540000,540000,0,0,0,cross-border-hang-quoc-te
170726279,"Sách - The Handmaid's Tale by Margaret Atwood (US edition, paperback)",27.0,8590615997272,202000,202000,0,0,1,cross-border-hang-quoc-te
170722233,"Sách - Harry Potter And The Goblet Of Fire by J.K. Rowling (UK edition, paperback)",50.0,7784935943028,239000,239000,0,0,0,cross-border-hang-quoc-te
170722169,"Sách - Get a Financial Life: Personal Finance in Your Twenties and Thirties by Beth Kobliner (US edition, paperback)",1.0,8114522259220,553000,553000,0,0,0,cross-border-hang-quoc-te
170706578,"Sách - The Secret History by Donna Tartt (UK edition, paperback)",27.0,2139411235103,390000,390000,0,0,1,cross-border-hang-quoc-te
170692392,"Sách - The Fantastic Book of Feelings: A Guide to Being Happy, Sad and Everyt by Marcia Williams (UK edition, hardcover)",1.0,5501958904115,588000,588000,0,0,0,cross-border-hang-quoc-te
170657513,"Sách - Working Backwards : Insights, Stories, and Secrets from Inside Amazon by Colin Bryar (US edition, paperback)",4.0,2485348544098,580000,580000,0,0,0,cross-border-hang-quoc-te
170630681,"Sách - Human Acts by Han Kang (UK edition, paperback)",3.0,2830744656460,350000,350000,0,0,0,cross-border-hang-quoc-te
170582810,"Sách - The Essential Cocktail Book : A Complete Guide to Modern Drinks with 15 by Megan Krigbaum (US edition, paperback)",4.0,4812857565178,684000,684000,0,0,0,cross-border-hang-quoc-te
170578980,"Sách - Lonely Planet Best of Japan by Lonely Planet (US edition, paperback)",1.0,6279202725733,942000,942000,0,0,0,cross-border-hang-quoc-te
170578900,"Sách - How to Love by Thich Nhat Hanh (US edition, paperback)",19.0,6960069915150,306000,306000,0,0,2,cross-border-hang-quoc-te
165017868,"Sách - Seven Husbands of Evelyn Hugo : Tiktok made me buy it! by TAYLOR JENKINS REID (UK edition, paperback)",88.0,4809458742679,318000,318000,0,0,15,cross-border-hang-quoc-te
164240684,"Sách - The Sun My Heart : The Companion to The Miracle of Mindfulness by Thich Nhat Hanh (US edition, hardcover)",1.0,6140296221307,540000,540000,0,0,0,cross-border-hang-quoc-te
164240680,"Sách - How to Relax by Thich Nhat Hanh Jason Deantonis (US edition, paperback)",2.0,3101320367579,306000,306000,0,0,0,cross-border-hang-quoc-te
161030316,"Sách - The Psychology of Money : Timeless lessons on wealth, greed, and happiness by Morgan Housel - (UK Edition, paperback)",160.0,3922878381035,499000,499000,0,0,17,cross-border-hang-quoc-te
134441777,"Sách - Positive Parenting : An Essential Guide by Rebecca Eanes - (US Edition, paperback)",4.0,8649660743698,416000,416000,0,0,1,cross-border-hang-quoc-te
127787001,"Sách - No Mud, No Lotus by Thich Nhat Hanh - (US Edition, paperback)",8.0,9967978214705,412000,412000,0,0,0,cross-border-hang-quoc-te
127515847,"Sách - Atomic Habits : An Easy and Proven Way to Build Good Habits and Break Bad Ones by James Clear - (US Edition, paperback)",83.0,2859245017942,321300,321300,0,0,16,cross-border-hang-quoc-te
116898357,"Sách - The Song of Achilles by Madeline Miller - (US Edition, paperback)",0.0,6424756680379,526000,526000,0,0,2,cross-border-hang-quoc-te
113408211,"Sách - The Real Book of Real Estate : Real Experts. Real Stories. Real Life. by Robert T. Kiyosaki - (US Edition, paperback)",7.0,4306649968139,742000,742000,0,0,1,cross-border-hang-quoc-te
111067221,Nút tai silicon Bluedio NE -40dB Giảm tiếng ồn Cách nhiệt Bảo vệ tai Chống ồn ,56.0,1728271080363,141000,141000,0,0,6,cross-border-hang-quoc-te
108600088,Áo khoác phản quang cho nam đi xe đạp và các hoạt động thể thao ngoài trời,9.0,3172200197613,430000,430000,0,0,1,cross-border-hang-quoc-te
108125509,"Kính bảo hộ bơi lặn chất lượng cao, Tròng kính cường lực bền đẹp,Mặt nạ PVC mềm có chức năng niêm phong tốt",1.0,9433652311159,274000,274000,0,0,0,cross-border-hang-quoc-te
28602083,Retail 101: The Guide to Managing and Marketing Your Retail Business,1.0,3092108900426,750000,750000,0,0,0,cross-border-hang-quoc-te
17970235,Never Split The Difference,50.0,9696319999497,410550,410550,0,0,10,cross-border-hang-quoc-te
17968992,The Complete Cosmicomics,4.0,8507126006081,346000,346000,0,0,1,cross-border-hang-quoc-te
17965507,The Sorrow Of War (New Edition),1.0,2034171234719,293000,293000,0,0,0,cross-border-hang-quoc-te
11778938,Alice In Wonderland,3.0,5784766010491,597000,597000,0,0,0,cross-border-hang-quoc-te
11708954,Unshakeable: Your Guide To Financial Freedom,8.0,3501188407508,484000,484000,0,0,4,cross-border-hang-quoc-te
11534299,It Ends With Us,285.0,4223009185394,359000,359000,0,0,59,cross-border-hang-quoc-te
11504758,Nice Girls Still Don't Get The Corner Office,5.0,9937684942931,316000,316000,0,0,1,cross-border-hang-quoc-te
10761139,BEHAVE The Biology of Humans at Our Best and Worst,24.0,4929303434670,523000,523000,0,0,5,cross-border-hang-quoc-te
7917860,The Subtle Art of Not Giving A F*ck,151.0,7310081250915,330000,330000,0,0,18,cross-border-hang-quoc-te
2043735,"The Culture Map: Decoding How People Think, Lead, And Get Things Done Across Cultures",108.0,5949707218590,481000,481000,0,0,10,cross-border-hang-quoc-te
514255,Combo 6 Chai Sữa Nước Abbott Ensure Liquid Vanilla 237ml,214.0,8003127311853,290000,290000,0,0,18,cross-border-hang-quoc-te
276950440,"Sách - Reckless - TikTok made me buy it! The epic and sizzling fantasy romance by Lauren Roberts (UK edition, paperback)",0.0,2952751187026,251000,251000,0,0,0,cross-border-hang-quoc-te
273858513,"Sách - The Seven Year Slip by Ashley Poston (UK edition, paperback)",4.0,6577918890722,473000,473000,0,0,1,cross-border-hang-quoc-te
273783941,"Sách - The Time Traveller's Guide to Medieval England : A Handbook for Visitors  by Ian Mortimer (UK edition, paperback)",1.0,1103898867338,610000,610000,0,0,0,cross-border-hang-quoc-te
273780395,"Sách - The Leopard : Revised and with new material by Giuseppe Tomasi di Lampedusa (UK edition, paperback)",3.0,1169801382360,485000,485000,0,0,0,cross-border-hang-quoc-te
273751018,"Sách - Blood Meridian by Cormac McCarthy (UK edition, paperback)",3.0,6263866791001,549000,549000,0,0,0,cross-border-hang-quoc-te
273733430,"Sách - Babel Or the Necessity of Violence : An Arcane History of the Oxford Trans by R. F. Kuang (UK edition, Paperback)",1.0,1181768759000,517000,517000,0,0,0,cross-border-hang-quoc-te
271413818,"Sách - Once Upon A Broken Heart by Stephanie Garber (UK edition, paperback)",3.0,9124340163649,633000,633000,0,0,0,cross-border-hang-quoc-te
271081870,"Sách - The Hunger Games 4 Book Paperback Box Set by Suzanne Collins (UK edition, paperback)",3.0,4612544569117,958000,958000,0,0,0,cross-border-hang-quoc-te
263764819,"Sách - The Bluest Eye by Toni Morrison (US edition, paperback)",3.0,5989212138087,368000,368000,0,0,0,cross-border-hang-quoc-te
203218996,"Sách - True Love by Thich Nhat Hanh (US edition, paperback)",5.0,3576344222364,283000,283000,0,0,1,cross-border-hang-quoc-te
176463031,"Sách - Prisoners of Geography : Ten Maps That Tell You Everything You Need to Kn by Tim Marshall (UK edition, paperback)",45.0,2795832521253,394000,394000,0,0,4,cross-border-hang-quoc-te
170706546,"Sách - Llewellyn's 2022 Sun Sign Book : Horoscopes for Everyone by Llewellyn Publications (US edition, paperback)",1.0,4596715167437,457000,457000,0,0,0,cross-border-hang-quoc-te
170706535,"Sách - Llewellyn's 2022 Moon Sign Book : Plan Your Life by the Cycles by Llewellyn Publications (US edition, paperback)",1.0,6217396687497,474000,474000,0,0,0,cross-border-hang-quoc-te
170706415,"Sách - Dr. Jekyll & Mr. Hyde by Robert Louis Stevenson (US edition, paperback)",1.0,6050351448480,341000,341000,0,0,0,cross-border-hang-quoc-te
170706326,"Sách - Greek Myths : A New Retelling by Charlotte Higgins (US edition, hardcover)",1.0,6291994227353,978000,978000,0,0,0,cross-border-hang-quoc-te
170704873,"Sách - A Shepherd Looks at Psalm 23 by W. Phillip Keller (US edition, paperback)",1.0,7153940102776,247000,247000,0,0,0,cross-border-hang-quoc-te
170704046,"Sách - Letters from a Stoic by Lucius Seneca (UK edition, paperback)",16.0,4183621973915,223000,223000,0,0,5,cross-border-hang-quoc-te
170704045,"Sách - The Prophet by Kahlil Gibran (UK edition, paperback)",2.0,2169495296105,322000,322000,0,0,1,cross-border-hang-quoc-te
170695705,"Sách - Unravel Me by Tahereh Mafi (UK edition, paperback)",4.0,5792260393215,394000,394000,0,0,1,cross-border-hang-quoc-te
170682912,"Sách - The Year of Magical Thinking by Joan Didion (UK edition, paperback)",1.0,9465588307565,590000,590000,0,0,0,cross-border-hang-quoc-te
170629042,"Sách - Freak the Mighty by Rodman Philbrick (UK edition, paperback)",5.0,5926450567201,308000,308000,0,0,0,cross-border-hang-quoc-te
170625647,"Sách - The China Study: Revised and Expanded Edition : The Most Comprehensi by T. Colin Campbell (US edition, paperback)",3.0,2533995497168,931000,931000,0,0,0,cross-border-hang-quoc-te
170625458,"Sách - Jujutsu Kaisen, Vol. 5 by Gege Akutami (US edition, paperback)",1.0,1032725935958,330000,330000,0,0,0,cross-border-hang-quoc-te
170624746,"Sách - Berlitz Pocket Guide Lisbon (Travel Guide with Dictionary) by (UK edition, paperback)",1.0,4743556592477,483000,483000,0,0,0,cross-border-hang-quoc-te
170583060,"Sách - Children: the Challenge by Zuckerman (UK edition, paperback)",1.0,9583452054211,536000,536000,0,0,0,cross-border-hang-quoc-te
170581822,"Sách - Light on Yoga by B. K. S. Iyengar (US edition, paperback)",5.0,6025958788152,734000,734000,0,0,0,cross-border-hang-quoc-te
146553822,CINCATDY Tai Nghe Bluetooth V5.0 Earbuds Gaming Headphone True Wireless Headset E6S - Hàng Chính Hãng,27.0,5745592451835,177000,177000,0,0,2,cross-border-hang-quoc-te
113401059,"Sách - That Will Never Work : The Birth of Netflix and the Amazing Life of an Idea by Marc Randolph - (US Edition, paperback)",4.0,3296726698490,652000,652000,0,0,0,cross-border-hang-quoc-te
113348958,"Sách - Eat, Sleep, Innovate : How to Make Creativity an Everyday Habit Inside Your Organization by Scott D. Anthony Paul Cobban Natalie Painchaud Andy Parker - (US Edition, hardcover)",1.0,4519722197192,862000,862000,0,0,0,cross-border-hang-quoc-te
108603895,"Bàn đạp xe đạp ZTTO MTB hợp kim nhôm cao cấp, chống trượt",2.0,6592852278570,542000,542000,0,0,0,cross-border-hang-quoc-te
108603111,"Găng tay thể thao Wheel UpSummer đi xe đạp nửa ngón chống nắng, chống trượt , giảm sốc",3.0,6361457114680,202000,202000,0,0,0,cross-border-hang-quoc-te
28602603,"How To Make Money In Stocks: A Winning System in Good Times and Bad, Fourth Edition",8.0,3967839376003,774000,774000,0,0,1,cross-border-hang-quoc-te
17968674,Penguin On Design: Ways Of Seeing,6.0,5148593946369,354000,354000,0,0,1,cross-border-hang-quoc-te
17961566,Road To Character,10.0,3347475090608,391000,391000,0,0,1,cross-border-hang-quoc-te
11862453,"Little Prince, The (Picture Bk)",1.0,7684086142774,474000,474000,0,0,0,cross-border-hang-quoc-te
11708614,How To Talk So Teens Will Listen And Listen So Teens Will Talk,8.0,6099078646207,462000,462000,0,0,0,cross-border-hang-quoc-te
11534814,Getting To Yes With Yourself,1.0,2803616589420,445000,445000,0,0,0,cross-border-hang-quoc-te
11446405,Great Again,10.0,4352797618361,452000,452000,0,0,1,cross-border-hang-quoc-te
11409859,Norse Goddess Magic,1.0,6666127161587,437000,437000,0,0,1,cross-border-hang-quoc-te
7917829,Good To Great: Why Some Companies Make The Leap,40.0,1861299167558,389000,389000,0,0,2,cross-border-hang-quoc-te
274221104,"Sách - Behavioral Economics by Edward Cartwright (UK edition, paperback)",0.0,2643571845962,3037000,3037000,0,0,0,cross-border-hang-quoc-te
273862072,"Sách - Nothing To Envy - Real Lives In North Korea by Barbara Demick (UK edition, paperback)",3.0,9319456121970,502000,502000,0,0,0,cross-border-hang-quoc-te
273784388,"Sách - The Name Of The Game Is A Kidnapping (paperback) by Keigo Higashino (UK edition, paperback)",0.0,4596757775097,719000,719000,0,0,0,cross-border-hang-quoc-te
273776298,"Sách - Never Let Me Go by Kazuo Ishiguro (UK edition, paperback)",6.0,7137865793100,387000,387000,0,0,0,cross-border-hang-quoc-te
273773103,"Sách - Oxford Learner's German Dictionary by  (UK edition, paperback)",1.0,2123678416790,621000,621000,0,0,0,cross-border-hang-quoc-te
273764149,"Sách - A Tale for the Time Being by Ruth Ozeki (UK edition, paperback)",0.0,8860234307837,532000,532000,0,0,0,cross-border-hang-quoc-te
273753380,"Sách - The Martian : Young Readers Edition by Andy Weir (UK edition, paperback)",7.0,1857645292886,487000,487000,0,0,0,cross-border-hang-quoc-te
263684135,"Sách - Vicious by V. E. Schwab (UK edition, paperback)",4.0,3861511289144,364000,364000,0,0,0,cross-border-hang-quoc-te
263202569,"Sách - The Egyptian Book of the Dead by John Romer (UK edition, paperback)",0.0,2347021359566,725000,725000,0,0,0,cross-border-hang-quoc-te
180221614,Sách - Surrounded by Idiots : The Four Types of Human Behavior and How to Effectively Comm by Thomas Erikson (paperback),19.0,2564347984222,351000,351000,0,0,2,cross-border-hang-quoc-te
179913297,Sách - Flushable Fashion by Jian Yang (paperback),0.0,6544569569975,634000,634000,0,0,0,cross-border-hang-quoc-te
170725433,"Sách - The 7 Habits of Highly Effective People : 30th Anniversary Edition by Stephen R. Covey (US edition, paperback)",18.0,3939327293562,603000,603000,0,0,1,cross-border-hang-quoc-te
170719097,"Sách - A Collection of Essays by George Orwell (UK edition, paperback)",0.0,2255982432187,509000,509000,0,0,0,cross-border-hang-quoc-te
170695963,"Sách - A Tale of Magic... by Chris Colfer (UK edition, paperback)",2.0,6308394676125,450000,450000,0,0,0,cross-border-hang-quoc-te
170695707,"Sách - Heartless by Marissa Meyer (UK edition, paperback)",3.0,2457448283007,386000,386000,0,0,0,cross-border-hang-quoc-te
170682418,"Sách - Beauty and the Beast: Pop-Up Book by Robert Sabuda (UK edition, hardcover)",0.0,5904594816807,1187000,1187000,0,0,0,cross-border-hang-quoc-te
170682325,"Sách - Morpho: Hands and Feet by Michel Lauricella (US edition, paperback)",6.0,5008097033849,373000,373000,0,0,2,cross-border-hang-quoc-te
170677368,"Sách - Animal Farm: The Graphic Novel by George Orwell (US edition, paperback)",4.0,6865285144890,897000,897000,0,0,0,cross-border-hang-quoc-te
170621701,"Sách - 101 Things I Learned in Urban Design School by Matthew Frederick (US edition, hardcover)",1.0,7787154754984,758000,758000,0,0,1,cross-border-hang-quoc-te
170590823,"Sách - Model Under Cover : Stolen with Style by Carina Axelsson (UK edition, paperback)",0.0,9908447622347,345000,345000,0,0,0,cross-border-hang-quoc-te
170582988,"Sách - The Montessori Method by Maria Montessori (US edition, paperback)",1.0,9126954583723,598000,598000,0,0,0,cross-border-hang-quoc-te
170565657,"Sách - The Caller : A Robert Hunter Thriller by Chris Carter (UK edition, paperback)",1.0,6352314066222,654000,654000,0,0,1,cross-border-hang-quoc-te
170561956,"Sách - Insight Guides City Guide Hong Kong by Insight Guides (UK edition, paperback)",0.0,1851402905707,421000,421000,0,0,0,cross-border-hang-quoc-te
146554071,CINCATDY Tai Nghe Bluetooth V5.0 Earbuds Gaming Headphone True Wireless Headset MD128 - Hàng Chính Hãng,0.0,1220756994258,285000,285000,0,0,0,cross-border-hang-quoc-te
113356599,"Sách - The Whole-Brain Child : 12 Revolutionary Strategies to Nuture Your Child&#x27;s Developing Mind by Daniel J Siegel - (US Edition, paperback)",69.0,6261702487706,356000,356000,0,0,7,cross-border-hang-quoc-te
112994107,Bộ Softbox Godox FL-SF3045 với Túi đựng bằng vải mềm dạng lưới tổ ong cho Godox FL60 Linh hoạt LED Light Roll-Flex Photo,0.0,2616243944301,583000,583000,0,0,0,cross-border-hang-quoc-te
108604236,"Quần đùi đi xe đạp cho nam thoáng khí, có đệm",26.0,8867972951870,236000,236000,0,0,1,cross-border-hang-quoc-te
108125689,"Chân vịt bơi lặn cho người lớn , có điều chỉnh gót chân",5.0,2912025399716,491000,491000,0,0,0,cross-border-hang-quoc-te
28731762,Value Proposition Design: How To Create Products And Services Customers Want,2.0,1026086606713,1093000,1093000,0,0,0,cross-border-hang-quoc-te
28602093,"The End Of Cheap China, Revised And Updated: Economic And Cultural Trends That Will Disrupt The World",1.0,7383740143644,273000,273000,0,0,0,cross-border-hang-quoc-te
17968462,The Philosophy Book,1.0,2812331940058,945000,945000,0,0,0,cross-border-hang-quoc-te
17964190,Dk Eyewitness Travel Guide Provence And The Côte D'Azur,0.0,5835529680441,487000,487000,0,0,0,cross-border-hang-quoc-te
17963556,Territory Of Light,3.0,1594178891656,370000,370000,0,0,1,cross-border-hang-quoc-te
11777235,Collins Classics: The Memoirs Of Sherlock Holmes,0.0,4114954965165,230000,230000,0,0,0,cross-border-hang-quoc-te
11505576,Harvard Business Review: 10 Must Reads On Communication,4.0,1929686105054,629000,629000,0,0,0,cross-border-hang-quoc-te
11466409,Unlocking German With Paul Noble,2.0,6827306603360,619000,619000,0,0,1,cross-border-hang-quoc-te
11464892,Cobuild English Grammar (Fourth Ed.),4.0,1433327340679,840000,840000,0,0,0,cross-border-hang-quoc-te
10756940,"Thinking, Fast And Slow",22.0,4301207898251,499000,499000,0,0,5,cross-border-hang-quoc-te
7917806,Great By Choice,8.0,4000648759755,642000,642000,0,0,2,cross-border-hang-quoc-te
7917797,Tools Of Titans,14.0,3943387023170,784000,784000,0,0,0,cross-border-hang-quoc-te
277346985,"Sách - Vagabond (VIZBIG Edition), Vol. 3 by Takehiko Inoue (UK edition, paperback)",2.0,9689022984536,599000,599000,0,0,1,cross-border-hang-quoc-te
276950428,"Sách - Intermezzo by Sally Rooney (US edition, paperback)",4.0,1138874845767,447000,447000,0,0,0,cross-border-hang-quoc-te
274332131,"Sách - Newcomer by Keigo Higashino (UK edition, paperback)",1.0,6826777196547,615000,615000,0,0,0,cross-border-hang-quoc-te
274301745,"Sách - Animal Farm: Annotation Edition by George Orwell (UK edition, paperback)",2.0,8797403695138,521000,521000,0,0,0,cross-border-hang-quoc-te
274245080,"Sách - Hitler's Panzer Generals - Guderian, Hoepner, Reinhardt and Schmidt Ungua by David Stahel (UK edition, hardcover)",0.0,6463186620995,1307000,1307000,0,0,0,cross-border-hang-quoc-te
273858630,"Sách - A Little Life - The Million-Copy Bestseller by Hanya Yanagihara (UK edition, hardcover)",1.0,3355223938327,480000,480000,0,0,0,cross-border-hang-quoc-te
273780353,"Sách - Death Note (All-in-One Edition) by Tsugumi Ohba Takeshi Obata (US edition, paperback)",1.0,1311335386311,2085000,2085000,0,0,1,cross-border-hang-quoc-te
273762473,"Sách - Vagabond (VIZBIG Edition), Vol. 7 by Takehiko Inoue (UK edition, paperback)",4.0,4158420002904,599000,599000,0,0,1,cross-border-hang-quoc-te
273760620,"Sách - Divine Rivals by Rebecca Ross (UK edition, hardcover)",0.0,1092654441402,792000,792000,0,0,0,cross-border-hang-quoc-te
273760448,"Sách - The Folk of the Air Boxset by Holly Black (UK edition, paperback)",3.0,8206775870223,819990,819990,0,0,2,cross-border-hang-quoc-te
273757329,"Sách - The Unmaking of June Farrow by Adrienne Young (UK edition, hardcover)",0.0,3726576290940,838000,838000,0,0,0,cross-border-hang-quoc-te
273754356,"Sách - Exercised : The Science of Physical Activity, Rest and Health by Daniel Lieberman (UK edition, paperback)",0.0,1231635326427,633000,633000,0,0,0,cross-border-hang-quoc-te
273752149,"Sách - Brave New World by Aldous Huxley (UK edition, paperback)",3.0,2308396427887,412000,412000,0,0,0,cross-border-hang-quoc-te
273735535,"Sách - Berserk Deluxe Volume 1 by Kentaro Miura (US edition, hardcover)",1.0,1816980909978,2295000,2295000,0,0,0,cross-border-hang-quoc-te
273733692,"Sách - A Curse For True Love - the thrilling final book in the Sunday Times  by Stephanie Garber (UK edition, paperback)",0.0,9826836935846,719000,719000,0,0,0,cross-border-hang-quoc-te
174246284,"Sách - Breath : The New Science of a Lost Art by James Nestor (UK edition, paperback)",2.0,1759454717345,383000,383000,0,0,0,cross-border-hang-quoc-te
170725220,"Sách - Jujutsu Kaisen, Vol. 8 by Gege Akutami (US edition, paperback)",1.0,8114839581615,330000,330000,0,0,1,cross-border-hang-quoc-te
170723815,"Sách - Be Who You Are by Todd Parr (US edition, paperback)",0.0,1697615055123,302000,302000,0,0,0,cross-border-hang-quoc-te
170693062,Sách - The Hating Game by Sally Thorne (paperback),1.0,5106804043432,581000,581000,0,0,0,cross-border-hang-quoc-te
170625642,Sách - Can't Hurt Me : Master Your Mind and Defy the Odds - Clean Edition by David Goggins (paperback),18.0,6069362340681,926000,926000,0,0,0,cross-border-hang-quoc-te
170567875,"Sách - Color and Light: A Guide for the Realist Painter (James Gurney Art) by James Gurney (US edition, paperback)",10.0,9623538803159,904000,904000,0,0,0,cross-border-hang-quoc-te
134441362,"Sách - A Little Life : Shortlisted for the Man Booker Prize 2015 by Hanya Yanagihara - (UK Edition, paperback)",66.0,9600661803969,369000,369000,0,0,8,cross-border-hang-quoc-te
111061686,Loa không dây di động Bluedio HS Bluetooth gắn trên cổ với hỗ trợ âm thanh vòm trung thực Chức năng FM Thẻ SD,6.0,8511289887274,487000,487000,0,0,2,cross-border-hang-quoc-te
108602773,"Bộ quần áo đi đạp xe đạp cho nam nữ, quần có đệm thoáng khí, áo ngắn tay chuyên dụng",3.0,8815358863044,742000,742000,0,0,0,cross-border-hang-quoc-te
108602458,Áo đua xe đạp dài tay thoáng khí dành cho Nam,7.0,7648281586650,447000,447000,0,0,1,cross-border-hang-quoc-te
17970416,Educated,35.0,4868749528799,680000,680000,0,0,2,cross-border-hang-quoc-te
17968451,Amerika,0.0,4305466881474,296000,296000,0,0,0,cross-border-hang-quoc-te
17966869,The 48 Laws Of Power by Robert Greene,171.0,4374818184211,549000,549000,0,0,25,cross-border-hang-quoc-te
17963293,America's Bank,2.0,2027385351013,630000,630000,0,0,0,cross-border-hang-quoc-te
17961618,Thus Spoke Zarathustra,17.0,6730655798215,398000,398000,0,0,2,cross-border-hang-quoc-te
17961516,Start with Why: How Great Leaders Inspire Everyone to Take Action,51.0,5935351872257,282000,282000,0,0,3,cross-border-hang-quoc-te
11849714,Gravity Falls: Journal 3,376.0,2114852125571,499000,499000,0,0,66,cross-border-hang-quoc-te
11846403,Mommy Bk,1.0,1637694518383,305000,305000,0,0,0,cross-border-hang-quoc-te
11777282,The Prince,3.0,1751011132837,236000,236000,0,0,0,cross-border-hang-quoc-te
11573139,"Kjv, Holy Bible: Leathersoft Black",51.0,8458272336884,689000,689000,0,0,11,cross-border-hang-quoc-te
11504802,Rich Dad Poor Dad,813.0,4839091014810,297000,297000,0,0,121,cross-border-hang-quoc-te
11504731,Harvard Business Review: Guide To Finance Basics For Managers,0.0,5967685130284,547000,547000,0,0,2,cross-border-hang-quoc-te
11477012,Leading : Learning from Life and My Years at Manchester United,19.0,4133827605274,670000,670000,0,0,4,cross-border-hang-quoc-te
10756802,Book Of Five Rings,4.0,9263373063367,622000,622000,0,0,2,cross-border-hang-quoc-te
10755125,Why Nations Fail (Us),28.0,2720191523185,461000,461000,0,0,0,cross-border-hang-quoc-te
277346987,"Sách - Vagabond (VIZBIG Edition), Vol. 4 by Takehiko Inoue (US edition, paperback)",0.0,6122525812558,599000,599000,0,0,0,cross-border-hang-quoc-te
273780457,"Sách - Oxford First Picture Dictionary by Oxford Dictionaries (UK edition, paperback)",0.0,4999398522434,444000,444000,0,0,0,cross-border-hang-quoc-te
273778205,"Sách - Death Note: L, Change the WorLd by &quot;M.&quot; (US edition, hardcover)",2.0,6808376656215,740000,740000,0,0,0,cross-border-hang-quoc-te
273764261,"Sách - DK Eyewitness Brazil by DK Eyewitness (UK edition, paperback)",0.0,5513998259264,838000,838000,0,0,0,cross-border-hang-quoc-te
273752424,"Sách - Jurassic Park by Michael Crichton (UK edition, paperback)",3.0,3307987944369,541000,541000,0,0,0,cross-border-hang-quoc-te
273751416,"Sách - I Have More Souls Than One by Fernando Pessoa (UK edition, paperback)",1.0,1245977928686,218000,218000,0,0,0,cross-border-hang-quoc-te
273736615,"Sách - Fourth Wing by Rebecca Yarros (UK edition, Hardback)",1.0,2133431479997,391000,391000,0,0,0,cross-border-hang-quoc-te
273736551,Sách - The Fashion Business Manual : An Illustrated Guide to Building a Fashion Brand by FASHIONARY (hardcover),0.0,7721179165978,1090000,1090000,0,0,0,cross-border-hang-quoc-te
273735887,"Sách - Harry Potter Boxed Set: The Complete Collection (Adult Paperback) by J.K. Rowling (UK edition, paperback)",0.0,1448813993638,3182000,3182000,0,0,0,cross-border-hang-quoc-te
273729953,"Sách - Powerless - TikTok made me buy it! An epic and sizzling fantasy romance by Lauren Roberts (UK edition, paperback)",2.0,9901281734427,570000,570000,0,0,0,cross-border-hang-quoc-te
268504604,"Sách - Normal People : A Novel by Sally Rooney (US edition, paperback)",7.0,3304325105262,347000,347000,0,0,1,cross-border-hang-quoc-te
207830350,"Sách - The Five Dysfunctions of a Team - A Leadership Fable, 20th Anniversar by Patrick Lencioni (US edition, hardcover)",6.0,1490553253224,691000,691000,0,0,1,cross-border-hang-quoc-te
198077968,"Sách - If We Were Villains - 5th anniversary signed and illustrated edition by M.L. Rio (UK edition, hardcover)",8.0,8868563078380,665000,665000,0,0,1,cross-border-hang-quoc-te
180324905,"Sách - The Prison Healer by Lynette Noni (UK edition, paperback)",0.0,5124144623876,446000,446000,0,0,0,cross-border-hang-quoc-te
176304381,"Sách - Tuesdays with Morrie: an Old Man, a Young Man, and Life's Greatest Lesson by Mitch Albom (US edition, paperback)",54.0,4421496584487,247650,247650,0,0,10,cross-border-hang-quoc-te
170725853,"Sách - The 4 Disciplines of Execution: Revised and Updated : Achieving Your Wildly by Sean Covey (UK edition, paperback)",4.0,8545389761031,584000,584000,0,0,1,cross-border-hang-quoc-te
170725260,"Sách - Antifragile: Things That Gain from Disor.der (Incerto) by Nassim Nicholas Taleb (US edition, paperback)",3.0,5531562760890,643000,643000,0,0,0,cross-border-hang-quoc-te
170704473,"Sách - Beyond Good and Evil by Friedrich Nietzsche (US edition, paperback)",16.0,9949561213761,371000,371000,0,0,1,cross-border-hang-quoc-te
170605519,"Sách - More Music Theory Sample Papers, ABRSM Grade 5 by ABRSM (UK edition, paperback)",0.0,2279166814169,288000,288000,0,0,0,cross-border-hang-quoc-te
164063788,"Sách - Circe : The International No. 1 Bestseller - Shortlisted for the Women by Madeline Miller (UK edition, paperback)",9.0,1256254325925,318000,318000,0,0,1,cross-border-hang-quoc-te
146553907,CINCATDY Tai Nghe Bluetooth True Wireless TWS A6S pro Phiên Bản Nâng Cấp - Hàng Chính Hãng,24.0,2610741224650,162000,162000,0,0,1,cross-border-hang-quoc-te
127646919,Đồng hồ thông minh Mibro Air phiên bản toàn cầu Đồng hồ theo dõi thể dục XPAW001,1.0,2765931570577,992000,992000,0,0,0,cross-border-hang-quoc-te
113408354,"Sách - Omoiyari : The Japanese Art of Compassion by Erin Niimi Longhurst - (UK Edition, hardcover)",2.0,1235689674199,464000,464000,0,0,0,cross-border-hang-quoc-te
111065910,OSCOO USB 3.0 Type-C 64G Flash Drive tốc độ cao Thay thế đĩa U cho máy tính điện thoại thông minh Type-C MacBook mới,0.0,7157948747342,190000,190000,0,0,0,cross-border-hang-quoc-te
109435974,"Tai nghe chơi game ONIKUMA K5 PRO có micrô PC Gamer,âm thanh nổi 3,5 mm chống ồn  - Màu đỏ",1.0,5363745842834,477000,477000,0,0,1,cross-border-hang-quoc-te
109435109,FX-AUDIO TUBE-06 Tube Preamplifier Home Audio Tube 6N3 Pre Amplifier Input PC-USB AUX Bass&Treble Adjustment DC12V/1A,0.0,3989295827665,2355600,2355600,0,0,0,cross-border-hang-quoc-te
109434853,Tai nghe Bluetooth không dây NEW BEE,0.0,4602202692384,392000,392000,0,0,0,cross-border-hang-quoc-te
57515986,A Little Life: A Novel,4.0,2792169784218,319000,319000,0,0,1,cross-border-hang-quoc-te
18011175,Elmer And The Tune,0.0,1467801074637,238000,238000,0,0,0,cross-border-hang-quoc-te
17970317,The Design Of Everyday Things,105.0,4411064663142,598000,598000,0,0,9,cross-border-hang-quoc-te
17970192,Meditations,111.0,5232373777936,373000,373000,0,0,16,cross-border-hang-quoc-te
17968379,Death Of A Salesman,5.0,6022914107884,324000,324000,0,0,1,cross-border-hang-quoc-te
17966554,Think And Grow Rich (Revised),22.0,9669781895826,370000,370000,0,0,0,cross-border-hang-quoc-te
17963668,"Lust, Caution",0.0,5472486229872,270000,270000,0,0,0,cross-border-hang-quoc-te
11667781,Tax-Free Wealth,7.0,2380011628188,334000,334000,0,0,1,cross-border-hang-quoc-te
11464729,Collins Cobuild Key Words For Automotive Engineering,0.0,4685858652388,416000,416000,0,0,0,cross-border-hang-quoc-te
10761195,Can Asians Think? Commemorative Edition,2.0,3763815421251,633000,633000,0,0,0,cross-border-hang-quoc-te
10756962,Lucifer Effect (Uk),19.0,8049014568337,578000,578000,0,0,2,cross-border-hang-quoc-te
10732570,Zero To One,15.0,4229133745428,307349,307349,0,0,1,cross-border-hang-quoc-te
7917793,Leonardo Da Vinci,13.0,7387982937375,520000,520000,0,0,1,cross-border-hang-quoc-te
277874338,Phới trộn bột Elmich EL0278 - Hàng chính hãng,0.0,2949573593504,169000,169000,0,0,0,cross-border-hang-quoc-te
274338282,"Sách - The Cruel Prince by  (UK edition, paperback)",0.0,3419859082917,1250000,1250000,0,0,0,cross-border-hang-quoc-te
273774815,"Sách - The Remains of the Day by Kazuo Ishiguro (UK edition, paperback)",0.0,7877004278838,380000,380000,0,0,0,cross-border-hang-quoc-te
273758603,"Sách - Goodnight Punpun, Vol. 3 by Inio Asano (US edition, paperback)",0.0,9688606891795,951000,951000,0,0,0,cross-border-hang-quoc-te
273753098,"Sách - Vagabond (VIZBIG Edition), Vol. 12 by Takehiko Inoue (US edition, paperback)",2.0,5309703508234,599000,599000,0,0,0,cross-border-hang-quoc-te
273752881,"Sách - Miss Peregrine's Home for Peculiar Children by Ransom Riggs (US edition, paperback)",0.0,1339206448466,543000,543000,0,0,0,cross-border-hang-quoc-te
273751997,"Sách - Twilight : Twilight, Book 1 by Stephenie Meyer (UK edition, paperback)",0.0,2619758613266,537000,537000,0,0,0,cross-border-hang-quoc-te
273751981,"Sách - Games People Play : The Psychology of Human Relationships by Eric Berne (UK edition, paperback)",1.0,1938791100190,488000,488000,0,0,0,cross-border-hang-quoc-te
273749052,"Sách - The Karamazov Brot by Fyodor Dostoevsky,Constance Garnett,Dr Keith Carabine,A.D.P. Briggs (UK edition, paperback)",1.0,8476602192543,451000,451000,0,0,0,cross-border-hang-quoc-te
271246115,"Sách - Getting Things Done: The Art of Stress-Free Productivity by David Allen (UK edition, paperback)",1.0,2663980382501,339000,339000,0,0,0,cross-border-hang-quoc-te
252517731,"Sách - King of Wrath : from the bestselling author of the Twisted series by Ana Huang (UK edition, paperback)",6.0,4295558865339,299000,299000,0,0,2,cross-border-hang-quoc-te
247314711,"Sách - Tiny Beautiful Things (10th Anniversary Edition) : Advice from Dear Sug by Cheryl Strayed (US edition, paperback)",4.0,1175510721887,456000,456000,0,0,0,cross-border-hang-quoc-te
206749270,"Sách - The The Psychology of Money - hardback edition : Timeless lessons on wea by Morgan Housel (UK edition, hardcover)",1.0,9238745156870,886000,886000,0,0,0,cross-border-hang-quoc-te
190737872,"Sách - Piano Exam Pieces 2023 & 2024, ABRSM Grade 8 : Selected from the 2023 & 2024 syl by ABRSM (UK edition, paperback)",10.0,1625236977287,693000,693000,0,0,0,cross-border-hang-quoc-te
170725075,"Sách - It's Not How Good You Are, It's How Good You Want to Be : The world's best- by Paul Arden (UK edition, paperback)",9.0,3176766067045,386000,386000,0,0,0,cross-border-hang-quoc-te
170724865,"Sách - Carrie by Stephen King (US edition, paperback)",3.0,3230272249681,218000,218000,0,0,1,cross-border-hang-quoc-te
170706421,"Sách - Diplomacy by Kissinger (US edition, paperback)",0.0,6643870758508,1010000,1010000,0,0,0,cross-border-hang-quoc-te
170675325,"Sách - The Wretched of the Earth by Frantz Fanon (UK edition, paperback)",0.0,4378316756121,375000,375000,0,0,0,cross-border-hang-quoc-te
170675187,"Sách - The Witcher Boxed Set : The Last Wish, Sword of Destiny, Blood of El by Andrzej Sapkowski (UK edition, paperback)",1.0,6623618625480,3728000,3728000,0,0,0,cross-border-hang-quoc-te
170631013,"Sách - The Concise Laws of Human Nature by Robert Greene (UK edition, paperback)",15.0,3194938553757,377000,377000,0,0,1,cross-border-hang-quoc-te
170610823,"Sách - Tom Gates That's Me! (Books One, Two, Three) by L Pichon (US edition, paperback)",0.0,1764335159604,928000,928000,0,0,0,cross-border-hang-quoc-te
170605707,"Sách - Piano Scales & Arpeggios, Grade 8 by ABRSM (UK edition, paperback)",1.0,6979274672534,512000,512000,0,0,0,cross-border-hang-quoc-te
170578667,"Sách - Buyology : Truth and Lies about Why We Buy by Martin Lindstrom (US edition, paperback)",2.0,5203879962101,486000,486000,0,0,0,cross-border-hang-quoc-te
170277774,"Sách - Star vs. the Forces of Evil: The Magic Book of Spells by Daron Nefcy (US edition, hardcover)",5.0,5768720444118,857000,857000,0,0,1,cross-border-hang-quoc-te
164244449,"Sách - SCP Foundation: Iris Through the Looking-Glass (Light Novel) Vol. 1 by Akira (US edition, paperback)",2.0,4189830819957,419000,419000,0,0,0,cross-border-hang-quoc-te
127805313,"Sách - Red, White &amp; Royal Blue : A Novel by Casey Mcquiston - (US Edition, paperback)",8.0,7768462625927,522000,522000,0,0,2,cross-border-hang-quoc-te
113209079,"Sách - Mindset: The New Psychology of Success by Carol Dweck - (US Edition, paperback)",38.0,1448440572754,479000,479000,0,0,5,cross-border-hang-quoc-te
111415575,Hộp câu cá hai mặt giúp giữ các phụ kiện câu cá ngăn nắp,0.0,4809124514218,169000,169000,0,0,0,cross-border-hang-quoc-te
109436605,Loa máy tính có dây USB SADA V-193 siêu trầm âm thanh vòm 3.5mm,1.0,1679082006945,305000,305000,0,0,0,cross-border-hang-quoc-te
109436301,Loa Bluetooth không dây Rolton E500 6W Máy nghe nhạc âm thanh nổi HiFi Đài FM kỹ thuật số di động với màn hình LED đèn pin,3.0,7262627643460,393000,393000,0,0,1,cross-border-hang-quoc-te
109434854,Bộ sạc pin LiitoKala lii-600 Li-ion-3.7V Ni-MH1.2V 4 khe cắm,4.0,9706763086516,914000,914000,0,0,0,cross-border-hang-quoc-te
108604092,"Túi đựng đồ treo khung trước xe đạp vỏ cứng, chất liệu bền, chống thấm nước",3.0,7586216365540,275000,275000,0,0,1,cross-border-hang-quoc-te
108227034,"Đồng hồ thông minh SENBONO Youth2 Màn hình TFT 1,28 inch BT4.1 IP67 chống thấm nước Nhiệt độ cơ thể / Giấc ngủ / Nhịp tim",2.0,3743329557069,738000,738000,0,0,2,cross-border-hang-quoc-te
28601749,Invest By The With Fed,1.0,2580839021226,669000,669000,0,0,0,cross-border-hang-quoc-te
28601533,"International Financial Statement Analysis, Third Edition (Cfa Institute Investment Series)",1.0,6217365691833,744000,744000,0,0,0,cross-border-hang-quoc-te
17970323,Together Is Better,2.0,5260921697467,511000,511000,0,0,0,cross-border-hang-quoc-te
17968600,Siddhartha,4.0,1638961433040,347000,347000,0,0,0,cross-border-hang-quoc-te
17966855,Life Of A Stupid Man,12.0,1129317341022,173000,173000,0,0,1,cross-border-hang-quoc-te
17963514,A Room Of One'S Own/Three Guineas,1.0,3182522645628,400000,400000,0,0,0,cross-border-hang-quoc-te
11504844,Harvard Business Review: 20 Minute Manager: Delegating Work,1.0,4079135073728,389000,389000,0,0,0,cross-border-hang-quoc-te
273855444,"Sách - Never Finished - Unshackle Your Mind and Win the War Within - Clean Edit by David Goggins (UK edition, paperback)",5.0,9152929186689,1188000,1188000,0,0,1,cross-border-hang-quoc-te
273776437,"Sách - Harry Potter: Official Christmas Cookbook by Jody Revenson (UK edition, hardcover)",0.0,7246500555589,1016000,1016000,0,0,0,cross-border-hang-quoc-te
273766456,"Sách - The Only One Left : the next gripping novel from the master of the genre-b by Riley Sager (UK edition, hardcover)",0.0,7912090976695,908000,908000,0,0,0,cross-border-hang-quoc-te
273755631,"Sách - Collins COBUILD Advanced American English Dictionary by  (UK edition, hardcover)",1.0,2252591027332,1082000,1082000,0,0,0,cross-border-hang-quoc-te
273752196,"Sách - Jade City : THE WORLD FANTASY AWARD WINNER by Fonda Lee (UK edition, paperback)",1.0,6102445197219,561000,561000,0,0,0,cross-border-hang-quoc-te
273735117,"Sách - 20th Century Boys: The Perfect Edition, Vol. 1 by Naoki Urasawa (UK edition, paperback)",1.0,9628948232114,821000,821000,0,0,0,cross-border-hang-quoc-te
273734784,"Sách - Golden Son : Red Rising Series 2 by Pierce Brown (UK edition, paperback)",1.0,7207699801055,539000,539000,0,0,0,cross-border-hang-quoc-te
273729885,"Sách - Your Fault by Mercedes Ron (UK edition, paperback)",2.0,7612354128276,530000,530000,0,0,0,cross-border-hang-quoc-te
270660081,"Sách - Disney: Moana (Tiny book) by Insight Editions (US edition, hardcover)",1.0,8013375688521,239000,239000,0,0,0,cross-border-hang-quoc-te
212964337,"Sách - Chip War - The Fight for the World's Most Critical Technology by Chris Miller (UK edition, paperback)",31.0,9022336122205,549000,549000,0,0,1,cross-border-hang-quoc-te
191356451,"Viên Uống Bổ Sung Dầu Cá DHA, EPA, Efamol Efalex Tăng Cường Trí Nhớ, Hỗ Trợ Trí Não, Tim Mạch, Thị Lực (240 Viên Nang) ",1.0,2348258221616,1954000,1954000,0,0,0,cross-border-hang-quoc-te
186433594,"Sách - It Starts with Us : A Novelvolume 2 by Colleen Hoover (US edition, paperback)",12.0,5704056028812,316000,316000,0,0,1,cross-border-hang-quoc-te
173372266,"Sách - Fear : Essential Wisdom for Getting Through The Storm by Thich Nhat Hanh (UK edition, paperback)",2.0,4277362651482,496000,496000,0,0,0,cross-border-hang-quoc-te
172631313,"Sách - Before the Coffee Gets Cold by Toshikazu Kawaguchi (UK edition, paperback)",18.0,6502593332191,350000,350000,0,0,2,cross-border-hang-quoc-te
171551092,"Sách - The Last Hours: Chain of Iron by Cassandra Clare (UK edition, paperback)",0.0,8318889168668,429000,429000,0,0,0,cross-border-hang-quoc-te
170693294,"Sách - Waltzes for the Piano by Frederic Chopin (US edition, paperback)",3.0,6284632391161,391000,391000,0,0,0,cross-border-hang-quoc-te
170671941,"Sách - The Boy Who Was Raised as a Dog, 3rd Edition : And Other Stories from a by Bruce D. Perry (US edition, paperback)",1.0,3553743303542,554000,554000,0,0,0,cross-border-hang-quoc-te
170610748,"Sách - Eat That Frog! 21 Great Ways to Stop Procrastinating and Get More Done in Less T by Tracy (US edition, paperback)",8.0,7894439966563,458000,458000,0,0,0,cross-border-hang-quoc-te
170605765,"Sách - Nomadology : The War Machine by Gilles Deleuze (US edition, paperback)",0.0,2163109006159,550000,550000,0,0,0,cross-border-hang-quoc-te
170600360,"Sách - My Dark Vanessa by Kate Elizabeth Russell (UK edition, paperback)",3.0,1968460035327,573000,573000,0,0,0,cross-border-hang-quoc-te
170585451,"Sách - The Last Apprentice: Fury of the Seventh Son (Book 13) by Joseph Delaney (US edition, paperback)",0.0,4133673232130,587000,587000,0,0,0,cross-border-hang-quoc-te
170581539,"Sách - Behave : The Biology of Humans at Our Best and Worst by Robert M. Sapolsky (US edition, paperback)",3.0,2093980529126,775000,775000,0,0,0,cross-border-hang-quoc-te
146553780,CINCATDY Tai Nghe Bluetooth V5.0 Earbuds Gaming Headphone True Wireless Headset - Hàng Chính Hãng,0.0,7402654799916,217000,217000,0,0,0,cross-border-hang-quoc-te
112996823, Đèn Godox LITEMONS LED6R RGB LED có thể thay đổi 13 hiệu ứng ánh sáng,2.0,6212509885723,599000,599000,0,0,1,cross-border-hang-quoc-te
111388826,"Chai nước thể thao chạy bộ , cắm trại, đi bộ đường dài TPU có thể gấp gọn",0.0,6312239914941,152000,152000,0,0,0,cross-border-hang-quoc-te
109436747,Tai nghe Bluetooth không dây Fineblue với micrô Đen,0.0,3160243020489,346000,346000,0,0,0,cross-border-hang-quoc-te
109436358,Tai nghe Bluetooth không dây Fineblue F2 Pro 5.0 cảnh báo rung với mic cho điện thoại thông minh ,1.0,4787481439669,522000,522000,0,0,0,cross-border-hang-quoc-te
109435865,FX-AUDIO TUBE-03MKII BT Tube Preamplifier Headphone Pre Amplifier BT Receiver HiFi BT 5.0 Tube AUX Bass Treble,0.0,6236771761035,1634400,1634400,0,0,0,cross-border-hang-quoc-te
109435817,"Loa gia đình 3 trong 1 3,5 mm Máy tính có dây cho Máy tính để bàn xách tay SADA D-200T",0.0,2061252819710,443000,443000,0,0,0,cross-border-hang-quoc-te
109435554,"Tai nghe Fineblue F970 Pro Kẹp trên tai,không dây Bluetooth 5.0",10.0,7853957847062,422000,422000,0,0,2,cross-border-hang-quoc-te
108599345,Áo khoác không tay đi xe đạp Jersey chống gió thoáng khí dành cho Nam Nữ,1.0,6373515351654,412000,412000,0,0,1,cross-border-hang-quoc-te
28602125,Unlearn: Let Go Of Past Success To Achieve Extraordinary Results,3.0,6822779186143,839000,839000,0,0,0,cross-border-hang-quoc-te
17966244,It Always Seems Impossible Until It's Done.,2.0,4900673986822,522000,522000,0,0,0,cross-border-hang-quoc-te
17965889,Why I Am So Clever,30.0,9712758148125,158000,158000,0,0,3,cross-border-hang-quoc-te
17965697,The Templars,2.0,9019646066869,321000,321000,0,0,1,cross-border-hang-quoc-te
17963449,Wine Folly - Bìa Mềm - Bản US,21.0,7829880315157,870000,870000,0,0,2,cross-border-hang-quoc-te
17961586,Myth Of Sisyphus,12.0,6468442638207,359000,359000,0,0,1,cross-border-hang-quoc-te
11845752,Lonely Planet Bhutan (Travel Guide),2.0,6682252056345,706000,706000,0,0,0,cross-border-hang-quoc-te
11778131,Pachinko,8.0,3741059613687,612000,612000,0,0,1,cross-border-hang-quoc-te
10755123,Factfulness (Uk),9.0,2455235744270,467000,467000,0,0,0,cross-border-hang-quoc-te
273777779,"Sách - Little Women by Louisa May Alcott (UK edition, paperback)",0.0,9966087265143,210000,210000,0,0,0,cross-border-hang-quoc-te
273777617,"Sách - Frankenstein: Junji Ito Story Collection by Junji Ito (US edition, hardcover)",0.0,8344241001671,965000,965000,0,0,0,cross-border-hang-quoc-te
273772265,"Sách - Finale : Caraval Series Book 3 by Stephanie Garber (UK edition, paperback)",1.0,6341718317560,545000,545000,0,0,0,cross-border-hang-quoc-te
273762265,"Sách - The Second Sex (Vintage Feminism Short Edition) by Simone de Beauvoir (UK edition, paperback)",4.0,8623755773084,351000,351000,0,0,0,cross-border-hang-quoc-te
273758931,"Sách - Stoner : A Novel by John Williams (UK edition, paperback)",0.0,4944401721468,498000,498000,0,0,0,cross-border-hang-quoc-te
273758481,"Sách - Queen Charlotte: Before the Bridgertons came the love story that changed by Shonda Rhimes (UK edition, paperback)",1.0,8716878206377,792000,792000,0,0,0,cross-border-hang-quoc-te
273751820,"Sách - The Hobbit by J. R. R. Tolkien (UK edition, paperback)",1.0,8936234441383,467000,467000,0,0,0,cross-border-hang-quoc-te
273751548,"Sách - Harry Potter: Collectible Quidditch Set by Running Press (US edition, paperback)",0.0,8646743034067,1206000,1206000,0,0,0,cross-border-hang-quoc-te
273751320,"Sách - The Diary of a Young Girl by Anne Frank (UK edition, paperback)",0.0,6741903657990,483000,483000,0,0,0,cross-border-hang-quoc-te
273732518,"Sách - Rich Dad Poor Dad - What the Rich Teach Their Kids About Money Th by Robert T. Kiyosaki (US edition, Mass Market)",9.0,5384615460713,229000,229000,0,0,1,cross-border-hang-quoc-te
271410503,"Sách - Secret Wars by Jonathan Hickman (UK edition, paperback)",0.0,2134468721020,1151000,1151000,0,0,0,cross-border-hang-quoc-te
271170045,"Sách - Critique of Pure Reason by Immanuel Kant (UK edition, paperback)",6.0,1321324870129,683000,683000,0,0,1,cross-border-hang-quoc-te
214093204,"Sách - Twisted Hate by Ana Huang (UK edition, paperback)",18.0,8963758922865,350000,350000,0,0,1,cross-border-hang-quoc-te
208285592,"Sách - Twisted Love by Ana Huang (UK edition, paperback)",31.0,5301177313472,349000,349000,0,0,7,cross-border-hang-quoc-te
186434158,Sách - Science of Yoga : Understand the Anatomy and Physiology to Perfect Your Practice by Ann Swanson (paperback),2.0,5010453415959,871000,871000,0,0,0,cross-border-hang-quoc-te
182581316,Đồng Hồ Kỹ Thuật Số North Edge Bấm Giờ Đèn Nền Led Chống Nước 50M,1.0,3232171846125,707000,707000,0,0,1,cross-border-hang-quoc-te
172631250,"Sách - The Hitchhiker's Guide to the Galaxy Illustrated Edition by Douglas Adams (UK edition, paperback)",8.0,8826413468769,507000,507000,0,0,0,cross-border-hang-quoc-te
170711089,"Sách - The Girl, the Penguin, the Home-Schooling and the Gin : A hilarious parody o by Guy Adams (UK edition, hardcover)",2.0,1445935642140,361000,361000,0,0,1,cross-border-hang-quoc-te
170708215,"Sách - Franklin Endicott and the Third Key : Tales from Deckaw by Kate DiCamillo Chris Van Dusen (US edition, hardcover)",0.0,7168032036819,489000,489000,0,0,0,cross-border-hang-quoc-te
170693263,"Sách - The Only Astrology Book You'll Ever Need by Joanna Martine Woolfolk (US edition, paperback)",2.0,6350150241283,915000,915000,0,0,1,cross-border-hang-quoc-te
170678864,"Sách - What Is Existentialism? by Simone de Beauvoir (UK edition, paperback)",2.0,3956155130321,261000,261000,0,0,0,cross-border-hang-quoc-te
170654667,"Sách - Adult Piano Adventures : Classics Book 2 by Nancy Faber Randall Faber (US edition, paperback)",0.0,2298486000282,366000,366000,0,0,0,cross-border-hang-quoc-te
170632735,"Sách - A Darkest Minds Novel: The Darkest Minds : Book 1 by Alexandra Bracken (UK edition, paperback)",1.0,2397625276747,398000,398000,0,0,0,cross-border-hang-quoc-te
170631053,"Sách - Strategize : Product Strategy and Product Roadmap Practices for the Digi by Roman Pichler (US edition, paperback)",2.0,3787468362311,767000,767000,0,0,0,cross-border-hang-quoc-te
170604379,"Sách - Harry Potter and the Prisoner of Azkaban Enchanted Postcard Book by Insight Editions (US edition, paperback)",0.0,7215658078050,516000,516000,0,0,0,cross-border-hang-quoc-te
170585806,Sách - How to Be a Genius : Your Brain and How to Train It by DK (paperback),1.0,8657403093910,812000,812000,0,0,0,cross-border-hang-quoc-te
163925049,"Sách - The Seven Principles for Making Marriage Work : A Practical Guide from th by John Gottman (US edition, paperback)",3.0,5566133160595,483000,483000,0,0,1,cross-border-hang-quoc-te
162150706,"Sách - Harry Potter and the Goblet of Fire - Hufflepuff Edition by J.K. Rowling (UK edition, hardcover)",0.0,3536904760687,872000,872000,0,0,0,cross-border-hang-quoc-te
113209142,"Sách - Tax-Free Wealth : How to Build Massive Wealth by Permanently Lowering Your Taxes by Tom Wheelwright - (US Edition, paperback)",6.0,4269494536168,691000,691000,0,0,0,cross-border-hang-quoc-te
111066447,"Bìa đựng hồ sơ, giấy tờ kinh doanh BUBM Dung lượng lớn Muiti-lớp bảo vệ chống mài mòn - không thấm nước - Bền màu - Grey - L",0.0,5397601488034,314000,314000,0,0,0,cross-border-hang-quoc-te
111062659,Chuột quang có dây Delux M618 Plus Blue Light 600/1000/1600 DPI 3 cấp độ với 6 nút cho PC Laptop,2.0,5424055087560,645000,645000,0,0,0,cross-border-hang-quoc-te
109435589, Loa Bluetooth không dây di động 10W âm thanh nổi ngoài trời U Disk TF Đầu đọc thẻ T&G 116 ,0.0,2821624980943,380000,380000,0,0,0,cross-border-hang-quoc-te
109270811,1.3 Inch Screen BT 4.0 Smart Watch Smart Fitness Tracker Activity Tracker Watch Smart Fitness IP67 Waterproof Watch,0.0,9312211166515,994000,994000,0,0,0,cross-border-hang-quoc-te
28601987,"Stock Investing For Dummies, 5Th Edition",2.0,8586067846536,377000,377000,0,0,0,cross-border-hang-quoc-te
17963391,Orlando,0.0,5382264674728,570000,570000,0,0,0,cross-border-hang-quoc-te
11778910,The Isle Of The Lost: A Descendants Novel,4.0,6625943197576,393000,393000,0,0,1,cross-border-hang-quoc-te
11778485,Warriors Of Ultramar,2.0,8503170157762,323000,323000,0,0,2,cross-border-hang-quoc-te
11504829,Why The Rich Are Getting Richer,22.0,1500200191779,326000,326000,0,0,5,cross-border-hang-quoc-te
11466175,My Very First Animals Book,0.0,2199015199248,953000,953000,0,0,0,cross-border-hang-quoc-te
11446422,Influence: The Psychology Of Persuasion,30.0,2598315542028,848000,848000,0,0,4,cross-border-hang-quoc-te
273857433,"Sách - Heal Your Body : The Mental Causes for Physical Illness and the Metaphysica by Louise Hay (US edition, paperback)",3.0,1816476044643,483000,483000,0,0,1,cross-border-hang-quoc-te
273782457,"Sách - Vogue Covers: On Fashion's Front Page by Robin Muir (UK edition, paperback)",0.0,5359117956581,983000,983000,0,0,0,cross-border-hang-quoc-te
273776668,"Sách - Harry Potter and the Chamber of Secrets : Deluxe Illustrated Slipcase Edi by J.K. Rowling (UK edition, hardcover)",0.0,9323054749573,6120000,6120000,0,0,0,cross-border-hang-quoc-te
273776227,"Sách - Atlas of Human Anatomy for the Artist by Stephen Rogers Peck (US edition, paperback)",3.0,1344446601689,824000,824000,0,0,0,cross-border-hang-quoc-te
273761843,"Sách - How to Talk so Teens will Listen & Listen so Teens will by Adele & Elaine Faber & Mazlish (UK edition, paperback)",1.0,7501079078418,566000,566000,0,0,0,cross-border-hang-quoc-te
273755235,"Sách - Dark Days by James Baldwin (UK edition, paperback)",1.0,1413479236674,218000,218000,0,0,0,cross-border-hang-quoc-te
273754540,"Sách - Principles of Anatomy and Physiology, 16e International Adaptation by Bryan H. Derrickson (US edition, paperback)",0.0,1270998309688,2605000,2605000,0,0,0,cross-border-hang-quoc-te
273753542,"Sách - Tuesdays With Morrie : An old man, a young man, and life's greatest lesson by Mitch Albom (UK edition, paperback)",3.0,9156169415533,244000,244000,0,0,0,cross-border-hang-quoc-te
273735770,"Sách - Letters to Milena - Discover Franz Kafka's love letters - the surprise Tik by Franz Kafka (UK edition, paperback)",1.0,7720885736770,486000,486000,0,0,0,cross-border-hang-quoc-te
262465402,Sách - Embedded Systems with Arm Cortex-M Microcontrollers in Assembly Language and C by Yifeng Zhu (paperback),0.0,6321605201360,2329000,2329000,0,0,0,cross-border-hang-quoc-te
202597516,"Sách - Everything I Know About Love by Dolly Alderton (UK edition, paperback)",18.0,1877781511669,339000,339000,0,0,0,cross-border-hang-quoc-te
200680406,"Sách - Don't Believe Everything You Think : Why Your Thinking Is The Beginning  by Joseph Nguyen (US edition, paperback)",6.0,9629714635144,788000,788000,0,0,1,cross-border-hang-quoc-te
179912978,"Sách - Drawing for Beginners : 100+ Ideas and Prompts to Release Your Inner Arti by Jamie Markle (US edition, paperback)",0.0,2513341440969,439000,439000,0,0,0,cross-border-hang-quoc-te
174224284,"Sách - Why Has Nobody Told Me This Before? : The No 1 Sunday Times bestseller by Dr Julie Smith (UK edition, paperback)",13.0,1327556626577,691000,691000,0,0,0,cross-border-hang-quoc-te
170726391,"Sách - How I Built This : The Unexpected Paths to Success from the World' by Guy Raz Nils Parker (US edition, paperback)",1.0,6695252901001,808000,808000,0,0,0,cross-border-hang-quoc-te
170726365,"Sách - Pax, Journey Home by Sara Pennypacker (paperback)",0.0,7426370094901,370000,370000,0,0,0,cross-border-hang-quoc-te
170715800,"Sách - Meditation Is Not What You Think : Mindfulness and Why It Is So Importa by Jon Kabat-Zinn (US edition, paperback)",1.0,5896173694305,630000,630000,0,0,0,cross-border-hang-quoc-te
170708811,"Sách - The Bell Jar by Sylvia Plath (UK edition, paperback)",12.0,1888736000189,350000,350000,0,0,1,cross-border-hang-quoc-te
170707233,"Sách - The Rough Guide to Shanghai (Travel Guide) by Rough Guides (UK edition, paperback)",0.0,9058078881467,454000,454000,0,0,0,cross-border-hang-quoc-te
170693388,"Sách - The Heart Sutra by Red Pine (US edition, paperback)",3.0,4081299383830,472000,472000,0,0,0,cross-border-hang-quoc-te
170682447,"Sách - On Bullshit by Harry G. Frankfurt (US edition, hardcover)",2.0,8772670498886,346000,346000,0,0,0,cross-border-hang-quoc-te
170661830,"Sách - Delavier's Core Training Anatomy by Frederic Delavier (US edition, paperback)",1.0,6581203613543,824000,824000,0,0,0,cross-border-hang-quoc-te
170654143,"Sách - Descendants: Mal's Spell Book by Disney Book Group (US edition, hardcover)",2.0,2700367586911,553000,553000,0,0,1,cross-border-hang-quoc-te
170631121,Sách - Warren Buffett Accounting Book : Reading Financial Statements for Value Investing by Preston Pysh (paperback),2.0,9547167123924,661000,661000,0,0,0,cross-border-hang-quoc-te
170583317,"Sách - Batman 75th Anniversary Box Set by Frank Miller Greg Capullo (US edition, hardcover)",1.0,7422650177902,679000,679000,0,0,1,cross-border-hang-quoc-te
170581831,"Sách - Messages From Your Animal Spirit Guides Cards by Steven Farmer (US edition, paperback)",1.0,5367802438186,574000,574000,0,0,0,cross-border-hang-quoc-te
146518665,CINCATDY Tai Nghe Bluetooth V5.0 Earbuds Gaming Headphone True Wireless Headset ME-19T,2.0,2342635903717,391000,391000,0,0,0,cross-border-hang-quoc-te
109436681,Tai nghe Bluetooth không dây Bluetooth 4.0 Đeo Kẹp Rảnh tay Fineblue F-V6,1.0,2729176839945,328000,328000,0,0,0,cross-border-hang-quoc-te
109434987,Bộ sạc pin LiitoKala lii-S8 Li-ion 3.7V NiMH 1.2V Li-FePO4 3.2V IMR 3.8V sạc cho 18650 26650 21700 26700 AA AAA,3.0,6685834443048,840000,840000,0,0,3,cross-border-hang-quoc-te
108603789,"Mũ bảo hiểm thể thao có vành, Chất liệu ABS chống va đập với lớp PU bên ngoài chống thấm nước.",0.0,8030157362040,367000,367000,0,0,0,cross-border-hang-quoc-te
108600790,Giá đỡ chai nước giữa lồng xe,0.0,3326151507973,157000,157000,0,0,0,cross-border-hang-quoc-te
108599272,"Khóa cáp xe đạp chống trộm an toàn , đa chức năng",3.0,3017460802217,219000,219000,0,0,0,cross-border-hang-quoc-te
28602581,The Definitive Drucker,1.0,4138141979896,695000,695000,0,0,1,cross-border-hang-quoc-te
28602383,5 Steps To A 5 Ap Physics 1: Algebra-Based 2018 Edition,0.0,9851597266109,377000,377000,0,0,0,cross-border-hang-quoc-te
17968730,Just An Ordinary Day,1.0,6352443485765,261000,261000,0,0,0,cross-border-hang-quoc-te
17966640,How Much Land Does A Man Need?,7.0,7025136504492,157000,157000,0,0,0,cross-border-hang-quoc-te
17966536,Undoing Project,1.0,9764814910771,407000,407000,0,0,0,cross-border-hang-quoc-te
11842316,Gravity Falls Dipper's And Mabel's Guide To Mystery And Nonstop Fun! (Guide to Life) ,23.0,7318831948884,482000,482000,0,0,6,cross-border-hang-quoc-te
11544603,"Search Inside Yourself: Increase Productivity, Creativity And Happiness",62.0,2304410499781,516000,516000,0,0,5,cross-border-hang-quoc-te
11505404,The Screwtape Letters,1.0,9433092383217,459000,459000,0,0,0,cross-border-hang-quoc-te
145224778,Máy in phun màu Canon Ts207- hàng chính hãng,205.0,3202955950050,1070000,1150000,80000,7,42,laptop-may-vi-tinh-linh-kien
276191357,Hộp mực dành cho Máy in Brother DCP 2520dw 2540dw -HL-L2321D HL-2361DN HL-2366DW MFC-L2701D MFC-L2701DW - TN 2325/2385 Mới 100%-CÓ LỔ ĐỔ MỰC Hàng chính hãng Alpha Cartridge ,84.0,4733190179421,105000,105000,0,0,1,laptop-may-vi-tinh-linh-kien
187770519,Máy Tính Siêu Nhỏ Ultra Mini Morefine ZX01 Plus - Intel thế hệ 12 Alder Lake N100 - Hỗ Trợ Xuất Hình 4K 60hz,34.0,1046566289097,4030000,4030000,0,0,9,laptop-may-vi-tinh-linh-kien
276632232,Dây cáp mạng LAN đúc sẵn 2 đầu Cat6 UTP Unitek - Hàng chính hãng,77.0,3100045895465,60000,60000,0,0,7,laptop-may-vi-tinh-linh-kien
99998451,Màn hình máy tính LG UHD 4K 27'' IPS VESA DisplayHDR 400 27UP600K-W - Hàng chính hãng,433.0,2228735644002,5490000,8090000,2600000,32,51,laptop-may-vi-tinh-linh-kien
276762388,Hạt đầu bấm mạng UTP RJ45 Cat6 Unitek (100c) - Hàng chính hãng,5.0,2061105684337,185000,185000,0,0,0,laptop-may-vi-tinh-linh-kien
276181938,USB 3.2 Team Group C175 32GB - Hàng chính hãng,103.0,4476418092052,99000,169000,70000,41,7,laptop-may-vi-tinh-linh-kien
276034344,OFFICE 365 FAMILY -  1 Tài Khoản 5 Thiết bị 1 Năm+ 1TB Lưu Trữ  - Hàng Chính Hãng,35.0,9096108590124,389000,389000,0,0,4,laptop-may-vi-tinh-linh-kien
275171088,Hộp mực dành cho máy in Canon LBP 6030/ 6030w F158200 HP P1102 / 1102w Hàng chính hãng Alpha Cartridge,238.0,4316340906989,121000,121000,0,0,11,laptop-may-vi-tinh-linh-kien
806672,USB Team Taiwan C171 16GB - Hàng Chính Hãng,487.0,6101576467779,77000,120000,43000,36,17,laptop-may-vi-tinh-linh-kien
275797120,Dây cáp mạng LAN đúc sẵn 2 đầu Cat6E UTP Arigato - Hàng chính hãng,379.0,5775244175359,60000,60000,0,0,30,laptop-may-vi-tinh-linh-kien
476059,USB Team E902 16GB - Hàng Chính Hãng,287.0,6104067990619,84000,120000,36000,30,6,laptop-may-vi-tinh-linh-kien
275961342,Hộp mực 78A dành cho Canon 6230dn 6230dw 6200d - HP P1560/1536/P1566/1600/P1606DN Mực in Canon MF4410/4430/4580DN/MF4570dn/4550d/4452/4450/4450d/MF4420n /4412/ự D520  Có lổ đổ mực-Hàng chính hãng Alpha Cartridge,55.0,8738807587844,126800,126800,0,0,0,laptop-may-vi-tinh-linh-kien
275621665,Hộp mực cho máy in HP 135a / 135w (có chip) hàng nhập khẩu - Dành cho máy in HP Laser MFP 135a / 135w - Cartridge 107A / W1107A mới 100% [Full Box] ,54.0,8504963370243,180000,180000,0,0,2,laptop-may-vi-tinh-linh-kien
275191713,"Hộp mực 337 dành cho máy in Canon MF211, MF221D,  MF215, MF241D LBP151dw/ Image CLASS MF 237W/ 247DW/ 211D/ MF212W/ MF221D/ MF241D/ MF215/ MF217W/ MF226DN/ MF229DW/ MF 236N/ MF244DW/ Hàng chính hãng Alpha Cartridge",116.0,8937804023560,126800,126800,0,0,1,laptop-may-vi-tinh-linh-kien
262065570,"Bộ phát wifi từ sim 4G PIX-LINK USB Modem  ,USB phát Wifi 4G LTE từ sim 4G, Dcom phát wifi di động  tốc độ cao, phủ sóng rộng - Hàng chính hãng / Hàng nhập khẩu",402.0,1279657733747,199000,199000,0,0,69,laptop-may-vi-tinh-linh-kien
136558,USB Team E902 8GB - Hàng Chính Hãng,137.0,6104118108369,81000,100000,19000,19,1,laptop-may-vi-tinh-linh-kien
274402217,USB Team Taiwan C171 4GB - Hàng Chính Hãng,262.0,6592199434986,72000,100000,28000,28,3,laptop-may-vi-tinh-linh-kien
589301,USB Team Group E902 4GB - USB 2.0 - Hàng Chính Hãng,251.0,6103084772017,100000,100000,0,0,7,laptop-may-vi-tinh-linh-kien
273124552,"USB Lexar JumpDrive V400 64GB / 128GB, Chuẩn USB 3.0, Tốc độ đọc 100Mb/s - Hàng chính hãng",231.0,9192378106138,135000,149000,14000,9,28,laptop-may-vi-tinh-linh-kien
272400934,Phần mềm bảo vệ máy tính Kaspersky Standard | Bản quyền chính hãng 365 ngày - Hàng Chính Hãng,19.0,4413829376916,350000,350000,0,0,1,laptop-may-vi-tinh-linh-kien
271041775,USB Kingston 3.2 Gen 1 DataTraveler Exodia Onyx USB Flash Drive 64G / 128G / 256G - Hàng Chính Hãng,42.0,5277654294710,125000,125000,0,0,10,laptop-may-vi-tinh-linh-kien
270663581,Phần mềm diệt Virus Kaspersky Plus Cho 5 Máy Tính - Plus5 - Hàng chính hãng,48.0,4243783395274,865000,865000,0,0,0,laptop-may-vi-tinh-linh-kien
219163708,"Hộp mực 337 - Hộp mực Canon mf241d hàng nhập khẩu dùng cho máy in Canon MF211, MF212w, MF215, MF217w, MF220, MF221d, MF230, MF232w, MF235, MF237w, MF240, MF244dw, MF246dn, MF249dw, LBP 151dw - Cartridge 337 - 83A mới 100%",79.0,7866589575858,130000,130000,0,0,3,laptop-may-vi-tinh-linh-kien
206112579,USB Kingston 128GB DataTraveler M 3.2 - Hàng chính hãng FPT phân phối,84.0,5062718819880,199000,199000,0,0,11,laptop-may-vi-tinh-linh-kien
190315447,Phần Mềm Diệt Virus BKAV Pro Internet Security AI (1 năm) - Hàng Chính Hãng,572.0,4888963029576,169000,169000,0,0,68,laptop-may-vi-tinh-linh-kien
174593821,"Kích Sóng Wifi Tốc Độ Cao 4 Râu 300M PIX-LINK LV-WR09 Thiết Bị Mở Rộng Sóng Bao Phủ Căn Nhà, Văn Phòng - Hàng Chính Hãng",597.0,9152381708033,199000,299000,100000,33,134,laptop-may-vi-tinh-linh-kien
142459136,Hộp Mực Cartridge 12A Máy In Canon LBP 2900 (303) 3000 HPQ2612A 1020 M1005 M1010 1018 Có Lỗ Nạp Mực - Hàng Chính Hãng,663.0,2368418900355,100000,100000,0,0,24,laptop-may-vi-tinh-linh-kien
138481685,"Phần mềm Microsoft Office 365 Family 6GQ-01896 / EP2-36878  | 12 tháng | Dành cho tối đa 6 người | 5 thiết bị/tài khoản| Word, Excel, PowerPoint | 1TB OneDrive",5157.0,5057438857877,1760000,2590000,830000,32,775,laptop-may-vi-tinh-linh-kien
134561311,USB 3.0 SanDisk Ultra Flair CZ73 - Hàng Nhập Khẩu,10312.0,8367091212771,135000,135000,0,0,233,laptop-may-vi-tinh-linh-kien
124742926,MacBook Air M1 13 inch 2020,2972.0,4409272649267,16770000,24990000,8220000,33,869,laptop-may-vi-tinh-linh-kien
95564239,Hộp mực 12A Canon 2900 hàng nhập khẩu Hộp mực dành cho máy in Canon LBP 2900/3000 HP Laser Jet 1010/1015/1020/3015/3020/3030/3050,64.0,5745134000307,130000,130000,0,0,1,laptop-may-vi-tinh-linh-kien
76181490,Phần Mềm Diệt Virus BKAV Profressional Internet Security (1 năm) - Hàng Chính Hãng,29759.0,7690918036913,176000,221100,45100,20,1694,laptop-may-vi-tinh-linh-kien
54439144,Bộ Chuyển Đổi USB Wifi TP-Link Archer T2U Plus Công Suất Cao AC600 - Hàng Chính Hãng,113.0,1416843001118,256000,309400,53400,17,12,laptop-may-vi-tinh-linh-kien
53080935,"Phần mềm Microsoft Office 365 Personal  | 12 tháng | Dành cho 1 người | 5 thiết bị/tài khoản | Word, Excel, PowerPoint | 1TB OneDrive",4498.0,1084495096501,1450000,2090000,640000,31,1086,laptop-may-vi-tinh-linh-kien
53056161,Phần mềm Microsoft 365 Family | 6 Users | 1TB/User | 365 ngày – Hàng chính hãng,910.0,3405828458427,1790000,2590000,800000,31,177,laptop-may-vi-tinh-linh-kien
21709688,Hộp mực 12a dành cho máy in LBP 2900/ hp 1020/ 1010 - NHẬP KHẨU,203.0,3901820326271,116500,116500,0,0,28,laptop-may-vi-tinh-linh-kien
14380739,"Hộp mực Samsung MLTD101, Samsung ML-2160/2161/2164/2165/2165W; SCX-3401/3450FW/3406 - Hàng nhập khẩu",61.0,9133888712831,214000,214000,0,0,4,laptop-may-vi-tinh-linh-kien
9845151,"Hộp mực máy in HP 85a (Cartridge, catrich, toner 85a, 1102, 1212, 1132)",479.0,1763573959852,116500,116500,0,0,82,laptop-may-vi-tinh-linh-kien
3831591,"Hộp đựng ổ cứng 2.5"" SSD/HDD Orico 2577U3 chuẩn sata 3 cổng USB 3.0 - Hàng Chính Hãng",1.0,5782854631979,179000,179000,0,0,0,laptop-may-vi-tinh-linh-kien
3054369,Phần Mềm Diệt Virus BKAV Profressional 1 PC 12 Tháng - Hàng Chính Hãng,52.0,5116522285995,234000,234000,0,0,1,laptop-may-vi-tinh-linh-kien
964243,Ổ Cứng SSD WD Green 240GB 3D NAND - WDS240G2G0A - Hàng Chính Hãng,26.0,9229899332325,430000,430000,0,0,4,laptop-may-vi-tinh-linh-kien
456500,TP-Link  TL-SG1008D - Switch Để Bàn 8 Cổng  - Hàng Chính Hãng,781.0,7506423083499,406000,499000,93000,19,95,laptop-may-vi-tinh-linh-kien
416990,TP-Link  TL-WN722N - USB Wifi (high gain) tốc độ 150Mbps - Hàng Chính Hãng,5825.0,7507716307926,175000,197600,22600,11,595,laptop-may-vi-tinh-linh-kien
276191594,Hộp mực 12A Canon 2900 dành cho Canon LBP 2900/3000 HP Laser Jet 1010/1015/1020/3015/3020/3030/3050  HÀNG CHÍNH HÃNG ALPHA CARTRIDGE,152.0,2057461643290,121000,121000,0,0,7,laptop-may-vi-tinh-linh-kien
2903577,Máy In Phun Màu Đa Năng Canon Pixma G3010 - Hàng Chính Hãng,327.0,1570718926767,4790000,5490000,700000,13,66,laptop-may-vi-tinh-linh-kien
273181063,"Bộ phát wifi từ sim 4G Pixlink USB Dcom, USB phát Wifi 4G LTE, usb modem phát wifi tốc độ cao, phủ sóng rộng, sử dụng dễ dàng - Hàng chính hãng / Hàng nhập khẩu",28.0,3665480520839,199000,250000,51000,20,5,laptop-may-vi-tinh-linh-kien
275175365,Cụm trống (Drum) Brother DR-2385 - Dùng cho các dòng máy in Brother HL(L2321D;L2361DN;L2366DW); MFC(L2520D;L2701D;L2701DW) Hàng chính hãng Alpha Cartridge,44.0,3557479216568,176500,176500,0,0,5,laptop-may-vi-tinh-linh-kien
276626019,Mac Mini 2024,3.0,7417807361908,15200000,18990000,3790000,20,1,laptop-may-vi-tinh-linh-kien
276308462,(Hot Sale) Bộ Thu Phát USB Bluetooth 5.3 TP-Link UB500 Nano thiết kế nhỏ gọn dành cho PC / Laptop - Hàng chính hãng,5.0,7488679266291,149000,149000,0,0,2,laptop-may-vi-tinh-linh-kien
276139893,Box NVME Orico PDDM2C3-G2 hỗ trợ m2 NVME PCIe Gen3x4 / Gen4x4 Type C tốc độ 10Gbps – Hàng Chính Hãng,1.0,5648108444130,385000,420000,35000,8,0,laptop-may-vi-tinh-linh-kien
276067078,"Dây nguồn máy tính laptop hàng xịn loại 1, dây dài 1 mét rưỡi, ổn định, chất lượng - Power cable laptop - Hàng chính hãng",8.0,4942860302754,65000,75000,10000,13,1,laptop-may-vi-tinh-linh-kien
275175751,Combo 5 Mực nạp Brother 2280 2385 1010 B022 dành cho HL 2240 2270 2321 L2300D L2305W L2320D L2340DW L2360DW L2380DW DCP 7060 7065 L2520DW L2540DW MFC 7360 7362 7470 7860 L2680W L2700DW L2705DW L2707DW L2720DW 7535DW Hàng chính hãng Alpha Cartridge,37.0,2038763188107,150000,150000,0,0,2,laptop-may-vi-tinh-linh-kien
275190023,Mực in Dành Cho Máy Canon 2900/L11121E - Hộp mực 12A HP 1010/ 1015/ 1018/ 1020/ 3015/ 3020/ 3030/ 3050/ 3055/ M1005MFP Hàng chính hãng Alpha Cartridge,164.0,9379210535255,121000,121000,0,0,4,laptop-may-vi-tinh-linh-kien
459201,Máy In Laser Đen Trắng Đơn Năng Brother HL-L2321D Duplex - Hàng Chính Hãng,4466.0,8502748339364,3200000,3690000,490000,13,628,laptop-may-vi-tinh-linh-kien
275955794,"Màn hình di động ZX1505 Nhiều Kích thước FullHD / 2K / 4k cho máy tính , laptop , smartphone",10.0,8183967181626,2050000,2050000,0,0,2,laptop-may-vi-tinh-linh-kien
275451243,Hộp mực dùng cho máy in canon lbp 2900/3000 (hộp mực 12a) hàng chính hãng ,286.0,8475785093143,112000,112000,0,0,7,laptop-may-vi-tinh-linh-kien
275191477,Hộp mực 85A 35A dành cho máy in Canon LBP 6000 6030 6030w F158200 HP P1102/P1212/P1102W/1136/1216/1130 - LBP 3010/3050/3020 Hàng chính hãng Alpha Cartridge,112.0,4436777031662,112800,112800,0,0,4,laptop-may-vi-tinh-linh-kien
274147427,Mã Code Hệ Điều Hành  Windows Pro - Hàng Nhập Khẩu,20.0,1672282986216,250000,250000,0,0,5,laptop-may-vi-tinh-linh-kien
257846830,"Mực In Brother TN-B022 (2.600 Trang) Mực Laser Trắng Đen, Sử Dụng Cho Máy Brother HL-B2000D, HL-B2080DW, DCP-B7535DW, MFC-B7715DW - Hàng Chính Hãng",49.0,4479643187467,485000,485000,0,0,5,laptop-may-vi-tinh-linh-kien
248184839,(Giá Huỷ Diệt) Thiết Bị Chuyển Đổi USB Wi-Fi Nhỏ Gọn TP-Link Archer T2UB Nano Chuẩn Bluetooth 4.2 Tốc Độ Cao AC600 - Hàng Chính Hãng,23.0,8417533320877,269000,269000,0,0,3,laptop-may-vi-tinh-linh-kien
201155896,"Combo 10 Nút Bịt Ổ Cắm Điện Chống Giật, Bảo Vệ An Toàn Cho Bé Hình Gấu - Hàng Chính Hãng",26.0,8690514057215,49000,98000,49000,50,2,laptop-may-vi-tinh-linh-kien
193247921,Dây Cáp Mạng Kèm Nguồn Cat5e FTP + 2C Golden Japan Bọc Bạc Chống Nhiễu - Hàng Chính Hãng (Bán Lẻ Mét),96.0,6449838624301,1020000,1020000,0,0,2,laptop-may-vi-tinh-linh-kien
192210428,Ổ Cứng Di Động WD My Passport Ultra Hàng Chính Hãng,48.0,9079087185851,2850000,3890000,1040000,27,10,laptop-may-vi-tinh-linh-kien
165177374,"Hộp mực in 107A/W1107A (full chip) hàng chính hãng Viettoner dùng cho máy in HP LaserJet 107a, 107w, 135a, 135w, 137a, 137w - Cartridge 107A/W1107A mới 100% [Fullbox]",110.0,7571732963668,285000,285000,0,0,10,laptop-may-vi-tinh-linh-kien
127377591,Hộp mực Topjet dùng cho máy in Canon 2900 - Hàng Chính Hãng ,523.0,2229210067223,150000,150000,0,0,8,laptop-may-vi-tinh-linh-kien
126107841,"Hộp mực máy in Canon 6030 hàng nhập khẩu - Hộp mực 325 dùng cho máy in Canon LBP 6000 6030, 6030w, 3050, 3100 - Cartridge 325 / 312 - 85A mới 100%",156.0,7978280153976,130000,130000,0,0,11,laptop-may-vi-tinh-linh-kien
87128621,Mực in Brother TN-2385 - HÀNG CHÍNH HÃNG,72.0,9928477837801,474500,474500,0,0,8,laptop-may-vi-tinh-linh-kien
83921674,Router Wifi Linksys E5600-AH Max-Stream AC1200 MU-MIMO GIGABIT - Hàng Chính Hãng,6.0,4596923028300,789000,789000,0,0,2,laptop-may-vi-tinh-linh-kien
44012580,RAM Laptop Samsung 8GB DDR4 Bus 3200 - Hàng Nhập Khẩu,1095.0,3732052764513,480000,684000,204000,30,370,laptop-may-vi-tinh-linh-kien
15270539,Bộ Thu Wifi TP-Link Archer T3U AC1300Mbps - Hàng Chính Hãng,52.0,4329393925490,331200,331200,0,0,19,laptop-may-vi-tinh-linh-kien
11627777,Hộp Mực In 05A-247Min dùng cho dòng máy in HP 2005/2030/2050/2055,24.0,4400314392734,165000,165000,0,0,2,laptop-may-vi-tinh-linh-kien
6909331,Bộ Kích Sóng Wifi Repeater Băng Tần Kép AC750 TP-Link RE200 - Hàng Chính Hãng,1617.0,4417398345419,369000,448500,79500,18,131,laptop-may-vi-tinh-linh-kien
6403893,Dây mạng bấm sẵn 2 đầu Cat6 UTP Patch Cords dài 5M UGREEN NW102 11204 - Hàng chính hãng,1403.0,9082768741396,56000,80000,24000,30,238,laptop-may-vi-tinh-linh-kien
2050777,USB 4G Huawei E3372 | Dcom 4G cho tốc độ lướt web chóng mặt 150Mbps – USB 4G - Hàng chính hãng,58.0,9426765555370,1190000,1190000,0,0,8,laptop-may-vi-tinh-linh-kien
763155,Dây Mạng Bấm Sẵn 2 Đầu CAT6 UTP Patch Cords NW102 11202 (2m) - Xanh - Hàng Chính Hãng,655.0,1359916223980,40100,50000,9900,20,71,laptop-may-vi-tinh-linh-kien
708026,Bộ Phát Wifi TP-Link Archer C50 Băng Tần Kép AC1200 - Hàng Chính Hãng,19.0,7509811889031,496000,496000,0,0,2,laptop-may-vi-tinh-linh-kien
575388,Hộp Đựng Ổ Cứng Di Động HDD Box 2.5 ORICO 2139U3 USB3.0/2.5 Nhựa Trong Suốt - Hàng Chính Hãng,919.0,3364245433687,175000,175000,0,0,185,laptop-may-vi-tinh-linh-kien
561957,Kaspersky Anti Virus Cho 1 Máy Tính - KAV1U - Hàng chính hãng,3428.0,2893630630512,172000,186000,14000,8,403,laptop-may-vi-tinh-linh-kien
561879,Kaspersky Internet Security Cho 1 Máy Tính - KIS1U - Hàng chính hãng,5257.0,2896544681069,299000,312000,13000,4,823,laptop-may-vi-tinh-linh-kien
514864,TP-Link  TL-WR845N - Router Không Dây Chuẩn N Tốc Độ 300Mbps - Hàng Chính Hãng,216.0,7502734914613,331000,349000,18000,5,30,laptop-may-vi-tinh-linh-kien
417018,Card Mạng TP-Link  TL-WN781ND - Hàng Chính Hãng,85.0,7505615609233,188000,195000,7000,4,5,laptop-may-vi-tinh-linh-kien
416978,Bộ Chuyển Đổi USB Wifi Nano TP-Link TL-WN725N Chuẩn N 150Mbps - Hàng Chính Hãng,7515.0,7504604440345,121000,139100,18100,13,808,laptop-may-vi-tinh-linh-kien
277521913,USB 3.2 Netac UM1 | 32GB / 64GB / 128GB | Vỏ kim loại bền bỉ | Read Upto 150MB/s | Bảo hành 5 năm | Hàng Chính Hãng,3.0,5416841143348,85000,85000,0,0,0,laptop-may-vi-tinh-linh-kien
277284444,Màn Hình Viewsonic VA2432A-H 24inch 120Hz Full HD IPS - Hàng Chính Hãng,4.0,8860841220347,2190000,2999000,809000,27,0,laptop-may-vi-tinh-linh-kien
276802041,"USB phát wifi từ sim 4G 5G Dongle, Dcom wifi, bộ phát wifi tốc độ cao sử dụng mọi loại sim - Hàng chính hãng / Hàng nhập khẩu",7.0,1461625874141,224000,448000,224000,50,0,laptop-may-vi-tinh-linh-kien
276499582,Laptop Dell Inspiron 15 3520 i5 1235U/16GB/512GB/120Hz/OfficeHS/Win11 (N3520 - i5U165W11BLU - FP) - Hàng Chính Hãng - Bảo Hành 12 Tháng,2.0,1243239680559,14290000,18990000,4700000,25,1,laptop-may-vi-tinh-linh-kien
276067096,"Dây nguồn dùng cho máy tính PC, màn hình máy tính, nồi cơm điện, máy in, máy chiếu và các thiết bị điện tử khác - Hàng chính hãng",8.0,5725454096408,66000,72000,6000,8,1,laptop-may-vi-tinh-linh-kien
275902796,"Dây Nguồn PC - Cắm PC - Màn Hình Máy Tính - Nồi Cơm Điện - Ấm Nước - Nồi Lẩu, An toàn, Tiện Dụng -Hàng Nhập khẩu",23.0,7670291055612,62000,62000,0,0,1,laptop-may-vi-tinh-linh-kien
275621667,Hộp mực máy in HP 137fnw (có chip) hàng nhập khẩu - Dùng cho máy in HP Laser MFP 137fnw - Cartridge 107A / W1107A mới 100% [Full Box] ,17.0,4742327549569,180000,180000,0,0,0,laptop-may-vi-tinh-linh-kien
275379339,"Ổ đĩa DVD gắn ngoài, Đầu đĩa CD/DVD di động USB 3.0 VÀ TYPE C cho máy tính xách tay Ổ ghi CD DVD ROM Tương thích với máy tính xách tay Máy tính để bàn PC Windows Linux OS Apple Mac-HÀNG CHÍNH HÃNG",9.0,6861004321945,320000,320000,0,0,2,laptop-may-vi-tinh-linh-kien
275347200,Màn hình LCD 24 INCH VSP V2407S FullHD 75Hz 5ms IPS (Đen/Trắng) Hàng Chính Hãng,2.0,9697273340747,1979000,2000000,21000,1,0,laptop-may-vi-tinh-linh-kien
275197013,Hộp mực 17A Có Chip dành cho HP LaserJet Pro M102a M102w M130a M130nw M130Fn M130fw CRG 047 Canon 113w mf113w CÓ LỔ ĐỔ MỰC Hàng chính hãng Alpha Cartridge,23.0,2619271180535,129900,129900,0,0,2,laptop-may-vi-tinh-linh-kien
275189884,"Hộp mực in 83A máy in HP M201, M125, M127, M225 Hàng chính hãng Alpha Cartridge",31.0,9558523479755,126800,126800,0,0,1,laptop-may-vi-tinh-linh-kien
274748068,Dây cáp mạng LAN bấm sẵn 2 đầu Cat6 UTP Dây Mạng Bấm Sẵn Đúc Sẵn Chuẩn 2 Đầu Hỗ Trợ Tốc Độ (màu ngẫu nhiên) Nẹp Dây Điện - Hàng chính hãng,42.0,7213733218625,110000,110000,0,0,2,laptop-may-vi-tinh-linh-kien
274382473,Ổ Cứng Di Động SSD Samsung T7 Shield USB 3.2 Gen 2 - Hàng Chính Hãng,12.0,1110810104206,3085000,3582000,497000,14,4,laptop-may-vi-tinh-linh-kien
271555404,Ổ Cứng SSD Samsung 990 Pro Heatsink 1TB / 2TB PCIe Gen 4.0 x4 NVMe 2.0 - Hàng Nhập Khẩu,9.0,1987791045223,2989000,3100000,111000,4,1,laptop-may-vi-tinh-linh-kien
270906218,Bộ Chuyển Đổi Card WiFi PCIe TP-Link Archer TX55E Bluetooth 5.2 Wi-Fi 6 AX3000 - Hàng Chính Hãng,4.0,1694796219541,615000,615000,0,0,0,laptop-may-vi-tinh-linh-kien
261976274,Dây cáp mạng LAN đúc sẵn 2 đầu Cat5E UTP Kingmaster - Hàng chính hãng,163.0,6754292759019,65000,99000,34000,34,9,laptop-may-vi-tinh-linh-kien
261823017,USB 3.2 SanDisk Ultra Luxe CZ74 - 512GB (Hàng Nhập Khẩu),42.0,5606664710225,890000,890000,0,0,9,laptop-may-vi-tinh-linh-kien
253185174,Ổ cứng di động External SSD Sandisk Extreme V2 E61 New 2021 - 2TB ( Hàng Nhập Khẩu ),39.0,9881192065779,4260000,4260000,0,0,3,laptop-may-vi-tinh-linh-kien
246163295,Ổ cứng HDD tím/Seagate 500G -1TB- 2TB chuyên dụng cho camera- Hàng Công ty,73.0,3292581745587,390000,390000,0,0,12,laptop-may-vi-tinh-linh-kien
225223011,Ổ Cứng SSD Crucial P3 Plus 500GB / 1TB / 2TB M2 PCIe 4.0 3D NAND - Hàng Nhập Khẩu,66.0,4492631145658,1355000,1626000,271000,17,14,laptop-may-vi-tinh-linh-kien
203213313,(Giá Hủy Diệt) Ổ Cứng gắn trong HDD Western Digital Ultrastar 20TB / 22TB SATA iii 3.5 inch cho Serve dòng Enterprise - Hàng Nhập Khẩu,131.0,6229903875590,10580000,12696000,2116000,17,39,laptop-may-vi-tinh-linh-kien
192304040,Phần mềm diệt virus kaspersky- Mã code Kaspersky Standard - Hàng Chính Hãng,89.0,9072238541618,89000,89000,0,0,14,laptop-may-vi-tinh-linh-kien
191975880,USB 3.2 Gen 1 Acer UP300 dung lượng USB 8GB - 1TB - Hàng chính hãng ,788.0,6361135443083,101000,104000,3000,3,155,laptop-may-vi-tinh-linh-kien
191829340,Bộ Chia Tín Hiệu Switch TP-Link LS1008G Để Bàn 8 Cổng 10/100/1000Mbps - Hàng Chính Hãng,67.0,2019323060623,435000,435000,0,0,9,laptop-may-vi-tinh-linh-kien
186139303,Ram PC KingSpec 8GB DDR3 1600Mhz - Hàng Chính Hãng,6.0,9654231001261,390000,390000,0,0,1,laptop-may-vi-tinh-linh-kien
185922577,Bộ Kích Sóng Wifi Xiaomi Repeater Pro N300 - Hàng Nhập Khẩu,63.0,3655952136812,215000,215000,0,0,13,laptop-may-vi-tinh-linh-kien
184497231,Bộ Chia Tín Hiệu Thông Minh TP-Link SG108E 8 Cổng Gigabit Tốc Độ Cao - Hàng Chính Hãng,18.0,4591337062882,629000,629000,0,0,3,laptop-may-vi-tinh-linh-kien
164250802,Ổ cứng SSD KingSpec M2 PCIe NVMe | NE - Hàng Chính Hãng,26.0,2782468043281,598000,598000,0,0,6,laptop-may-vi-tinh-linh-kien
120484511,Card mở rộng ổ cứng SSD M.2 qua khe Pci-E 3.0 X4 Orico PDM2 - Hàng chính hãng,1.0,2480467655118,188000,188000,0,0,0,laptop-may-vi-tinh-linh-kien
108924121,Laptop Dell Latitude 3520 70251603 (Core i3-1115G4/ 4 GB/ 256GB SSD/ 15.6HD/ Fedora) - Hàng Chính Hãng,5.0,9546440966387,10000000,10000000,0,0,3,laptop-may-vi-tinh-linh-kien
106235458,Hộp Mực In 83A/CF83A (VIET Toner) dùng cho máy in HP M125/ 125FW/ 125A/ 125nw/ M126/ M127/ M127FN/ M201/ M201DW/ M225MFP (Hàng chính hãng),83.0,1865570155423,126000,126000,0,0,3,laptop-may-vi-tinh-linh-kien
72689407,Phần mềm bảo vệ điện thoại Bkav Pro Mobile - Hàng chính hãng,354.0,8175696120577,78000,78000,0,0,45,laptop-may-vi-tinh-linh-kien
42561582,Hộp Mực In Premium 79A (CF279A) - Hàng Nhập Khẩu,111.0,4736066690218,118000,118000,0,0,11,laptop-may-vi-tinh-linh-kien
17967481,Bộ Kích Sóng Wifi Xiaomi Repeater Pro - Hàng Nhập Khẩu,422.0,9823030367490,290000,290000,0,0,120,laptop-may-vi-tinh-linh-kien
16392587,RAM PC DDR4 Samsung 8GB Bus 2133 - Hàng Nhập Khẩu,105.0,4056251417056,460000,624000,164000,26,22,laptop-may-vi-tinh-linh-kien
8114282,Máy Scan Canon Lide 300 - Hàng Chính Hãng,725.0,3084537339007,2040000,2490000,450000,18,160,laptop-may-vi-tinh-linh-kien
6817797,Vỏ hộp đựng ổ cứng SATA 2.0/3.0 2.5 và SSD vỏ nhựa ABS cao cấp (dây dời) UGREEN US221 30848 - Hàng Chính Hãng,1010.0,8945584994487,181000,220000,39000,18,220,laptop-may-vi-tinh-linh-kien
554426,Bộ Kích Sóng Wifi Repeater 300Mbps Tenda A9 - Hàng Chính Hãng,89.0,7509199036751,229000,229000,0,0,19,laptop-may-vi-tinh-linh-kien
491442,Mực In Canon PG-89 Cho Máy In Canon Pixma E560 - Hàng Chính Hãng,50.0,2686633134367,425000,425000,0,0,3,laptop-may-vi-tinh-linh-kien
459842,Bộ Chuyển Đổi USB Wifi TP-Link Archer T2U Băng Tần Kép AC600 - Hàng Chính Hãng,587.0,7502618878857,218000,361900,143900,40,59,laptop-may-vi-tinh-linh-kien
277837280,Màn Hình AOC 24B20JH3/74 (23.8 inch/ FHD/ IPS/ 250cd/ 1 ms/ 120Hz) - GiaPhucStore | Hàng Chính Hãng,4.0,2560468488269,2090000,2090000,0,0,0,laptop-may-vi-tinh-linh-kien
276985445,"USB Bluetooth 5.3 TP-Link UB500 Plus Chuẩn Bluetooth Mới nhất, Nhanh Hơn, Mạnh Mẽ Hơn - Hàng chính hãng",2.0,3015111685804,185000,185000,0,0,0,laptop-may-vi-tinh-linh-kien
276828662,Hộp mực 070 Canon LBP 243dw 246dw 248x-MF 461dw 462dw 463dw 465dw  KHÔNG CẦN GẮN CHIP VẪN NHẬ N LỆNH IN 100%-Bảo Đảm in bình thường. Hàng chính hãng Alpha Cartridge,4.0,5837964546255,221000,221000,0,0,0,laptop-may-vi-tinh-linh-kien
276287910,Tản Nhiệt Led RGB CM-M73S cho ổ cứng SSD M2 2280 hàng nhập khẩu,3.0,3089926805524,100000,100000,0,0,0,laptop-may-vi-tinh-linh-kien
275379102,Quạt Led tản nhiệt 12cm cắm nguồn trực tiếp cho case máy tính hàng nhập khẩu,7.0,5535275824001,55000,55000,0,0,1,laptop-may-vi-tinh-linh-kien
274610997,Máy tính để bàn mini – Máy chủ Server – Mini PC – Intel NUC JK01 (Hàng chính hãng),1.0,4714858273614,7300000,7300000,0,0,1,laptop-may-vi-tinh-linh-kien
274365707,"Đầu chuyển OTG Type C to USB 3.1 tốc độ cao Baseus Ingenuity Series Mini OTG Gen2 (Type-C to USB-A 3.1 Full Size, 10Gbps High speed OTG for Laptop/Macbook/iPad/Tablet/Smartphone)- Hàng nhập khẩu",11.0,9271837007077,115000,115000,0,0,0,laptop-may-vi-tinh-linh-kien
274055248,Mực in HP 103AD Dual Pack Black Original Neverstop Laser Toner (W1103AD) - Hàng chính hãng,6.0,3420505026945,600000,600000,0,0,0,laptop-may-vi-tinh-linh-kien
273714191,USB SanDisk 3.0 Ultra CZ48 32GB - Hàng Chính Hãng,12.0,9451862836329,199000,199000,0,0,1,laptop-may-vi-tinh-linh-kien
263440001,Ổ Cứng Di Động SSD Sandisk Portable E30 1TB New 2023 800MB/s - Hàng Nhập Khẩu,62.0,5057066743164,2250000,2250000,0,0,9,laptop-may-vi-tinh-linh-kien
205973673,"Dây Mạng Ngoài Trời + Âm Tường HIDEKI Cat5e FTP 8 Lõi Đồng Nguyên Chất + Bọc Bạc Phủ Dầu, Vỏ HDPE Siêu Bền - Hàng Chính Hãng",2.0,9675889997093,105000,105000,0,0,1,laptop-may-vi-tinh-linh-kien
204428582,Bộ Thu Phát Bluetooth TP-Link UB500 USB Nano Bluetooth 5.0 - Hàng Chính Hãng FPT phân phối,3.0,8207975229949,119000,119000,0,0,0,laptop-may-vi-tinh-linh-kien
196948702,Ổ cứng di động SDSSDE81-1T00 Sandisk Extreme Pro E81 - 1TB Hàng Nhập Khẩu,18.0,1679357351576,3600000,3600000,0,0,8,laptop-may-vi-tinh-linh-kien
188321303,Ổ cứng SSD 120GB/240GB/480GB/960GB HIKVISION HS-SSD-Minder(S) - Hàng Chính Hãng,2.0,3658218224468,330000,330000,0,0,1,laptop-may-vi-tinh-linh-kien
187188651,Bộ chia mạng 5/ 8 cổng switch 5/ 8 port 10/100Mbps chia tín hiệu lan Mercusys MS105 MS108 - Hàng chính hãng,5.0,8689757502474,120000,120000,0,0,0,laptop-may-vi-tinh-linh-kien
153911821,"Hộp mực 83A / Cartridge 137 / 337 Legend nhập khẩu - HP Pro M127FN, M125A - Canon MF211, MF212W, MF221D, MF215, MF217W, 151DW, MF240, MF241D, MF226DN",234.0,8702496678288,117500,117500,0,0,11,laptop-may-vi-tinh-linh-kien
147759418,Máy in HP LaserJet M211dw (9YF83A) - Hàng chính hãng,6.0,8446697254710,3570000,4990000,1420000,28,2,laptop-may-vi-tinh-linh-kien
143714177,USB 128GB Kingston DTX- Hàng chính hãng,29.0,4818920520335,199000,199000,0,0,5,laptop-may-vi-tinh-linh-kien
134840301,USB 3.2 Gen 1 Kingston DataTraveler Exodia - Hàng Chính Hãng,1117.0,9357563844316,115000,115000,0,0,79,laptop-may-vi-tinh-linh-kien
115845662,Ổ cứng HDD Seagate 500G Bh 24T tại H2PComputer- Hàng Chính Hãng,24.0,8438126245721,349000,349000,0,0,6,laptop-may-vi-tinh-linh-kien
73566898,"Giấy in nhiệt K57x38 - Giấy in Bill K57 - Giấy in hóa đơn K57 - Dùng cho các dòng máy in: XPRINTER, EPSON, BIXOLON, COGNITIVE, BIRCH, YAMAFUJI,C USTOM, SUPER PRINTER, TOPCASH, ANTECH, DATAPRINT, APOS, TAWA PRP, ATP",146.0,9371984443079,5400,5400,0,0,2,laptop-may-vi-tinh-linh-kien
72759094,Ổ cứng SSD Silicon Power 256GB Ace SP256GBSS3A58A25 - Hàng Chính Hãng,3.0,3285963789002,649000,649000,0,0,1,laptop-may-vi-tinh-linh-kien
26039308,Hộp mực PrintMax dành cho máy in Brother TN 2385  - Hàng Chính Hãng,17.0,9417881470715,195000,195000,0,0,2,laptop-may-vi-tinh-linh-kien
24881672,Hộp mực in ACO CF230A - Hàng chính hãng,21.0,4789974890898,154000,154000,0,0,1,laptop-may-vi-tinh-linh-kien
24012824,Hộp mực  78A dành cho máy in HP 1536DNF/P1566/1606.......- HÀNG NHẬP KHẨU,339.0,4178271268569,118500,118500,0,0,10,laptop-may-vi-tinh-linh-kien
21715160,Hộp mực 53a dành cho máy in hp 2015/2015d/2014 - NHẬP KHẨU,18.0,5372679087985,195000,195000,0,0,5,laptop-may-vi-tinh-linh-kien
20616291,Hộp mực máy in mã 85A Viet Toner - chính hãng,40.0,6658276041612,125000,125000,0,0,3,laptop-may-vi-tinh-linh-kien
16397909,RAM PC DDR4 Samsung 8GB Bus 2400 - Hàng Nhập Khẩu,240.0,7726343711641,480000,636000,156000,25,48,laptop-may-vi-tinh-linh-kien
14991077,Máy chấm công Ronald Jack RJ500 - Hàng chính hãng,3.0,1919344777365,1800000,1800000,0,0,0,laptop-may-vi-tinh-linh-kien
12404568,Bộ Phát Wifi TP-Link TL-WR820N Chuẩn N 300Mbps - Hàng Chính Hãng,1097.0,5716033749964,228000,253500,25500,10,197,laptop-may-vi-tinh-linh-kien
12121958,RAM Laptop Kingmax 8GB Bus 2666 DDR4 - Hàng Chính Hãng,15.0,5006180158512,430000,430000,0,0,6,laptop-may-vi-tinh-linh-kien
11194483,Mực đổ Thuận Phong IR 2016 dùng cho máy photocopy Canon - Hàng Chính Hãng,27.0,8928185632606,150000,150000,0,0,1,laptop-may-vi-tinh-linh-kien
7177741,Dây cáp COM RS-232 cái sang cái dài 1.5M UGREEN DB101 20149 - Hàng chính hãng,2.0,2629957149020,176000,176000,0,0,0,laptop-may-vi-tinh-linh-kien
2045595,Dây Cáp Mạng Ugreen CAT7 11271 (5m) - Hàng Chính Hãng,24.0,7153529001416,187000,187000,0,0,5,laptop-may-vi-tinh-linh-kien
2045567,Dây Cáp Mạng Ugreen CAT6 11207 (15m) - Hàng Chính Hãng,92.0,8286286096308,123000,140000,17000,12,35,laptop-may-vi-tinh-linh-kien
1406949,Ổ Đĩa Rời Đọc Và Ghi CD/DVD Transcend TS8X DVDS-K - Hàng Chính Hãng,114.0,8777670403548,959000,979000,20000,2,14,laptop-may-vi-tinh-linh-kien
763675,Máy In Laser Đơn Năng Brother HL-L2366DW - Hàng Chính Hãng,693.0,8504441045641,4140000,4490000,350000,8,120,laptop-may-vi-tinh-linh-kien
754246,Bộ Chuyển Đổi Wifi Mercusys MW150US USB Wifi Nano N150 - Hàng Chính Hãng,2.0,7504825243756,75000,75000,0,0,0,laptop-may-vi-tinh-linh-kien
561924,Kaspersky Internet Security Cho 3 Máy Tính - KIS3U - Hàng Chính Hãng,1365.0,2899710380414,650000,650000,0,0,169,laptop-may-vi-tinh-linh-kien
514319,TP-Link  TL-SG105 - Switch Để Bàn 5 Cổng Gigabit - Hàng Chính Hãng,14.0,7500384794685,365000,365000,0,0,1,laptop-may-vi-tinh-linh-kien
277542377,Bộ phát sóng Mesh WIFI 6 TP-Link Deco X10 | WIFI 6 AX1500 2 băng tần | Vùng phủ sóng rộng | Bảo hành 2 năm | Hàng Chính Hãng,1.0,6318966537143,899000,899000,0,0,1,laptop-may-vi-tinh-linh-kien
277444714,"Wi-Fi Di Động 4G LTE Mercusys MT110 4G LTE đến 150Mbps, Thẻ SIM Cắm và Chạy, 10 Giờ Sử Dụng, Ứng Dụng Dễ Điều Khiển - Hàng chính hãng",1.0,8425460574592,605000,605000,0,0,1,laptop-may-vi-tinh-linh-kien
276643094,Hộp Mực In GDV Cartridge 12A Cho Máy HP 1010 1012 1015 1018 1020 1022 3015 3020 3030 3050 3050Z 3052 3055 M1005 1319 Có Lỗ Nạp Mực - Hàng Chính Hãng,7.0,6780492791496,110000,110000,0,0,0,laptop-may-vi-tinh-linh-kien
276643010,Hộp Mực In GDV Cartridge 12A Cho Máy In Canon LBP 2900 (303) 3000 HPQ2612A 1020 M1005 M1010 1018 Có Lỗ Nạp Mực - Hàng Chính Hãng,13.0,6750702998073,110000,110000,0,0,0,laptop-may-vi-tinh-linh-kien
276287914,Giá đỡ kim Loại VT192 cho VGA  máy tính chống xệ cong chân cho VGA hàng nhập khẩu,1.0,4637393109386,85000,85000,0,0,0,laptop-may-vi-tinh-linh-kien
275958329,Bo mạch chủ Main MSI B450M-A PRO MAX Socket AM4 - Hàng Chính Hãng,1.0,9778739841754,1790000,1790000,0,0,1,laptop-may-vi-tinh-linh-kien
275792538,Ống mực 3054: Dùng cho máy photocopy Ricoh MP 3554 _MP 2554 | 2555 | 3054 | 3554 | 3055 | 3555 | 4054 | 5054 | 6054 | 4055 | 5055 | 6055 | IM 2500 | IM 3000 | IM 3500 | IM 4000 | IM 5000 | IM 6000_ MP3554 ( HA - Hàng nhập khẩu ),3.0,6879236599863,420000,420000,0,0,0,laptop-may-vi-tinh-linh-kien
275621663,Hộp mực cho máy in Neverstop Laser 1200w / 1200a hàng nhập khẩu  mới 100% [Full box] - 103A / W1103A,8.0,2209839749634,110000,110000,0,0,0,laptop-may-vi-tinh-linh-kien
275611790,"Drum (Trống) 12A LN Phấn dùng cho máy In Canon 2900, 3000, Hp 1010, 1020, 3050, 1319F, 1022 - Hàng chính hãng",7.0,9283539452926,22000,22000,0,0,0,laptop-may-vi-tinh-linh-kien
275504846,Sạc dành cho Laptop HP Pavilion 14 V023TU V024TU Adapter 19.5V-3.33A hàng nhập khẩu.,1.0,9234395989683,255000,255000,0,0,0,laptop-may-vi-tinh-linh-kien
275246785,"COMBO CỤM DRUM + MỰC B022 Prospect dùng cho máy in Brother HL B2000D, HL B2080DW, MFC-7535D, MFC 7715dw - Hàng chính hãng",1.0,7726133526724,561000,561000,0,0,0,laptop-may-vi-tinh-linh-kien
275190388,Hộp mực TN 2280 2240 2260 -Có Lổ Đổ Mực dành cho- Brother HL 2130/2240d/2250dn/2270dw/2275dw/2280dw/ MFC-7360N/7470D/7460DN/7860DW DCP-7060D Hàng chính hãng Alpha Cartridge,6.0,8452890498280,119500,119500,0,0,2,laptop-may-vi-tinh-linh-kien
275175857,Cụm Drum 32A/30A/051 Có Chip HP M227fdw-M203dw-M118w-M148- dành cho Canon 161dn 162dw MF269dw- MF266dn-276dw Hàng chính hãng Alpha Cartridge,2.0,8348428604909,168000,168000,0,0,0,laptop-may-vi-tinh-linh-kien
274329447,"Dây nguồn 2 chân đầu tròn dài 3M Novalink NV-53008A dùng cho PC, UPS, màn hình.. tiết diện lõi đồng 3 x 1.0mm, tiêu chuẩn UL. Hàng chính hãng",5.0,9670700189760,140000,140000,0,0,0,laptop-may-vi-tinh-linh-kien
274274897,"Combo 3 lọ mực, nạp cho hộp mực in HP 35A/ 36A/ 78A/ 83A/ 85A/ Canon 312/ 313/ 325/ 326/ 328/ 337 ( Hàng nhập khẩu )",1.0,4824871969393,80000,80000,0,0,0,laptop-may-vi-tinh-linh-kien
273715443,Ugreen UG20168NW102TK 30M màu Đen Cáp mạng LAN CAT6 UTP - HÀNG CHÍNH HÃNG,1.0,6070808183039,240000,240000,0,0,0,laptop-may-vi-tinh-linh-kien
273712877,"Nguồn tổ ong RS-15-3.3 Meanwell (9.9W 3.3V 3A), Hàng chính hãng",1.0,4146533355431,225000,225000,0,0,0,laptop-may-vi-tinh-linh-kien
273351055,Vỏ máy tính CASE  SAMA M1/ M2/ M3 - Hàng Chính Hãng,1.0,3590288228747,390000,390000,0,0,1,laptop-may-vi-tinh-linh-kien
271963795,Ổ cứng gắn trong Silicon Power M.2 2280 PCIe NVMe SSD A60 - Hàng chính hãng,3.0,5899802586037,1350000,1350000,0,0,0,laptop-may-vi-tinh-linh-kien
271439340,USB Kingston 3.2 Gen 1 DataTraveler Exodia Onyx 64G / 128G / 256G - Hàng Chính Hãng ,5.0,9064424140718,139000,155000,16000,10,0,laptop-may-vi-tinh-linh-kien
263029608,"Màn Hình Gaming E-dra EGM22F75 (21.5""/FHD/IPS/75Hz/5ms) - Hàng chính hãng",3.0,7101421187113,1699000,1699000,0,0,0,laptop-may-vi-tinh-linh-kien
249200251,"Hộp mực 309 / 527 (hàng nhập khẩu) dùng cho máy in Canon LBP 3500, 3900, 3910, 3920, 3930, 3950, 3970, 3980, 8610, 8620, 8630, 5250, 5350 ,6525, 6535 - Cartridge 309 / 527-16A mới",8.0,1929789708072,495000,495000,0,0,1,laptop-may-vi-tinh-linh-kien
248792234,Hộp mực cho máy in HP Neverstop Laser 1000w / 1000a hàng nhập khẩu mới 100% [Full box] -  103A / W1103A,48.0,4885813972224,110000,110000,0,0,4,laptop-may-vi-tinh-linh-kien
225216948,Sạc dành cho Laptop HP 3.33a - công suất 65w - Chân kim nhỏ 4.5mm - Tặng kèm dây nguồn - Hàng Nhập Khẩu New Seal,1.0,3304478688426,280000,280000,0,0,0,laptop-may-vi-tinh-linh-kien
213891752,Bo Mạch Chủ (Mainboard) Gigabyte H170M-D3H (RAMDDR3)- HÀNG CHÍNH HÃNG,1.0,4023524839877,1650000,1650000,0,0,1,laptop-may-vi-tinh-linh-kien
211312699,Bộ Mực Epson 673 6 màu C M Y K LC LM dành cho máy Epson 1390/1400/1430/L1800/L805/L800/L850- Hàng nhập khẩu,36.0,5457839869934,420000,420000,0,0,3,laptop-may-vi-tinh-linh-kien
200027902,Bàn phím dùng cho Laptop HP Probook 4430S 4431S - Hàng Nhập Khẩu New Seal,2.0,1608568024487,262786,262786,0,0,1,laptop-may-vi-tinh-linh-kien
200007550,Pin dùng cho Laptop Dell Latitude E6440 - Hàng Nhập Khẩu  MIBAT820,3.0,1953590494628,513256,513256,0,0,1,laptop-may-vi-tinh-linh-kien
193614746,Soundcard M-Audio M-Track Duo - Bộ Thu Âm Thanh Và Livestream MAudio MTrack Audio Interface Sound Card M Track Hàng Chính Hãng - Kèm Móng Gẩy DreamMaker,8.0,3493562797513,1750000,1750000,0,0,2,laptop-may-vi-tinh-linh-kien
192202288,Phần mềm diệt virus BKAV Pro Internet Security AI 3PC/1 năm - Hàng Chính Hãng,2.0,4043712148849,546000,600000,54000,9,0,laptop-may-vi-tinh-linh-kien
169695798,Keo Tản Nhiệt Cooler Master Mastergel Pro V2 - Hàng Chính Hãng,204.0,3462696420104,99000,99000,0,0,29,laptop-may-vi-tinh-linh-kien
143105681,Hộp Mực In Cartridge 12A Cho Máy Canon LBP 2900 3000 Q2612A FX9 FX10 103 303 703 104 304 Có Lỗ Nạp Mực - Hàng Chính Hãng,353.0,9477893611029,100000,100000,0,0,13,laptop-may-vi-tinh-linh-kien
107360880,Bộ Mở Rộng Sóng Wifi Mesh TP-Link RE315 Chuẩn AC 1200Mbps - Hàng Chính Hãng,50.0,8141128709824,475000,475000,0,0,7,laptop-may-vi-tinh-linh-kien
98870800,Bộ chia mạng Switch Tenda SG108 8 cổng Ethernet 1000Mbps - Hàng Chính Hãng,37.0,2266692584164,417000,417000,0,0,8,laptop-may-vi-tinh-linh-kien
74883580,"Dây cáp mạng hai đầu đúc sẵn CAT8 SSTP VENTION tròn, dài 1m đến 20m IKAB - Hàng chính hãng",37.0,2731530498767,99000,99000,0,0,1,laptop-may-vi-tinh-linh-kien
42561571,Hộp Mực In Premium 30A - Hàng Nhập Khẩu,15.0,8086708319554,142000,142000,0,0,0,laptop-may-vi-tinh-linh-kien
25552398,Băng mực máy in Kim Epson LQ310 - HÀNG CHÍNH HÃNG,150.0,7213472746892,60000,60000,0,0,13,laptop-may-vi-tinh-linh-kien
21089128,Bộ Thu Wifi USB TP-Link TL-WN722N Chuẩn N 150Mbps - Hàng Chính Hãng,83.0,9411825928607,175000,175000,0,0,9,laptop-may-vi-tinh-linh-kien
20018750,USB 128GB Hoco - Hàng Chính Hãng,25.0,8682098022694,449000,449000,0,0,0,laptop-may-vi-tinh-linh-kien
16609730,RAM PC DDR4 Samsung 4GB Bus 2666 - Hàng Nhập Khẩu,80.0,1536793844617,350000,350000,0,0,34,laptop-may-vi-tinh-linh-kien
277592365,Bộ mở rộng sóng Wifi TP-Link 300Mbps TL-WA850RE - Hàng chính hãng,1.0,3542551924799,235000,249000,14000,6,0,laptop-may-vi-tinh-linh-kien
277286085,Màn Hình Viewsonic VA2708-2K-MHD 27 inch (2K/100HZ/1MS/LOA) - Hàng Chính Hãng,7.0,3675820855189,3690000,4590000,900000,20,3,laptop-may-vi-tinh-linh-kien
275940944,"Bộ mực dành cho máy in Canon G1010, G210, G3010, G1000, G2000, G3000",12.0,3531878774577,400000,400000,0,0,1,laptop-may-vi-tinh-linh-kien
275856915,Dây cáp mạng LAN 2 đầu bấm sẵn - Cáp mạng RJ45 dài từ 1 mét rưỡi đến 50m - Hàng chính hãng,27.0,6375750060328,30000,35000,5000,14,3,laptop-may-vi-tinh-linh-kien
275662684,"Hộp mực 136A (Có chip) hàng nhập khẩu - Dùng cho máy in Hp Laserjet M211d, M211dw, M236dw - Cartridge 136A - W1360A",21.0,9406853945552,270000,270000,0,0,4,laptop-may-vi-tinh-linh-kien
275621669,Hộp mực máy in HP 107a / 107w (có chip) hàng nhập khẩu - Dùng cho máy in HP Laser MFP 107a / 107w - Cartridge 107A / W1107A mới 100% [Full Box] ,87.0,1941720592828,180000,180000,0,0,5,laptop-may-vi-tinh-linh-kien
275621129,Mực Canon NPG 87/ G 87: Cho máy photocopy Canon IR 2725i/ 2730i/ 2735i/ 2745i ( Thương hiệu BIASDO - Hàng nhập khẩu ),2.0,4765397380618,450000,450000,0,0,1,laptop-may-vi-tinh-linh-kien
275515236,"Hộp mực in 278A/326/328 cho máy in Canon LBP 6200d/LBP6230dn/LBP6230dw, HP P1560/P1566/P1600/P1606/M1536dnf - Hàng nhập khẩu",26.0,3987779065973,102000,145000,43000,30,0,laptop-may-vi-tinh-linh-kien
275221517,Mực Prospect 673 dùng máy in Epson L805/ L1800/ L800/ L850 trọng lượng 70ml - Hàng chính hãng,35.0,6661878169019,44000,44000,0,0,0,laptop-may-vi-tinh-linh-kien
275221336,"Combo 5 chai Mực Nạp LN 12A-26A dùng cho máy in Canon 2900, Hp 1020,... đậm đẹp, ít thải 140g + 1 Phễu - hàng chính hãng",24.0,4978894447234,155000,155000,0,0,3,laptop-may-vi-tinh-linh-kien
275221007,"Mực Nạp, Mực chai 12A-26A dùng cho máy in 2900, 3300, 6650, ... Hp 1020, P2035, Pro 400, P1320 Trọng lượng 140g đậm đẹp - Hàng chính hãng",107.0,6207823383049,30800,30800,0,0,1,laptop-may-vi-tinh-linh-kien
275196131,"Hộp mực 12A dành cho Canon 2900/ L11121E Mực in HP LaserJet 1010/1015/1020/3015/3020/3030/3050 Canon L120, MF4122, MF4150, MF4680, L140, L160, MF4270, MF4320d, MF4350d 3000 FX9 FX10 CÓ LỔ ĐỔ MỰC Hàng chính hãng Alpha Cartridge",88.0,5551589851052,112800,112800,0,0,3,laptop-may-vi-tinh-linh-kien
274664201,Ổ CỨNG HDD WESTERN DIGITAL 2TB PURPLE (WD23PURZ) (64MB CACHE/3.5 INCH/ SATA3) Hàng Chính Hãng,2.0,1356006926735,1766000,1800000,34000,2,1,laptop-may-vi-tinh-linh-kien
274402602,USB 3.2 Team Group C175 - Hàng chính hãng,71.0,5398961196545,99000,175000,76000,43,5,laptop-may-vi-tinh-linh-kien
273441394,Mực in Brother TN-B027 - Hàng Chính Hãng,47.0,9720987766493,220000,220000,0,0,3,laptop-may-vi-tinh-linh-kien
272209171,Bộ Phát WIFI  Từ Sim 4G/5G/LTE MF800 - Pin 2100mAh ( hoạt động 6-8h) - Bộ Phát WIFI Không Dây Kết Nối Tối Đa 10 Thiết Bị - Hàng Chính Hãng,18.0,6960978178197,440000,800000,360000,45,3,laptop-may-vi-tinh-linh-kien
262636982,"Trống Mực In (Drum) Brother DR-B022 (12.000 Trang) Sử Dụng Cho Máy In Brother B2080DW, B2000D, B7535DW, B7715DW - Hàng Chính Hãng",35.0,9511575035569,640000,640000,0,0,4,laptop-may-vi-tinh-linh-kien
260933397,Box Orico Đựng Ổ Cứng HDD/SSD 2.5 inch 25PW1-U3-BK - Hàng chính hãng,17.0,6643198728075,135000,150000,15000,10,2,laptop-may-vi-tinh-linh-kien
247241493,Phần Mềm Diệt Virus BKAV Profressional Internet Security (1 năm) - Hàng Chính Hãng,787.0,3960256358285,169000,169000,0,0,90,laptop-may-vi-tinh-linh-kien
192156146,"Cáp Mạng Ngoài Trời HIDEKI Cat5e 8 Lõi Đồng, Có Sợi Thép Chịu Lực, Vỏ HDPE Siêu Bền -Hàng Chính Hãng",113.0,5215235594433,10500,10500,0,0,23,laptop-may-vi-tinh-linh-kien
146012358,Ổ cứng di động External SSD Sandisk Extreme V2 E61 New 2021 - 1TB Hàng Nhập Khẩu,655.0,3987082079960,2750000,2750000,0,0,146,laptop-may-vi-tinh-linh-kien
134559638,USB SanDisk CZ73 Ultra Flair - USB 3.0 - Hàng Chính Hãng,504.0,7310552769494,134000,149000,15000,10,65,laptop-may-vi-tinh-linh-kien
97970440,Máy đếm tiền OUDIS 5200C New - hàng chính hãng,3.0,5038421625854,2890000,2890000,0,0,0,laptop-may-vi-tinh-linh-kien
74975883,Bộ Phát Wifi TP-Link Archer C54 Băng Tần Kép Chuẩn AC1200 - Hàng Chính Hãng,37.0,8856697508143,388000,526500,138500,26,10,laptop-may-vi-tinh-linh-kien
74342340,Hộp mực in laser CF276A (không chip) dùng cho máy in HP LaserJet Pro M404DW/M404DN/M404N/HP LaserJet Pro MFP M428FDW/M428DW/M428FDN - Hàng nhập khẩu,55.0,6907122138632,209000,209000,0,0,4,laptop-may-vi-tinh-linh-kien
67179382,"Hộp Đựng Ổ Cứng ORICO 2020U3-BK 2.5"""" SSD/HDD SATA 3 USB 3.0 Hàng Chính Hãng",108.0,2524084239227,125000,175000,50000,29,15,laptop-may-vi-tinh-linh-kien
58722665,Set 50 cuộn giấy in nhiệt K80 ∅45 (OJI - JAPAN) Hàng nhập khẩu,12.0,6832931756831,350000,350000,0,0,1,laptop-may-vi-tinh-linh-kien
42561594,Hộp Mực Premium TN2385/ TN2325 Cho Máy In Brother HL-2360/2361 - Hàng Nhập Khẩu,395.0,1881424934558,116500,116500,0,0,21,laptop-may-vi-tinh-linh-kien
11100482,Bộ thu sóng wifi LB-LINK BL-WN155 - Chính hãng,69.0,7083860188852,150000,150000,0,0,7,laptop-may-vi-tinh-linh-kien
9966450,Hộp mực 12A cho máy in 2900 3000 HP. 1010 1020 - Q2612A,368.0,4930475723455,116500,116500,0,0,16,laptop-may-vi-tinh-linh-kien
3939221,Ổ cứng SSD WD G2 240GB Chuẩn M.2 Green - Hàng Chính Hãng,9.0,6080369559832,515000,515000,0,0,4,laptop-may-vi-tinh-linh-kien
806744,USB Team Taiwan C171 8GB - Hàng Chính Hãng,346.0,6106897573864,74000,100000,26000,26,11,laptop-may-vi-tinh-linh-kien
536534,TP-Link  TL-WA850RE - Bộ Mở Rộng Sóng WiFi Tốc Độ 300Mbps - DCH - Hàng Chính Hãng,14.0,7500898607532,218000,529000,311000,59,2,laptop-may-vi-tinh-linh-kien
511996,Bộ Phát Wifi Router 4G LTE Băng Tần Kép AC750 TP-Link Archer MR200 - Hàng Chính Hãng,280.0,7503846209574,1360000,1606800,246800,15,52,laptop-may-vi-tinh-linh-kien
459843,Bộ Chuyển Đổi Không Dây TP-Link TL-WN881ND PCI Express Chuẩn N 300Mbps - Hàng Chính Hãng,54.0,7505160698294,290000,299000,9000,3,12,laptop-may-vi-tinh-linh-kien
459733,"Brother TN-2385 Toner Mực Cho Máy In HL-L2321D, HL-2361DN, HL-2366DW, MFC-L2701D, MFC-L2701DW - Hàng Chính Hãng",3216.0,8505023584480,495000,495000,0,0,455,laptop-may-vi-tinh-linh-kien
456516,TP-Link  TL-SF1016D - Switch Chia Tín Hiệu Để Bàn 16 Cổng 10/100Mbps - Hàng Chính Hãng,23.0,7504067900554,485000,485000,0,0,4,laptop-may-vi-tinh-linh-kien
419320,Máy In Laser Đơn Năng Canon LBP 6030 - Hàng chính hãng,2108.0,8504134130395,3450000,4490000,1040000,23,238,laptop-may-vi-tinh-linh-kien
416911,TP-Link  TL-WN823N - USB Wifi chuẩn N tốc độ 300Mbps - Hàng Chính Hãng,443.0,7505896127457,195000,195000,0,0,50,laptop-may-vi-tinh-linh-kien
276952048,Màn hình MSI PRO MP242L 23.8 inch FHD IPS 100Hz 1ms - Hàng Chính Hãng,12.0,3967808098247,1900000,2490000,590000,24,0,laptop-may-vi-tinh-linh-kien
276601428,Dung Dịch Đánh Bóng Và Làm Sáng Đồ Trang Sức Vàng Bạc Cao Cấp JAKEHOE - Hàng Nhập Khẩu,5.0,4448807850134,65000,65000,0,0,0,laptop-may-vi-tinh-linh-kien
276581298,"Máy in hoá đơn Bluetooth Xprinter XP-58IIB, sử dụng khổ giấy in rộng 58mm, kết nối USB hoặc là Bluetooth ( hàng chính hãng)",6.0,4694538347239,60000,60000,0,0,1,laptop-may-vi-tinh-linh-kien
276267734,"Ổ cứng SSD Acer MA200 M.2 2230 PCIe Gen4 x4 NVMe 1.4, tốc độ đọc/ghi 5200MB/s và 4700MB/s - Bảo hành 5 năm Hàng chính hãng",4.0,2269608474025,1347000,1827000,480000,26,0,laptop-may-vi-tinh-linh-kien
276074011,Adapter sạc laptop đa năng 8 đầu dùng cho nhiều dòng máy - Hàng chính hãng / Hàng nhập khẩu,7.0,6023570119372,120000,120000,0,0,1,laptop-may-vi-tinh-linh-kien
275970332,"Cục phát wifi từ sim 4G kiêm pin sạc dự phòng TP10000, bộ phát wifi di động tốc độ cao 300Mbps, sử dụng mọi loại sim - Hàng nhập khẩu",3.0,5019631852430,638000,1276000,638000,50,0,laptop-may-vi-tinh-linh-kien
275538760,Sạc 165W USB-C Type-C Power Charger Adapter for Dell Precision 5680 5690 Dell XPS 15 17 DA165PM210 - Z.i.n Hàng nhập khẩu,3.0,3498317949386,1190000,1190000,0,0,0,laptop-may-vi-tinh-linh-kien
275452721,"Hộp mực Dành Cho máy in Canon LBP 2900, 3000 - 12A / HP LaserJet - 1010/ 1012/ 1015/ 1020/ 1018/ 1022/ 1022n/ 1022nw- Hàng chính hãng Alpha Cartridge ",63.0,4272664439480,112800,112800,0,0,1,laptop-may-vi-tinh-linh-kien
275073647,Giắc ổ cắm chuyển đổi đầu 3 chân sang 2 chân nguồn 220V thông thường - Hàng chính hãng,10.0,2910790949912,25000,25000,0,0,2,laptop-may-vi-tinh-linh-kien
274928774,"Hộp mực 78A 326 328 Prospect dùng cho máy in LBP 6230DN, 6200, HP P1566 P1606, 1536dnf  đậm đẹp, hàng chính hãng",53.0,1489252709798,143000,143000,0,0,3,laptop-may-vi-tinh-linh-kien
274612278,Hộp mực 136A (W1360A) dùng cho máy in HP M211d/ M211dw/ M236dw/ M236sdw KHÔNG CHIP NHẬN MỰC - Hàng nhập khẩu,10.0,6180291221081,170000,198000,28000,14,1,laptop-may-vi-tinh-linh-kien
274542060,Bộ Phát Wifi Di Động TP-Link TL-MR105 4G LTE Tốc Độ 300Mbps - Hàng Chính Hãng,4.0,5648280424861,875000,875000,0,0,0,laptop-may-vi-tinh-linh-kien
273891220,Box SSD di động Lexar E6 LPAE06N-RNBNG M.2 PCIe NMVe | Cổng giao tiếp USB-C | Bảo Hành 12 Tháng - Hàng Chính Hãng,11.0,7228545326578,349000,349000,0,0,2,laptop-may-vi-tinh-linh-kien
271421744,Ổ Cứng Di Động SSD Siêu nhỏ Transcend ESD310 256GB USB 3.2 Gen2x1 TS256GESD310 - Hàng Chính Hãng,11.0,5725260529233,990000,1059000,69000,7,2,laptop-may-vi-tinh-linh-kien
271266740,"USB Lexar Jumpdrive M900 Flash Drive 128GB/ 256GB , chuẩn 3.1 , tốc độ đọc 400MB/s, tương thích PC/ MAC - Hàng chính hãng",81.0,7711311113883,290000,350000,60000,17,8,laptop-may-vi-tinh-linh-kien
251999091,"Mực nạp đa năng KT221 (tặng kèm phễu) (hàng nhập khẩu) dùng cho hộp mực 12A, 35A, 85A, 49A, 53A, 26A, 05A, 78A, 83A",220.0,6005790657849,25000,25000,0,0,1,laptop-may-vi-tinh-linh-kien
249052944,"Hộp mực 12A (hàng nhập khẩu) dùng cho máy in Canon LBP 2900, 3000 - HP Laserjet 1020, 1022, MF4320d, MF4350d - Cartridge Q2612A",150.0,7278525527715,130000,130000,0,0,5,laptop-may-vi-tinh-linh-kien
196562378,"Bộ lưu điện UPS PROLiNK PRO1501SFCU (1500VA) công suất 900W, tích hợp bộ AVR, sạc siêu nhanh, dùng cho PC, Camera, Wifi - Hàng chính hãng",39.0,3998277857585,2929000,2929000,0,0,13,laptop-may-vi-tinh-linh-kien
192549132,Ổ Cứng Transcend SSD 220S 2.5inch Hàng Chính Hãng,2.0,7458631629922,600000,600000,0,0,0,laptop-may-vi-tinh-linh-kien
192208694,Ổ Cứng Di Động WD My Passport Hàng Chính Hãng,131.0,5735055845850,1870000,2220000,350000,16,24,laptop-may-vi-tinh-linh-kien
174029994,USB Kingston 64GB DataTraveler Exodia(DTX/64GB) - Hàng chính hãng,162.0,6692827442616,115000,115000,0,0,9,laptop-may-vi-tinh-linh-kien
127668958,Bộ Chia Tín Hiệu Switch Để Bàn TP-Link LS1005G 5 Cổng 10/100/1000Mbps - Hàng Chính Hãng,82.0,6000895419610,255000,255000,0,0,7,laptop-may-vi-tinh-linh-kien
119326682,Ổ cứng SSD KingSpec P4 120GB - Hàng Chính Hãng,450.0,2236739650861,438000,438000,0,0,120,laptop-may-vi-tinh-linh-kien
108843366,Tp-Link MR100 | Router Wi-Fi 4G LTE Chuẩn N Tốc Độ 300 Mbps | Hàng Chính Hãng,48.0,9674756902914,795000,795000,0,0,13,laptop-may-vi-tinh-linh-kien
74561265,Hộp Đựng Ổ Cứng  Di Động HDD Box 2.5 VINETTEAM USB 3.0 Nhựa Trong Suốt Tốc Độ 5gbs-3297-Hàng Chính Hãng,25.0,4182667499147,157940,157940,0,0,2,laptop-may-vi-tinh-linh-kien
74457280,"Hộp mực 85A / 35A (hàng nhập khẩu) dùng cho máy in HP Laser P1005, 1006, 1102 và Canon LBP 6000, MF3010, 6030 - Cartridge CB435A / CE285A  mới 100%",88.0,6761503055839,130000,130000,0,0,2,laptop-may-vi-tinh-linh-kien
58669073,"Hộp mực Brother TN2385 dùng cho máy in HL-L2321D, HL-2361DN, HL-2366DW, DCP-L2520D, MFC-L2701D, MFC-L2701DW - Hàng Chính Hãng",374.0,3655107160910,505000,505000,0,0,50,laptop-may-vi-tinh-linh-kien
54021947,Thiết Bị Kích Sóng Wifi Xiaomi Pro Hàng Chính Hãng,45.0,1950754314498,290000,290000,0,0,10,laptop-may-vi-tinh-linh-kien
24801234,Ổ cứng SSD 256GB Lexar NS100 2.5-Inch SATA III - Hàng Chính Hãng,46.0,8225415420942,495000,495000,0,0,7,laptop-may-vi-tinh-linh-kien
24415948,"Máy Tính Đồng Bộ DELL OPTIPLEX 7010 (Intel i5, Ram 4Gb, SSD 240Gb) - Hàng nhập khẩu",15.0,7165645713814,2550000,2550000,0,0,4,laptop-may-vi-tinh-linh-kien
16770500,Đĩa DVD Maxell( lốc 50 chiếc) Hàng nhập khẩu,87.0,7269066579919,239600,239600,0,0,15,laptop-may-vi-tinh-linh-kien
8114283,Máy Scan Canon Lide 400 - Hàng Chính Hãng,279.0,7777816996737,2860000,3490000,630000,18,59,laptop-may-vi-tinh-linh-kien
6964171,Hộp Mực Máy In Hp 85a,115.0,2301321653875,117500,117500,0,0,11,laptop-may-vi-tinh-linh-kien
3717809,"Bộ 4 Màu Mực in phun Thuận Phong TP50 (500ml) dùng cho máy in phun Epson, HP, Canon - Hàng Chính Hãng",101.0,8713239226722,420000,420000,0,0,16,laptop-may-vi-tinh-linh-kien
2045801,Đầu Nối Dây Mạng Ugreen RJ45 20390 - Hàng Chính Hãng,375.0,2605107200513,52000,59000,7000,12,30,laptop-may-vi-tinh-linh-kien
618526,Ổ Cứng SSD Kingston A400 (240GB) - Hàng Chính Hãng,732.0,1401282416319,609000,609000,0,0,196,laptop-may-vi-tinh-linh-kien
459739,Brother BT5000Y Ink Cho DCP-T300/T700W/MFC-T800W (Vàng) - Hàng Chính Hãng,392.0,8503597923827,145000,145000,0,0,32,laptop-may-vi-tinh-linh-kien
416914,TP-Link  TL-WN821N - USB Wifi Chuẩn N Tốc Độ 300Mbps - Hàng Chính Hãng,2869.0,7503418720735,179000,195000,16000,8,363,laptop-may-vi-tinh-linh-kien
277497700,"Brother TN-2385 Toner Mực Cho Máy In HL-L2321D, HL-2361DN, HL-2366DW, MFC-L2701D, MFC-L2701DW - Hàng Chính Hãng",456.0,6586998937658,545000,550000,5000,1,89,laptop-may-vi-tinh-linh-kien
276081880,"HCM- COMBO 4 màu Mực in màu Epson 003 70ml dùng cho máy in  L1110/ L3110/ L3150/ L5190/ L1216/ L1210/ L3216/ L3210/ L3250/ L3256/ L5290, hàng nhập khẩu.",21.0,3081425192692,280000,280000,0,0,1,laptop-may-vi-tinh-linh-kien
276073868,Mực in Epson 003 dành cho máy in Màu Epson L1110/ L3110/ L1250/ L1210,15.0,2733621825535,40000,40000,0,0,1,laptop-may-vi-tinh-linh-kien
275962594,"Mực máy in HP P1102/1102w ( 85A) Dành cho Canon LBP 3050, 3100, 3150, 6000, 6030, 6030W, MF 3010…Hàng chính hãng Alpha Cartridge",14.0,3310993469691,121000,121000,0,0,0,laptop-may-vi-tinh-linh-kien
275752039,Lẫy tách giấy sấy 5002 cải tiến: Dùng cho máy photocopy Ricoh 4000/ 5000/ 4001/ 5001/ 4002/ 5002/ 5003 ( HA - Hàng nhập khẩu ),2.0,7462697603582,300000,300000,0,0,0,laptop-may-vi-tinh-linh-kien
275738405,"Hộp mực 11A (Q6511A) AZ dùng cho Máy in HP 2400 / 2410 / 2420 , Canon 3410 / 3460... 6K -  hàng chính hãng",2.0,2279865726746,418000,418000,0,0,0,laptop-may-vi-tinh-linh-kien
275513377,"Hộp mực 248A cho máy in HP M15a, M15w, M28a, M28w - Hàng nhập khẩu",13.0,5055596703418,160000,175000,15000,9,1,laptop-may-vi-tinh-linh-kien
275500404,Hộp mực in 119A (có chip) cho máy in HP Color Laser 150a/150nw/178nw/179fnw - Hàng nhập khẩu,40.0,5395390677038,236000,270000,34000,13,1,laptop-may-vi-tinh-linh-kien
275401709,"Hộp mực 05A / 80A (hàng nhập khẩu) dùng cho máy in HP Pro 400 M401, M425, P2035, P2055 - Canon LBP 251DW, 252DW, MF416DW - Cartridge CE505A - CF280A",17.0,4430385862330,170000,170000,0,0,2,laptop-may-vi-tinh-linh-kien
275238650,Combo 5 Gạt nhỏ 12A Gạt từ 76A 87A 26A 49A 05A 80A 53A dành cho Canon 2900 3300 6300dn 223dw 226dw 251dw 252dw 052 057 041 303 308 315 319 FX9 FX10 HP 1010 1020 2035 2055 1320 PRO 400 M401 Hàng chính hãng Alpha Cartridge,4.0,3190296532213,34000,34000,0,0,1,laptop-may-vi-tinh-linh-kien
275195651,Máy Tính Siêu Nhỏ Ultra Mini T9 PLUS - Intel thế hệ 12 Alder Lake N100 - Hỗ Trợ Xuất Hình 4K 60hz hàng nhập khẩu,10.0,7855214860204,4195000,4195000,0,0,2,laptop-may-vi-tinh-linh-kien
275171067,Hộp mực in 26A cho máy in HP M402d/ M402dn/ M426fdn/ M426fdw Hàng chính hãng Alpha Cartridge,17.0,4517796129019,188000,188000,0,0,0,laptop-may-vi-tinh-linh-kien
274928980,"Hộp mực Prospect 12A/303/FX9 dùng cho máy in Canon LBP 2900, MF 4320d, 4350d, 4380dn Hp 1020, 1022 hàng chính hãng",8.0,4942147193893,137500,137500,0,0,1,laptop-may-vi-tinh-linh-kien
274928358,"Hộp Mực TN2385 Prospect dùng cho máy in Brother HL L2321D, 2361DN, 2366DW, L2520D, L2701DW in 2600 trang, hàng chính hãng",15.0,3888887501369,137500,137500,0,0,2,laptop-may-vi-tinh-linh-kien
274036353,"Soundcard V8S PRO kết nối bluetooth có autotune dành cho mic thu âm, livestream - hàng chính hãng",20.0,7682220138705,157940,157940,0,0,2,laptop-may-vi-tinh-linh-kien
273891148,Hộp box SSD Lexar E100 | gắn SSD 2.5 inch dung lượng 128G - 8TB | Giao tiếp USB 3.2 Gen 1 - Bảo hành 1 năm - Hàng Chính Hãng,18.0,3910740467903,139000,139000,0,0,3,laptop-may-vi-tinh-linh-kien
273747303,Laptop Giá Rẻ Dell Vostro V3591 i3 1005G1/8GB/256GB/Intel UHD Graphics/Win 10  Hàng Chính Hãng,5.0,1075708560393,4900000,4900000,0,0,1,laptop-may-vi-tinh-linh-kien
273002756,Laptop Dell Latitude 3590  Core i5 7200U- Ram 8GB- 128GB SSD Ổ cứng -Màn hình 15-6 inch BH 6 thang - Hàng chính hãng,10.0,9255190204530,5390000,5390000,0,0,4,laptop-may-vi-tinh-linh-kien
272355716,[Hàng mới về] Tenda Bộ phát Wifi 2.4Ghz di động dùng sim 4G LTE 4G05 - Hàng chính hãng,5.0,6805176535203,739900,739900,0,0,0,laptop-may-vi-tinh-linh-kien
271118991,Quạt tản nhiệt điện thoại Sò Lạnh Memo CXA3 - Quạt hạ nhiệt có đèn LED Gaming và nam châm từ tính siêu mạnh - Hàng nhập khẩu,8.0,5357934099702,169000,300000,131000,44,3,laptop-may-vi-tinh-linh-kien
252156968,Phần mềm diệt Virus Bkav Pro - Hàng chính hãng,84.0,7101627775082,169000,169000,0,0,2,laptop-may-vi-tinh-linh-kien
214495467,Đầu bấm mạng RJ45 Cat6 Ugreen 50962 (Hộp 50 cái) - Hàng chính hãng,12.0,9031845465126,119000,128000,9000,7,1,laptop-may-vi-tinh-linh-kien
214160066,Ổ Cứng SSD Samsung 990 Pro 1TB / 2TB M2 PCIe Gen 4.0 x 4 - Hàng Nhập Khẩu,61.0,3195543555548,5170000,5170000,0,0,14,laptop-may-vi-tinh-linh-kien
194102606,Hộp mực máy in HP M130a / M130fn / M130fw / M130nw (hàng nhập khẩu) - Cartridge CF217A - 17A mới 100% [Full Box],32.0,6924084140621,125000,125000,0,0,4,laptop-may-vi-tinh-linh-kien
188040084,USB Kingston DataTraveler Exodia M USB Flash Drive 32G / 64G / 128G / 256G - Hàng Chính Hãng,249.0,6844617541382,199000,199000,0,0,31,laptop-may-vi-tinh-linh-kien
157504855,Bộ Phát Wifi TP-Link Archer AX53 Chuẩn Wifi 6 Tốc Độ 3000Mbps - Hàng Chính Hãng,7.0,2041706152773,1200000,2999000,1799000,60,2,laptop-may-vi-tinh-linh-kien
136032838,Bộ Mở Rộng Sóng Wifi TP-Link RE505X Chuẩn AX1500 - Hàng Chính Hãng,12.0,4046045539269,795000,795000,0,0,2,laptop-may-vi-tinh-linh-kien
122095199,"Bộ Mic Hát Livestream Soundcard XOX K10 2020 & Mic ISK AT100 Chất Lượng Cao, Âm Thanh Cực Kỳ Sống Động - Hàng Chính Hãng",10.0,9506953622357,1569000,1569000,0,0,4,laptop-may-vi-tinh-linh-kien
121242845,Hộp ổ cứng M.2 SSD USB 3.1 Gen 1 ORICO M2PF-C3-BK - Đen - Hàng chính hãng,31.0,5236944534914,248880,290000,41120,14,8,laptop-may-vi-tinh-linh-kien
80799408,Ổ Cứng SSD Samsung 870 Evo 500GB 2.5-Inch SATA III - Hàng Nhập Khẩu (Box Anh),291.0,3295612130721,1450000,1450000,0,0,72,laptop-may-vi-tinh-linh-kien
57043010,Keo tản nhiệt VSPTECH MX-4 (4g) - lk1984 - hàng nhập khẩu,3.0,9905121509115,84900,84900,0,0,1,laptop-may-vi-tinh-linh-kien
42561568,Hộp Mực In Premium 26A (HP CF226A)/ Cartridge 052 - Hàng Nhập Khẩu,206.0,1458732253543,179000,179000,0,0,11,laptop-may-vi-tinh-linh-kien
27609946,Ổ cứng SSD 128GB Lexar NS100 2.5-Inch SATA III_Hàng chính hãng,83.0,5713101027702,355000,355000,0,0,10,laptop-may-vi-tinh-linh-kien
11594750,Hộp Mực In 35A-247Min dùng cho dòng máy in HP 1006/1006/CANON 3050/3100,35.0,4808954901925,117500,117500,0,0,4,laptop-may-vi-tinh-linh-kien
3598689,USB Team Group INC C143 64GB – USB 3.0 - Hàng Chính Hãng,19.0,3778390907106,219000,219000,0,0,2,laptop-may-vi-tinh-linh-kien
802598,Mini PC Intel NUC NUC6CAYH - Celeron J3455 - Hàng Chính Hãng,13.0,2709879679956,2400000,2400000,0,0,8,laptop-may-vi-tinh-linh-kien
754249,Bộ Kích Sóng Wifi Repeater Mercusys MW300RE 300Mbps - Hàng Chính Hãng,26.0,7500518341020,255000,255000,0,0,6,laptop-may-vi-tinh-linh-kien
561953,Kaspersky Internet Security Cho 5 Máy Tính - KIS5U - Hàng chính hãng,1603.0,2890911335531,855000,1020800,165800,16,192,laptop-may-vi-tinh-linh-kien
481625,Máy In Đa Năng Canon MF3010 Scan Copy - Hàng chính hãng,243.0,8506950212521,4910000,5790000,880000,15,46,laptop-may-vi-tinh-linh-kien
456506,TP-Link TL-SF1005D - Bộ Chia Tín Hiệu Để Bàn 5 cổng 10/100Mbps - Hàng Chính Hãng,1937.0,7509586864301,134000,217100,83100,38,236,laptop-may-vi-tinh-linh-kien
277313182,Màn Hình Viewsonic VX2758A-2K-PRO-2 27inch 2K 185Hz QHD - Hàng Chính Hãng,2.0,8975359939200,4890000,5999000,1109000,18,0,laptop-may-vi-tinh-linh-kien
277284675,Màn Hình Viewsonic VA2732A-H 120Hz 27inch Full HD IPS - Hàng Chính Hãng,5.0,9687985409036,2500000,3590000,1090000,30,1,laptop-may-vi-tinh-linh-kien
276985137,Phần Mềm Diệt Virus BKAV Profressional Internet Security 1 PC 3 Tháng - QUÀ TẶNG BKAV - Hàng chính hãng,20.0,2449175820193,165000,165000,0,0,0,laptop-may-vi-tinh-linh-kien
276944901,Máy in nhãn nhiệt cầm tay Mini Máy in bỏ túi Bluetooth không dây Android IOS Điện thoại Máy in ảnh Máy tạo nhãn - Hàng Nhập Khẩu,12.0,4770563518375,193000,195000,2000,1,2,laptop-may-vi-tinh-linh-kien
276552162," 100 Cuộn Giấy In Hóa Đơn K57 Phi 38, K57 Phi 45, K80 phi 45 Cho Máy In Nhiệt tùy chọn - Hàng chính hãng",22.0,6971351232071,399000,399000,0,0,0,laptop-may-vi-tinh-linh-kien
276174461,Máy In HP Laser 108W (4ZB80A) - Hàng Chính Hãng,7.0,5382387582134,3370000,3690000,320000,9,1,laptop-may-vi-tinh-linh-kien
275715364,SOAIY Usb sound card 7.1CH - Usb sound card 7.1 âm thanh 3D cao cấp - Hàng Nhập Khẩu,2.0,5845622184771,95000,95000,0,0,0,laptop-may-vi-tinh-linh-kien
275459017,"Cục phát wifi từ sim 4G 5G kèm pin 10.000mA TP10000 phát liên tục 24 tiếng, tốc độ cao 300Mbps kết nối cho 10 thiết bị vô cùng tiện lợi - hàng nhập khẩu",7.0,6340460548900,565000,999000,434000,43,1,laptop-may-vi-tinh-linh-kien
275281459,Ổ cứng di động SSD Transcend 512GB/1TB/2TB ESD330C USB 10Gbps type C – Hàng Chính Hãng,1.0,4749452346220,1600000,1600000,0,0,1,laptop-may-vi-tinh-linh-kien
273688489,"USB FIRO Jump Drive Dual Drive F29 Type-C / Type-A - USB 3.1 32GB / 64GB, Tốc Độ Đọc 130Mb/s, Tương Thích MAC / PC - Hàng Chính Hãng",175.0,3807601304771,225000,430000,205000,48,32,laptop-may-vi-tinh-linh-kien
273395255,Avast Premium Security (For 1 PC – 1 year)- Hàng chính hãng ,293.0,5619455831634,155000,155000,0,0,67,laptop-may-vi-tinh-linh-kien
273271980,Màn Hình Máy Tính Full Viền HIKVISION 22 / 24 / 27 inch Full HD 1080P - Hàng Chính Hãng,13.0,9920967778529,1455000,1455000,0,0,3,laptop-may-vi-tinh-linh-kien
262887614,Bộ Phát Router WiFi 6 TP-Link Archer AX12 Băng Tần Kép AX1500 - Hàng Chính Hãng,16.0,1378878254122,695000,695000,0,0,2,laptop-may-vi-tinh-linh-kien
253721467,"Bộ kích sóng wifi 4 râu Vinetteam tốc độ 300mbps/ 1200mbps 2 cổng RJ45 ăng ten phát xuyên tường cắm trực tiếp dùng cho điện thoại, laptop, máy tính, PC - hàng chính hãng",83.0,7983626204079,157940,157940,0,0,13,laptop-may-vi-tinh-linh-kien
252587229,MÀN HÌNH CONG FULL VIỀN K-vison 24 inch -MÀU TRẮNG -  FUll HD 1920x1080 - Chống Lóa - Tần số 75Hz - Hàng Chính Hãng,8.0,5950147009245,1898000,1898000,0,0,2,laptop-may-vi-tinh-linh-kien
247024105, Ổ cứng SSD 512GB Lexar NS100 2.5-Inch SATA III_Hàng chính hãng,13.0,1653534270468,398000,400000,2000,1,4,laptop-may-vi-tinh-linh-kien
207937066,Ổ cứng di động WD My Passport New USB 3.2 1TB/2TB/4TB/5TB Hàng Chính Hãng,54.0,9480837973572,2590000,2990000,400000,13,10,laptop-may-vi-tinh-linh-kien
203211116,(Giá Hủy Diệt) Ổ cứng gắn trong HDD Western Digital Ultrastar 3.5 inch Sata 3 cho Serve dòng Enterprise - Hàng Nhập Khẩu,294.0,6685533854497,4380000,5256000,876000,17,89,laptop-may-vi-tinh-linh-kien
200815573,Phần mềm Microsoft 365 Personal | 1 User | 1TB | 365 ngày – Hàng chính hãng,157.0,8257253453622,1690000,1900000,210000,11,36,laptop-may-vi-tinh-linh-kien
192548075,Ổ cứng SSD Transcend 820S M2 Hàng Chính Hãng,3.0,9710152032560,600000,600000,0,0,0,laptop-may-vi-tinh-linh-kien
182095566,"Màn Hình Không Viền HIKVISION DS-D5022FN-C 21.5"" FHD 60Hz - Hàng Chính Hãng",1.0,3143053249239,1690000,1690000,0,0,0,laptop-may-vi-tinh-linh-kien
179550020,"Ổ Cứng SSD WD Green Sata 6Gb/s ( 2.5 Inch , 7mm cased ) - Hàng Chính Hãng",197.0,5086723048910,430000,430000,0,0,25,laptop-may-vi-tinh-linh-kien
94173532,Màn hình LCD LG 24QP500-B 23.8 inch IPS 2K QHD - Hàng Chính Hãng,14.0,2886329568067,4379000,4550000,171000,4,4,laptop-may-vi-tinh-linh-kien
76283023,(Giá Hủy Diệt) Ổ Cứng gắn trong SSD Samsung 870 EVO 2.5 inch sata III - Hàng Nhập Khẩu,1055.0,3349850572129,1480000,1848000,368000,20,361,laptop-may-vi-tinh-linh-kien
72680847,Bộ mực in phun Brother (BT-D60BK + BT5000C/M/Y),136.0,1612372627779,628000,628000,0,0,19,laptop-may-vi-tinh-linh-kien
66566653,Mực nạp ( mực đổ ) cho hộp mực 12A/ 49A/ 05A Canon 2900/ 3300/ HP 1010/1020...,239.0,7182435125879,35000,35000,0,0,19,laptop-may-vi-tinh-linh-kien
42561566,Hộp Mực In Premium 17A - Hàng Nhập Khẩu,56.0,2194933687181,142000,142000,0,0,5,laptop-may-vi-tinh-linh-kien
21198038,Hộp Ổ Cứng 3.5 Và 2.5 SATA 3 USB 3.0 USB ORICO 3588US3 - Hàng Nhập Khẩu,12.0,6336358176383,385000,385000,0,0,3,laptop-may-vi-tinh-linh-kien
16880726,RAM Laptop Kingston 8GB DDR4 (PC4) 2666MHz KVR26S19S8/8 - Hàng Chính Hãng,12.0,8336308911055,820000,820000,0,0,1,laptop-may-vi-tinh-linh-kien
15507113,Main Asus H110M-K Hàng Chính Hãng,20.0,4807954861680,1500000,1500000,0,0,6,laptop-may-vi-tinh-linh-kien
11251768,Bộ Switch 16 cổng Gigabit chia mạng LAN TPLink TL-SG1016D - Hàng Chính Hãng ,19.0,8279273861607,1299000,1299000,0,0,2,laptop-may-vi-tinh-linh-kien
10001382,RAM Laptop Samsung 4GB DDR3L bus 1600 - Hàng Nhập Khẩu,2531.0,9836923467665,220000,264000,44000,17,595,laptop-may-vi-tinh-linh-kien
2901371,Máy In Phun Màu Canon Pixma G1010 - Hàng Chính Hãng,1250.0,8090133519212,2970000,3520000,550000,16,216,laptop-may-vi-tinh-linh-kien
1822419,Dây Cáp Mạng Orico PUG-C6-100 CAT6 10m - Hàng Chính Hãng,109.0,4484558117612,100000,100000,0,0,3,laptop-may-vi-tinh-linh-kien
561984,Kaspersky Anti Virus Cho 3 Máy Tính - KAV3U - Hàng chính hãng,54.0,2893365938556,348000,350000,2000,1,6,laptop-may-vi-tinh-linh-kien
476063,USB Team E902 32GB - Hàng Chính Hãng,52.0,6100513322386,89000,160000,71000,44,0,laptop-may-vi-tinh-linh-kien
456525,Bộ Chuyển Đổi USB Wifi TP-Link Archer T4U Băng Tần Kép MU-MIMO AC1300 - Hàng Chính Hãng,187.0,7502968321775,455000,455000,0,0,59,laptop-may-vi-tinh-linh-kien
452118,Ổ cứng Di Động Transcend StoreJet H3B 1TB USB 3.0/3.1 - TS1TSJ25H3B - Hàng Chính Hãng,33.0,6200163191452,1979000,1999000,20000,1,5,laptop-may-vi-tinh-linh-kien
447634,USB SanDisk 3.0 Ultra CZ48 32GB - Hàng Chính Hãng,103.0,6102985933084,159000,169000,10000,6,3,laptop-may-vi-tinh-linh-kien
275181298,"Giày thể thao nam, giày chạy bộ đế êm nhẹ, thoáng khí đế cao su đúc, chống trơn trượt hạn chế mòn  – GNA2024",48.0,7822013374711,307000,760000,453000,60,14,giay-dep-nam
276345718,"Giày thể thao nam, giày chạy bộ đế êm nhẹ, thoáng khí đế cao su đúc, chống trơn trượt hạn chế mòn  – GNA2025B",17.0,9443748795737,390000,780000,390000,50,6,giay-dep-nam
134773001,Giày lười da nam công sở Bụi Leather G107 - Da bò Nappa cao cấp,252.0,9988332007509,579000,827000,248000,30,91,giay-dep-nam
276182413,"Giày thể thao nam, giày chạy bộ đế êm nhẹ, thoáng khí đế cao su đúc, chống trơn trượt hạn chế mòn – BEE GEE – GNA1022",5.0,3125439194000,432000,960000,528000,55,2,giay-dep-nam
207277686,Giày thể thao nam phong cách mới – GNA1004C,27.0,2633642320944,513000,1140000,627000,55,6,giay-dep-nam
277735465,"Dép Sandal Nam, Dép Quai Hậu 2 Quai Dán Mã DP36",35.0,3373042679448,209000,418000,209000,50,3,giay-dep-nam
277512483,Dép Cross Nam Hàng Cao Cấp - DNA9022,4.0,1194262653522,300000,600000,300000,50,3,giay-dep-nam
276357225,Giày Thể Thao Nam Biti’s Hunter X LiteDash - Original Edition 2K24 ​ HSM007501KEM (Kem),6.0,9970014708433,802000,1050000,248000,24,1,giay-dep-nam
276089082,Dép quai ngang Nam/ Nữ Vento CAMEO dạo phố đi chơi du lịch SL12008,3.0,7354100579294,345000,345000,0,0,0,giay-dep-nam
277620155,Giày Sandal nam cao cấp kiểu dáng mới – GSDNA11,0.0,8041795389241,682000,1364000,682000,50,0,giay-dep-nam
276181491,"Giày thể thao nam đế êm nhẹ, thoáng khí đế cao su đúc, chống trơn trượt hạn chế mòn – BEE GEE - GNA2026",2.0,6725869772684,378000,840000,462000,55,0,giay-dep-nam
134744983,"Giày da nam, giày oxford công sở Bụi Leather G104 - Da bò Nappa cao cấp - Bảo hành 12 tháng",140.0,8018001962778,589000,840000,251000,30,58,giay-dep-nam
134757898,"Giày da nam, giày oxford công sở Bụi Leather G106 - Da bò Nappa cao cấp - Bảo hành 12 tháng",70.0,8004435866847,605000,865000,260000,30,31,giay-dep-nam
275910150,COMBO 2 Muỗng Xỏ Giày 001 Đón Gót Giày Cho Mọi Tư Thế Cho Giày Nam & Nữ Dụng Cụ Mang Giày/ Móc Chìa Khoá Tăng Tuổi Thọ Của Giày - Giao Màu Ngẫu Nhiên,10.0,5954260671221,100000,100000,0,0,1,giay-dep-nam
275889745,Keo Dán Giày Nhiệt Trong Suốt Siêu Dính Dùng Không Tổn Thương Da,0.0,5189920326319,100000,100000,0,0,1,giay-dep-nam
275772801,Sandal Bitis nam đế cao 5cm  (38-43),0.0,9403838106370,417000,417000,0,0,4,giay-dep-nam
275288309,"Xi Kem Đồ Da Italy Polish Cream For Leather Shoes 100ML (Chăm Sóc Bảo Dưỡng Giày Da, Đồ Da)",2.0,9879658237338,120000,120000,0,0,1,giay-dep-nam
275252528,"Dép tổ ong VAC nhựa EVA siêu bền, siêu nhẹ, chống trơn trượt, đế dày (FORM LỚN ĐẶT LÙI 1-2 SIZE) Dép Nam Nữ Nhiều Màu Sắc",22.0,7934441920650,63000,85000,22000,26,2,giay-dep-nam
276229384,"Giày thể thao nam đế êm nhẹ, thoáng khí đế cao su đúc, chống trơn trượt hạn chế mòn – BEE GEE - GNA1002",3.0,7930156253555,513000,1180000,667000,57,1,giay-dep-nam
217506888,Giày Mọi Nam Da Bò Thật TiTi ĐÔ Cao Cấp GM2066d,0.0,9451755426003,468000,748000,280000,37,0,giay-dep-nam
134754200,"Giày da nam, giày oxford công sở Bụi Leather G105 - Da bò Nappa cao cấp",86.0,5283790699583,569000,569000,0,0,31,giay-dep-nam
112188948,Dép Nam Quai Ngang HÀ NAM Da Bò Thật Cao Cấp DNA2074,56.0,3582462364405,268000,299000,31000,10,21,giay-dep-nam
277387765,"Giày thể thao nam đế êm nhẹ, thoáng khí đế cao su đúc, chống trơn trượt hạn chế mòn – BEE GEE - GNA2016A",0.0,2210288409844,520000,1040000,520000,50,0,giay-dep-nam
275021642,"Giày Sport Trekking Leo Núi, Giày Phượt, Giày Đi Bộ Dã Ngoại Siêu Nhẹ Màu Xanh Dương (Xanh Mực)",33.0,3882988156091,119000,119000,0,0,4,giay-dep-nam
275021490,"Giày Sport Trekking, Giày Leo Núi, Giày Phượt, Giày Đi Bộ Dã Ngoại Siêu Nhẹ",17.0,4937308090382,119000,119000,0,0,4,giay-dep-nam
274804274,"Dép tổ ong [Size 31-34] KÈM STICKER NGẪU NHIÊN vật liệu EVA cao cấp siêu bền, siêu nhẹ, chống trơn trượt",5.0,3232640126309,60000,100000,40000,40,0,giay-dep-nam
273645778,Lót Giày Thể Thao PU Dày Chống Sốc Và Khử Mùi Tốt L815 Sportslink,28.0,8409994649672,29000,38000,9000,24,3,giay-dep-nam
273466355,"Dép xỏ ngón nam, nữ đúc liền khối siêu nhẹ DUWA - Hàng chính hãng - TK288",34.0,5046535450980,64500,129000,64500,50,8,giay-dep-nam
273280942,Lót giày thể thao PU chống sốc và khử mùi hiệu quả L802,29.0,6898178948733,28000,37000,9000,24,0,giay-dep-nam
272302803,"Keo dán giày thể thao, keo dán đa năng, keo dán giày dép siêu chắc trong suốt 45ml - Hàng Chính Hãng",71.0,1775914805886,15000,15000,0,0,5,giay-dep-nam
271307623,"Dép tổ ong asia cao cấp mới, siêu nhẹ, cực bền, chống trơn và rất thời trang (38-44)",138.0,8474597528955,64000,80000,16000,20,16,giay-dep-nam
252917371,"Bình xịt khử mùi hôi của giày, lưu hương thơm công nghệ Bạc ion, kháng khuẩn XIMO 300ml",31.0,1319082224345,65000,65000,0,0,1,giay-dep-nam
217564040,"Giày thể thao nam Asia, đế kếp, bền, rẻ, dùng cho lao động và thể thao size 36-44",180.0,4731819430766,168000,200000,32000,16,40,giay-dep-nam
214504425,Chai Xịt Tạo Bọt Vệ Sinh Giày XIMO Cao Cấp 300ml XVSG02,280.0,6200170504012,65000,65000,0,0,25,giay-dep-nam
186677573,Dép Quai Ngang Nam Đúc Liền Quick Cao Cấp DP15,521.0,2189576010745,169000,338000,169000,50,108,giay-dep-nam
176037613,Dép Nam Cao Cấp Hai Quai Thời Trang KEEDO KD0505,43.0,6854185517140,290000,290000,0,0,11,giay-dep-nam
163806087,Keo Dán Giày Nhiệt XIMO Trong Suốt Siêu Dính Dùng Không Tổn Thương Da,348.0,5475862158530,31000,31000,0,0,31,giay-dep-nam
133234738,Dép nhựa đúc nam quai ngang Thái Lan Adda 5TD12,180.0,4866177548694,165000,165000,0,0,56,giay-dep-nam
125732767,"Xi đánh giày dạng sáp Star Wax Shoe, làm mềm, làm bóng, bảo vệ và gìn giữ da (48ml)-Nhập khẩu chính hãng Yuppies",62.0,8440040550495,30000,40000,10000,25,9,giay-dep-nam
115852451,"Chai vệ sinh giày đồ da, túi ví, áo, ghế da giúp làm sạch, dưỡng ẩm chống mốc XIMO XI03",3.0,2296020061430,66000,66000,0,0,0,giay-dep-nam
112019828,"Lót giày 4D đệm êm vòm ngang lòng bàn chân và các ngón chân, chống trượt bàn chân về phía trước - buybox - BBPK181",150.0,3220551622700,35000,35000,0,0,17,giay-dep-nam
108996138,"Dép sức khoẻ nam Spenco Fusion Slide Black - Dép quai ngang mềm giảm đau chân, không thấm nước 244",9.0,4190886124528,1495000,1495000,0,0,4,giay-dep-nam
107802069,Keo Dán Giày Nhiệt XIMO Trong Suốt Siêu Dính Dùng Không Tổn Thương Da XKDG06,901.0,6093400569872,32000,32000,0,0,58,giay-dep-nam
48226182,GIày Sandal Nam Da Bò BIGGBEN Cao Cấp SD96,24.0,7089484832577,369000,500000,131000,26,7,giay-dep-nam
43035743,Lót giày tổ ong độn đế tăng chiều cao buybox BBPK57,1437.0,8885502044293,67500,67500,0,0,199,giay-dep-nam
41077713,Lót giày vải cotton viền đen Hương Quế CI-13 làm từ vải cotton - bột quế giúp hút ẩm - khử mùi - phòng cảm cúm và cải thiện sức khoẻ,477.0,6087072384867,25000,25000,0,0,36,giay-dep-nam
27769036,Dép Nam BIGGBEN Da Bò Thật Cao Cấp DN209,348.0,3005173886847,299000,350000,51000,15,120,giay-dep-nam
27769016,Dép Nam BIGGBEN Da Bò Thật Cao Cấp DN208,107.0,2068688901550,299000,400000,101000,25,32,giay-dep-nam
26666649,Dép Nam BIGGBEN Da Bò Thật Cao Cấp DN196,110.0,6867741208980,299000,400000,101000,25,29,giay-dep-nam
22956625,Dép Nam BIGGBEN Da Bò Thật Cao Cấp DN182,30.0,3894672364266,299000,400000,101000,25,11,giay-dep-nam
6579831,Dép Nam Bảng Ngang BIGGBEN Da Bò Thật DN61,348.0,4185497177827,319000,350000,31000,9,96,giay-dep-nam
6187285,Dép Nam BIGGBEN May Đế  Da Bò Thật DN40,72.0,2350646994880,339000,400000,61000,15,18,giay-dep-nam
272939069,"Giày sục nam da bò dập vân cá sấu Trường Hải 2 vàng, đen SN160 CÓ SIZE LỚN",11.0,3027957118438,450000,450000,0,0,2,giay-dep-nam
54051384,Dép nam quai ngang Trường Hải một bản da bò thật đế kếp mềm dẻo không trơn QN0421,10.0,8383519265927,196000,196000,0,0,2,giay-dep-nam
277860431,Sandal Biti's đế cao nam (39-43),1.0,8412131530434,400000,400000,0,0,0,giay-dep-nam
277532614,Dép quai kẹp Biti's nam (39-43),1.0,2168266070624,320000,320000,0,0,0,giay-dep-nam
276561845,Giày thể thao Bitis hunter nam (40-45),4.0,4430111105438,869000,869000,0,0,1,giay-dep-nam
276357367,Giày Thể Thao Nam Biti’s Hunter X LiteDash - Festive Edition 2K24: Lush Beige ​HSM007506KEL (Kem lợt),2.0,6661501787396,802000,1050000,248000,24,0,giay-dep-nam
276357015,Sandals Thể Thao Nam Biti’s Hunter X Dune – Festive Edition 2K24​ HEM001300TRG (Trắng),6.0,2545822370092,549000,549000,0,0,3,giay-dep-nam
134777245,Giày lười da tăng chiều cao nam Bụi Leather G111 - Da bò Nappa cao cấp - Bảo hành 12 tháng,142.0,6197630263734,569000,812000,243000,30,58,giay-dep-nam
276195548,DÉP NAM TRUNG NIÊN DA BÒ VATIS 2009,1.0,8856548067655,150000,299000,149000,50,1,giay-dep-nam
276021112,Giày Vải Sneaker Canvas Đế Bằng Nam DC30 Beige Dincox Shoes,4.0,4968927048257,449000,510000,61000,12,1,giay-dep-nam
275836243,Giày thể thao Bitis nam (39-44),1.0,6927388827060,435000,435000,0,0,1,giay-dep-nam
275276334,"Dép tổ ong XÁM nhựa EVA siêu bền, siêu nhẹ, chống trơn trượt, đế dày (FORM LỚN ĐẶT LÙI 1-2 SIZE) Dép Nam Nữ Nhiều Màu Sắc",54.0,6758301367399,63000,85000,22000,26,4,giay-dep-nam
274992671,"Giày thể thao nam, giày chạy bộ đế êm nhẹ, thoáng khí đế cao su đúc, chống trơn trượt hạn chế mòn – BEE GEE – GNA2023",7.0,2590186453181,936000,1040000,104000,10,0,giay-dep-nam
191690638,Giày lười da nam công sở Bụi Leather G120 - Da bò Nappa cao cấp - Bảo hành 12 tháng,70.0,9182188955783,595000,840000,245000,29,15,giay-dep-nam
274922764,Giày Sneaker da bò màu trắng SIGOURNEY giày thể thao nam TT-001 bảo hành 18 tháng,3.0,1746571020721,595000,595000,0,0,3,giay-dep-nam
271200225,Dép da nam quai ngang da bò cao cấp KEEDO TN-S3-34,4.0,1062259884488,380000,380000,0,0,0,giay-dep-nam
270122349,"Lót giày thể thao nam nữ Genky Sport 7 lớp, tăng 2cm chiều cao, chống sốc, thấm mồ hôi và khử mùi, nâng vòm bàn chân",43.0,1018719873851,230000,230000,0,0,5,giay-dep-nam
252920270,"Keo Dán Giày Nhiệt Super Glue XIMO Siêu Dính Cao Cấp, Chống Nước Tốt",25.0,6386835852206,32000,32000,0,0,2,giay-dep-nam
217275661,Dây Giày Loại Tròn Phủ Lớp Sáp Chống Nước Cao Cấp DGD2025,12.0,8336824813863,16000,30000,14000,47,1,giay-dep-nam
207643738,"Dép tông lào Thái Lan nam siêu nhẹ, siêu bền, đi mưa không ngấm nước MIXSTAR  MV1",26.0,4780770572485,60000,60000,0,0,7,giay-dep-nam
189676441,Đón Gót Giày/ Dụng Cụ Mang Giày/ Móc Chìa Khoá Chất Liệu Da Thật Lõi Thép - TMG1000101 [ Chọn Mẫu Ngẫu Nhiên Khi Giao ],104.0,4318627366871,90000,90000,0,0,9,giay-dep-nam
171536034,"Dép quai ngang nam nữ M Masler-MT màu đen sọc trắng với lớp đế chống trượt, chống nước và quai êm chân DT1",160.0,4821103926182,139000,139000,0,0,66,giay-dep-nam
170728589,Chai Xịt Tạo Bọt Vệ Sinh Giày XIMO Cao Cấp 300ml tiêu diệt mọi vết bẩn,19.0,2836489190446,60000,60000,0,0,0,giay-dep-nam
149779903,01 Đôi lót giày nam ORSIL siêu mềm mại êm chân - L1.5CM,50.0,5728317049157,54000,54000,0,0,4,giay-dep-nam
127379868,Giày Sneaker Vải Unisex DINCOX D21 Black Cách Ấn Tượng,15.0,9522080477934,470000,470000,0,0,9,giay-dep-nam
125876751,"Chai Vệ Sinh Giày Da Lộn, Túi Ví, Áo, Ghế Da Lộn Giúp Làm Sạch, Chăm Sóc, Chống Mốc Suede Clean XIMO XI06",23.0,8688563434360,65000,65000,0,0,2,giay-dep-nam
108748395,Dép Sức Khoẻ Nam Spenco Thrust Black - Dép quai ngang đệm mềm giảm đau dùng cho cả chân người tiểu đường,3.0,1734437164069,2495000,2495000,0,0,1,giay-dep-nam
100770794,Giày Sneaker Nam Buộc Dây Cao Cấp Da Thật Xuất Khẩu VN Da Bò Đế Mềm,5.0,7325091536697,590000,590000,0,0,0,giay-dep-nam
66510946,Dép Nam Da Bò BIGGBEN Cao Cấp DN262,3.0,5529879969201,359000,400000,41000,10,1,giay-dep-nam
58451856,Xịt bọt làm sạch giày Sneaker,70.0,2017772635574,56000,56000,0,0,14,giay-dep-nam
55750878,Lót giày lưới 1 lớp Hương Quế CI-05 làm từ vải lưới 1 lớp - vải cotton - bột quế giúp êm chân - ấm chân - phòng cảm cúm và cải thiên sức khỏe,85.0,9855077288759,40000,40000,0,0,9,giay-dep-nam
55715962,Lót giày lưới 2 lớp Hương Quế CI-06 làm từ vải lưới 2 lớp - vải cotton - bột quế giúp êm chân - ấm chân - phòng cảm cúm,51.0,6716208680541,40000,40000,0,0,3,giay-dep-nam
53305817,Dép Xỏ Ngón Nam Da Bò Thật BIGGBEN DK61,66.0,9483448887883,299000,350000,51000,15,26,giay-dep-nam
49278142,"Xịt khử mùi giày ngăn ngừa vi khuẩn và ngăn mùi hôi, mùi khắm giày - buybox - PKBB61",598.0,9713008991720,86000,86000,0,0,131,giay-dep-nam
48319377,Dép Nam Da Bò BIGGBEN Cao Cấp DN225,22.0,9784998163992,309000,400000,91000,23,11,giay-dep-nam
48316320,Giày Mọi Nam BIGGBEN Da Bò Thật GM223,1.0,8830570824179,590000,650000,60000,9,1,giay-dep-nam
42377512,Dép quai ngang nam GIAVY - TL484,148.0,6285026676987,230000,230000,0,0,58,giay-dep-nam
7349821,Dép Nam Doctor BIGGBEN Da Bò Thật Cao Cấp DN95,198.0,8221726150578,339000,400000,61000,15,57,giay-dep-nam
6137251,Dép Nam Bảng Ngang BIGGBEN Da Bò Thật DN37,122.0,1969891557095,329000,400000,71000,18,40,giay-dep-nam
2022619,Giày Nam Tăng Chiều Cao Huy Hoàng HT7714 - Đen,2.0,7637372429820,999000,999000,0,0,1,giay-dep-nam
276898646,"Giày thể thao nam, giày thời trang nam mẫu mới, đế cao thiết kế trẻ trung năng động",6.0,9389386393558,169000,290000,121000,42,1,giay-dep-nam
276503298,Giày Thể Thao Nam Hunter X HSM008400 Siêu Nhẹ,1.0,1109334040497,1019000,1019000,0,0,0,giay-dep-nam
276168064,"Xi Đánh Giày Sáp Shoe Polish XIMO 50ml XI08 giúp giày túi xách, ví, thắt lưng, đồ giả da sáng bóng tự nhiên, bảo dưỡng bền đẹp lâu hơn, tăng khả năng chống thấm nước hiệu quả",14.0,3225851510303,100000,100000,0,0,0,giay-dep-nam
275431635,Dép quai kẹp Bitis nam (38-43),21.0,9477257078393,60000,60000,0,0,0,giay-dep-nam
274795145,"Dép tổ ong [Size 39-43] KÈM STICKER NGẪU NHIÊN vật liệu EVA cao cấp siêu bền, siêu nhẹ, chống trơn trượt",47.0,6983423998121,68000,100000,32000,32,0,giay-dep-nam
274781566,"Dép Nam Quai Ngang, Dép Đúc Liền Nguyên Khối Mã DP105",31.0,9191837728976,139000,278000,139000,50,9,giay-dep-nam
273719456,"Khăn Giấy Ướt Lau Giày Sneaker Wipes Clean Thần Thánh (Gói 30 Miếng) Lau Giầy Siêu Sạch, Siêu Nhanh",58.0,2837822986497,12000,23000,11000,48,2,giay-dep-nam
273440178,"Giày thể thao nam chất liệu vải mềm mại, phong cách cá tính năng dộng – GNA2017",30.0,2783235215235,300000,600000,300000,50,5,giay-dep-nam
273010633,"Keo Đa Năng Dán Đế Giầy Dép Thể Thao, Sneaker, Keo 1630 Dán Giày Dép Chuyên Dụng Siêu Dính, Siêu Bền, Tiện Lợi Trong Gia Đình. TakyHome 6070",46.0,3986767104673,35000,35000,0,0,2,giay-dep-nam
250335110,Giày Mọi Nam BiGGBEN Da Bò Thật Cao Cấp GM206,32.0,2996069617886,699000,720000,21000,3,6,giay-dep-nam
248430402,Dép Biti's Eva Nam BEM000900 Rất Nhẹ và Êm Chân,26.0,6027209676267,190000,190000,0,0,6,giay-dep-nam
193638088,Giày dép Sandals Vento ALPHA II Teen/Trẻ em màu Tro đi học/đi dã ngoại/đi chơi SD08002,6.0,3352855530124,365000,365000,0,0,2,giay-dep-nam
188665546,Lót Giày Nam Chất Liệu Cao Su Non Mềm Êm LGN2022,6.0,3989689883965,22000,22000,0,0,0,giay-dep-nam
177827466,Dép quai ngang nam nữ M Masler MT màu navy trắng thể thao với lớp đế êm chân chống trượt và khử mùi NV1,43.0,9930789121590,298000,298000,0,0,18,giay-dep-nam
175885112,GIÀY LƯỜI DA BÒ NAM CAO CẤP VATIS VA2028,4.0,3575768155944,349000,499000,150000,30,2,giay-dep-nam
172457050,Giày Sandal Nam The Bily 3 Quai Ngang - Màu Đen BL04,53.0,9640115025911,349000,349000,0,0,15,giay-dep-nam
171535414,Dép quai ngang nam nữ M Masler-MT màu xám với lớp đế êm chân khử mùi và chống trơn trượt XT1,34.0,1441704015583,290000,290000,0,0,26,giay-dep-nam
171535210,Dép quai ngang nam nữ M Masler-MT màu đen trắng thiết kế chống trơn trượt và lớp lớp quai êm chân chống nước TD2,46.0,2918661584008,278000,278000,0,0,25,giay-dep-nam
169331001,Túi Đựng Bảo Vệ Chống Bụi Giày Dép Du Lịch Có Dây Rút Loại To KhôngThấm Nước - Hàng Loại 1 - Chính Hãng MIINIIN,46.0,1201956031865,12000,12000,0,0,6,giay-dep-nam
163875026,"Đón giày Gỗ Hương/Gõ đỏ vân gỗ đẹp, có thể bỏ túi tiện dụng (DGH905) hàng xuất khẩu, kiểu dáng nhỏ gọn - HAHANCO",29.0,5637993427478,50000,50000,0,0,2,giay-dep-nam
134652690,"Giày da nam, giày oxford công sở Bụi Leather G101 - Da bò Nappa cao cấp - Bảo hành 12 tháng",113.0,6180637224485,569000,841000,272000,32,48,giay-dep-nam
133236001,"Dép kẹp Nam, Dép xỏ ngón Thái Lan Kito EM 4815",83.0,9275949622942,230000,230000,0,0,27,giay-dep-nam
126028887,"Dép Da Nam, Dép Quai Ngang Da Bò SUNPOLO AQN027 (Đen)",45.0,7624467198029,550000,550000,0,0,15,giay-dep-nam
125876512,Xi Đánh Giày Sáp Shoe Polish XIMO Chính Hãng XI08,287.0,8078361531113,29000,29000,0,0,28,giay-dep-nam
109064375,Lót giày thể thao EVA 4D ốp mút PU cứng giảm chấn vòm ngang và chống thốn gót - buybox - BBPK180,137.0,9992492256721,82000,82000,0,0,28,giay-dep-nam
85315634,"Dép Nam Quai Ngang, Dép Nam Kẻ Sọc Laceva DP66",547.0,2131857880604,159000,318000,159000,50,167,giay-dep-nam
53380039,Dép Xỏ Ngón Nam BIGGBEN Da Bò Thật DK63,82.0,4263495282153,299000,400000,101000,25,30,giay-dep-nam
31649352,2 cặp miếng lót mũi giày nam cao su non đệm êm ngón chân - buybox - BBPK50,846.0,9733835371144,30000,30000,0,0,82,giay-dep-nam
27769078,Dép Nam BIGGBEN Da Bò Thật Cao Cấp DN210,40.0,1893481149226,299000,400000,101000,25,18,giay-dep-nam
26666303,Dép Nam BIGGBEN Da Bò Thật Cao Cấp DN195,46.0,6324356663936,299000,370000,71000,19,19,giay-dep-nam
22929950,Dép Nam BIGGBEN Da Bò Thật Cao Cấp DN176,179.0,9663781090229,339000,450000,111000,25,65,giay-dep-nam
8407712,Giày Sandal Nam BIGGBEN Da Bò Thật SD68,105.0,6247917686116,339000,400000,61000,15,23,giay-dep-nam
7975818,Dép Nam Quai Ngang Da Bò Sunpolo SUD3DN,9.0,1827015948108,480000,480000,0,0,2,giay-dep-nam
7386965,Bộ Vệ Sinh Giày Dép Crep Protect Cure Kit (100ml),1549.0,1922033675736,470000,470000,0,0,180,giay-dep-nam
7303617,Dép Nam BIGGBEN Da Bò Thật Cao Cấp DN80,38.0,4974249473580,339000,450000,111000,25,13,giay-dep-nam
6132855,Dép Nam BIGGBEN Da Bò Thật DN35,85.0,5054312673112,339000,400000,61000,15,28,giay-dep-nam
5469215,Giày Sandal Nam BIGGBEN Da Bò Thật SD12,40.0,7946781604286,349000,400000,51000,13,20,giay-dep-nam
276663225,"Túi Rút Đựng Giày Thể Thao, Bảo Quản Giày, Thời Trang, Tiện Dụng DINCOX",6.0,8699628612796,90000,90000,0,0,0,giay-dep-nam
276634531,"Keo Dán Giày Thể Thao Sêu Dính Dùng Nhiệt Trong Suốt Không Tổn Thương Da, Keo Dính Giày Đa Năng Siêu Bền Chống Nước Tốt Xanh",5.0,2140716503426,160000,160000,0,0,0,giay-dep-nam
276477903,Khăn ướt vệ sinh giày da túi da ví da Leather EcoWipes gói 25 tờ tinh chất sáp ong,9.0,1938609343728,30000,51000,21000,41,1,giay-dep-nam
276357293,Giày Thể Thao Nam Biti’s Hunter X LiteDash - Original Edition 2K24 HSM007504TRG (Trắng),6.0,5094108086197,802000,1050000,248000,24,0,giay-dep-nam
275973689,"Xi khô đánh giày da, đồ da Hando 50g (Đen / Nâu)",3.0,4992445116917,32000,32000,0,0,0,giay-dep-nam
275276585,"Dép tổ ong KEM nhựa EVA siêu bền, siêu nhẹ, chống trơn trượt, đế dày (FORM LỚN ĐẶT LÙI 1-2 SIZE) Dép Nam Nữ Nhiều Màu Sắc",22.0,8418774885833,63000,85000,22000,26,2,giay-dep-nam
275263286,"Bộ dụng cụ đánh giày, bộ xi đánh giày 7 món tiện lợi",37.0,4111825704477,125000,125000,0,0,4,giay-dep-nam
274938716,Lót Giày Cao Cấp Bằng Da Thảo Mộc SIGOURNEY Siêu Mềm Thấm Hút Mồ Hôi Thoáng Khí Thoải Mái Cho Nam,13.0,1750981490842,90000,90000,0,0,1,giay-dep-nam
274175788,"Combo 2 Chai Lau Giày PLAC, Nước Tẩy Trắng Giày Đa Năng Cao Cấp",6.0,6494323380651,32000,32000,0,0,0,giay-dep-nam
273218765,"Lót giày thể thao đế cao su non mềm mại, chống sốc, giảm chấn thương cho lòng bàn chân XIMO (LGTT28)",7.0,1403579789588,39000,39000,0,0,0,giay-dep-nam
263276884,Dây giày Converse 1970s | Chuck 70 Shoelaces,12.0,9627056201070,100000,100000,0,0,0,giay-dep-nam
252406431,Dép quai kẹp Biti's nam,2.0,3297546327728,210000,210000,0,0,2,giay-dep-nam
249005594,"Túi Đựng Giày Dép Du Lịch 3 Ngăn dododios, Chất Liệu Chống Thấm Nước",6.0,6231132712531,96000,96000,0,0,3,giay-dep-nam
243030921,(Sạch giày nhanh) Chai Xịt Bọt Tuyết Vệ Sinh Giày Sneaker THAFA 300ML- Hàng Chính Hãng THAFA,191.0,1126446107999,125000,125000,0,0,20,giay-dep-nam
217023191,"Dép đúc quai ngang vân gỗ nam, nữ siêu nhẹ DUWA - Hàng chính hãng - TK211",126.0,3301762672117,88500,159000,70500,44,22,giay-dep-nam
203875759,"Băng vải quấn bảo vệ ngón chân giảm ma sát, chống chai sần khi mang giày - Buybox - BBPK247",73.0,4468163544666,17000,17000,0,0,9,giay-dep-nam
192138446,Dép Nam Da Bò Thật BIGGBEN Cao Cấp DN317,3.0,5207276812682,349000,400000,51000,13,0,giay-dep-nam
186434946,Túi than hoạt tính khử mùi giày - 100% từ gáo dừa Bến Tre (Hộp 2 túi) - Hapaku,173.0,4749743371898,119000,119000,0,0,15,giay-dep-nam
183895879,"Bình xịt lưu hương chống thối chân, khử mùi giày XIMO, kháng khuẩn, công nghệ Bạc ion (VSG08-1)",124.0,7410954345730,71000,71000,0,0,12,giay-dep-nam
183081577,Dép xỏ ngón nam da bò thật KEEDO KD2202,25.0,3103723036356,145000,145000,0,0,7,giay-dep-nam
180364283,"Dép tông lào, Dép kẹp nam Thái Lan siêu nhẹ Mixstar - MW2 Specail",8.0,4422810984320,55000,55000,0,0,0,giay-dep-nam
180364270,Dép Thái Lan Nam Xỏ Ngón Gambol 11267,40.0,5623615489193,220000,220000,0,0,9,giay-dep-nam
177662569,Dép Nam Quai Ngang Da Bò Thật BIGGBEN Cao Cấp DN306,14.0,3731987094027,289000,350000,61000,17,2,giay-dep-nam
174437687,Dép nhựa Bitis nam,79.0,6459009605827,89000,89000,0,0,21,giay-dep-nam
171535303,Dép quai ngang nam nữ M Masler-MT màu đỏ 4 sọc trắng với lớp quai êm chân và đế chống nước DT4,3.0,7221889489872,310000,310000,0,0,2,giay-dep-nam
137822550,Dép Xỏ Ngón Nam HÀ NAM Da Bò Thật Cao Cấp DNA2143,11.0,8285821204025,258000,360000,102000,28,3,giay-dep-nam
133236291,"Dép Nam xỏ ngón Thái Lan Adda 5TD20 , Dép đúc nguyên khối siêu bền",21.0,4056193590809,160000,160000,0,0,6,giay-dep-nam
129352203,Giày Sandals Vento Nam Nữ Quai Ngang dạo phố/đi chơi/đi học/đi làm NV9801,25.0,8816814329079,365000,365000,0,0,12,giay-dep-nam
118900544,Xịt khử mùi Giày Anh Quốc Beauty Formulas 150ml,92.0,9450122785160,102000,102000,0,0,10,giay-dep-nam
107233238,Dép nhựa quai ngang siêu nhẹ Bitis nam,309.0,9006171893287,106000,106000,0,0,69,giay-dep-nam
76827077,Giày Công Sở Đi Mưa Thời Trang Nam Cao Cấp,156.0,9888712909876,129000,129000,0,0,44,giay-dep-nam
72570436,"Dép Nam Quai Ngang Kẻ, Dép Nam DP65",3078.0,9139917334456,169000,338000,169000,50,1019,giay-dep-nam
58704904,DÉP NAM QUAI NGANG GIA VY TL346 ,35.0,3184186733413,230000,230000,0,0,14,giay-dep-nam
58267780,"Xi nước đánh giày da, đồ da Hando 80ml (màu Đen)",60.0,9569595007029,38000,38000,0,0,18,giay-dep-nam
51477254,Bộ 4 miếng lót độn đế silicone tổ ong tăng 3.5cm chiều cao - buybox - BBPK43,244.0,4170229652611,37500,37500,0,0,58,giay-dep-nam
45224922,Lót giày thể thao EVA êm chân có cấu trúc tổ ong thoáng khí buybox BBPK25,988.0,7943625239659,60000,60000,0,0,144,giay-dep-nam
9809445,Giày Sneaker Unisex Old Skool Vans - VN000D3HY28,91.0,3439714695139,1662500,1850000,187500,10,27,giay-dep-nam
7997300,Giày Converse Chuck Taylor All Star 1970s Hi Top - 162050V,200.0,8532162220597,1800000,2000000,200000,10,46,giay-dep-nam
7997237,Giày Converse Chuck Taylor All Star 1970s Low Top - 162058V,231.0,1496917592964,1710000,1900000,190000,10,72,giay-dep-nam
7995643,Giày Converse Chuck Taylor All Star Classic Low Top - 121178,121.0,4481697298288,1305000,1450000,145000,10,26,giay-dep-nam
277381734,Giày Thể Thao Nam Biti's Hunter X HSM008000XAM (Xám),2.0,2728807392649,970000,970000,0,0,0,giay-dep-nam
277294602,"Giày thể thao nam đế êm nhẹ, thoáng khí đế cao su đúc, chống trơn trượt hạn chế mòn – BEE GEE - GNA2033",2.0,4546941590530,540000,1200000,660000,55,0,giay-dep-nam
276561881,Giày thể thao Bitis hunter nam (40-45),2.0,5751573011124,869000,869000,0,0,2,giay-dep-nam
276472930,"Giày thể thao nam đế êm nhẹ, thoáng khí đế cao su đúc, chống trơn trượt hạn chế mòn  – BEE GEE - GNA1011A",11.0,5554941098941,340000,680000,340000,50,1,giay-dep-nam
276030362,"Giày thể thao nam đế êm nhẹ, thoáng khí đế cao su đúc, chống trơn trượt hạn chế mòn  – BEE GEE - GNA2032",6.0,4994435569148,486000,1080000,594000,55,2,giay-dep-nam
275907778,"Chai xịt khử mùi giày dép NaNo Bạc khử vi khuẩn 99% loại bỏ mùi hôi giày dép Mũ Bảo Hiểm mùi hôi chân nhanh chóng, tiện lợi",25.0,5899307254583,100000,100000,0,0,3,giay-dep-nam
275893413,Dép quai kẹp Bitis nam (38-43),2.0,4556651339660,255000,255000,0,0,2,giay-dep-nam
275399893,"Gói Khăn Ướt Lau Giày, Khăn Vệ Sinh Giày Sneaker (30 Tờ/Gói)",56.0,6100895151840,22000,22000,0,0,4,giay-dep-nam
274046223,Giày thể thao nam / nữ phong cách mới – G1004A,25.0,8978503637945,428400,840000,411600,49,11,giay-dep-nam
273697317,"Bình Xịt Khử Mùi Giày Dép, Mũ Bảo Hiểm Tủ Quần Áo, Chai Xịt Khử Mùi Nano Bạc Ngăn Ngừa Hôi Chân Hiệu Quả Tức Thì Dung Tích 260ML ",70.0,5599339539100,12000,24000,12000,50,8,giay-dep-nam
216205111,"Keo dán giày bền chặt, chống thấm hiệu quả. thiết kế nhỏ gọn, tiện lợi - BuyBox - BBPK323",80.0,6110554564757,40000,40000,0,0,12,giay-dep-nam
209125665,"Giày Thể Thao Nam Limenco L6059 Màu Ghi, Đế Phylon Êm Nhẹ, Đi Chơi, Thể Thao",15.0,1189056488918,649000,649000,0,0,6,giay-dep-nam
190792898,Giày sandal nam da bò thật BIGGBEN cao cấp SD123,12.0,9606922840780,329000,400000,71000,18,5,giay-dep-nam
190511573,Dép nam đế may sẵn da bò quai ngang cao cấp KEEDO TN-NB701,11.0,8607557285042,460000,460000,0,0,4,giay-dep-nam
175877407,GIÀY LƯỜI DA BÒ NAM CAO CẤP VATIS VA2027,15.0,9609376467941,349000,499000,150000,30,8,giay-dep-nam
171535511,Dép quai ngang nam nữ M Masler-MT màu sắc biển cả với lớp đế chống trơn và quai êm chân MBC,5.0,1538763220631,298000,298000,0,0,3,giay-dep-nam
171535329,Dép quai ngang nam nữ M Masler-MT Phản Quang với chất liệu đế đi êm chân và chống trượt an toàn PQ1,14.0,2288853644128,290000,290000,0,0,3,giay-dep-nam
171535266,"Dép quai ngang nam nữ M Masler-MT màu sắc trời hè với lớp đế bền bỉ, chống nước và quai êm chân BTH",3.0,8851337870358,298000,298000,0,0,1,giay-dep-nam
163884917,Giày lười nam Đông Hải da bò cao cấp  với độ sần tự nhiên tăng vẻ nam tính -   G0344,3.0,1863583908551,1490000,1490000,0,0,1,giay-dep-nam
161551919,"Giày Mọi Da Nam, Giày Lười Da Bò Nam SUNPOLO LS2098 (Đen, Nâu)",3.0,9986447483413,650000,650000,0,0,0,giay-dep-nam
153570444,Giày Sục Đạp Gót Mules Vải Sneaker Unisex Tăng Chiều Cao 4cm DINCOX E10 Off/white,18.0,9865645266627,359000,520000,161000,31,6,giay-dep-nam
150788748,Giày Sandal Nam The Bily Quai Chéo - Màu Đen BL01D,85.0,2016651974894,319000,319000,0,0,27,giay-dep-nam
150762145,Giày Sandal Nam The Bily Quai Chéo Đôi - Màu Đen BL02D,132.0,8103718701890,329000,329000,0,0,49,giay-dep-nam
150760547,Giày Sandal Nam The Bily Quai Ngang - Màu Xám BL03X,29.0,5397392729245,339000,339000,0,0,11,giay-dep-nam
147206921,Giày Sandal Nam The Bily Quai Chéo Đôi - Xám Thổ Cẩm BL02XTC,31.0,8373606967383,329000,329000,0,0,13,giay-dep-nam
141232483,Giày mọi rọ nam da bò thật BIGGBEN cao cấp GM263,13.0,6958604945060,649000,760000,111000,15,6,giay-dep-nam
133235615,Dép Thái Lan Nam Cao Su Thời trang KARDAS - Street 3.1,22.0,8856916695900,210000,210000,0,0,4,giay-dep-nam
130398472,"Giày Lười Nam Da Bò SUNPOLO SU4010 (Đen, Nâu)",12.0,2575369327997,690000,690000,0,0,5,giay-dep-nam
92137013,Dép nam DUWA siêu nhẹ - Hàng chính hãng - Quai ngang caro DH9014,186.0,1579440097939,88500,159000,70500,44,51,giay-dep-nam
90726651,Giày tây nam tăng chiều cao da bò thật GC02,30.0,4216951265144,850000,850000,0,0,10,giay-dep-nam
73546672,Lót giày thể thao EVA biết thở và có 2 đệm chịu lực hỗ trợ vận động thể thao - Đen phối xanh - buybox - BBPK155,550.0,7203747520944,50000,50000,0,0,117,giay-dep-nam
68368093,Dép bít mũi nam da bò thật HÀ NAM cao cấp GSB2043,31.0,8963424949367,298000,420000,122000,29,14,giay-dep-nam
59206687,GIày Sandal Nam Da Bò BIGGBEN Cao Cấp SD105,38.0,1822510969801,349000,450000,101000,22,13,giay-dep-nam
55081450,Giày sandal nam Trường Hải da bò thật mềm mại cao 5cm  màu đen đế PU siêu nhẹ không trơn trượt  chắc chắn  HÌNH ẢNH THẬT SD791,46.0,3283451572570,319000,319000,0,0,12,giay-dep-nam
55063108,Giày Sandal Nam Da Bò BIGGBEN Cao Cấp SD102,23.0,1197799921414,329000,450000,121000,27,8,giay-dep-nam
50240762,"Lót độn mũi giày chống nứt da, chống gãy mũi, chống xẹp mũi và giữ dáng mũi giày căng phồng PK58",239.0,5454837428998,60000,60000,0,0,42,giay-dep-nam
43388701,Dép quai ngang nam GIAVY - TL336,147.0,5015189973132,230000,230000,0,0,55,giay-dep-nam
37947630,Giày Tây Đông Hải - G0132,3.0,7300553637399,1350000,1350000,0,0,2,giay-dep-nam
6136987,Dép Xỏ Ngón Nam BIGGBEN Da Bò Thật DK05,160.0,4095011548029,299000,400000,101000,25,19,giay-dep-nam
277735426,"Dép Sandal Nam, Dép Quai Hậu, Giày Quai Hậu Nam Mã DP30",1.0,4744486881303,239000,478000,239000,50,0,giay-dep-nam
277592190,Dép Eva Phun Nam  BEM002300 Siêu Nhẹ Chống Nước,1.0,3749734166779,142000,142000,0,0,0,giay-dep-nam
276590892,"COMBO 2 CUỘN Băng vải quấn bảo vệ ngón chân giảm ma sát, chống chai sần khi mang giày",3.0,4576873993687,60000,60000,0,0,0,giay-dep-nam
276547653,Dép quai ngang Bitis nam (38-43),2.0,2890225011896,385000,385000,0,0,0,giay-dep-nam
276382739,Dép Thái Lan cao cấp quai ngang DT1038 (LOẠI 1),8.0,8522378140860,234000,520000,286000,55,4,giay-dep-nam
276098254,Giày Bảo Hộ Lao Động Thể Thao Voltan Cách Điện 6kV,3.0,7013410235473,495000,495000,0,0,1,giay-dep-nam
275956393,Tomoyo Dép Quai Ngang Da Microfiber Siêu Nhẹ TMD310,4.0,2893498856541,900000,900000,0,0,1,giay-dep-nam
275911002,Giày thể thao Bitis nam (39-44),3.0,9934248235578,869000,869000,0,0,1,giay-dep-nam
275837602,Sandal Bitis nam (38-44),4.0,9866644120250,340000,340000,0,0,0,giay-dep-nam
275514667,Sandal Nam Biti's BYM000300 Siêu Bền Chống Trượt,3.0,1359670850586,490000,490000,0,0,0,giay-dep-nam
275431720,Dép quai kẹp Bitis nam (38-43),7.0,8102817220847,60000,60000,0,0,0,giay-dep-nam
275276525,"Dép tổ ong XANH CHUỐI nhựa EVA siêu bền, siêu nhẹ, chống trơn trượt, đế dày (FORM LỚN ĐẶT LÙI 1-2 SIZE) Dép Nam Nữ Nhiều Màu Sắc",10.0,3241410459199,63000,85000,22000,26,2,giay-dep-nam
275276422,"Dép tổ ong XANH NGỌC nhựa EVA siêu bền, siêu nhẹ, chống trơn trượt, đế dày (FORM LỚN ĐẶT LÙI 1-2 SIZE) Dép Nam Nữ Nhiều Màu Sắc",14.0,6233971762268,63000,85000,22000,26,2,giay-dep-nam
275276395,"Dép tổ ong TRẮNG nhựa EVA siêu bền, siêu nhẹ, chống trơn trượt, đế dày (FORM LỚN ĐẶT LÙI 1-2 SIZE) Dép Nam Nữ Nhiều Màu Sắc",27.0,4722804538683,63000,85000,22000,26,2,giay-dep-nam
274780205,"Dép Da Nam Quai Ngang, Dép Nam Quai Khâu Chỉ Dù Mã DP112",9.0,9073873887545,169000,338000,169000,50,3,giay-dep-nam
273316776,"Keo Dán Giày Thể Thao Sêu Dính Dùng Nhiệt Trong Suốt Không Tổn Thương Da, Keo Dính Giày Đa Năng Siêu Bền Chống Nước Tốt",66.0,8966460276733,14790,29000,14210,49,4,giay-dep-nam
263276745,Lót giày Converse OrthoLite® Siêu Nhẹ | Converse Sockliner,13.0,4641524332491,99000,99000,0,0,3,giay-dep-nam
253169454,"Dép Sandal Nam, Nữ Dép Quai Hâu Quai Tròn Mảnh Mã DP35",21.0,1537602075473,149000,298000,149000,50,3,giay-dep-nam
253149207,"Giày thể thao nam chất liệu da mềm mại, phong cách cá tính năng dộng – GNA1029",5.0,4136658095722,418000,836000,418000,50,0,giay-dep-nam
228132185,Dép Nam Quai Ngang HÀ NAM Da Bò Thật Cao Cấp DNA2210,4.0,9085594036057,279000,450000,171000,38,1,giay-dep-nam
191363362,"Giày da nam, giày đốc nam trẻ trung nam Bụi Leather G122 - Da bò thật Nappa cao cấp - Bảo hành 12 tháng",119.0,9623048536956,615000,969000,354000,37,38,giay-dep-nam
190509261,Dép quai ngang hàng hiệu da bò thật KEEDO TN-9021 Full hộp,8.0,1870174832190,460000,460000,0,0,1,giay-dep-nam
189940233,Dép kẹp nam Đông Hải chất da bò cao cấp thiết kế tối giản đế cao su chống trượt - D3221,1.0,2715696342643,690000,690000,0,0,0,giay-dep-nam
183068284,Dép kẹp nam quai dù siêu bền KEEDO KD1396,12.0,8362912327816,140000,140000,0,0,3,giay-dep-nam
174628667,Mule- Sục Nam Bảo Hân Da Bò Mã GS-02,9.0,5127302637438,650000,650000,0,0,3,giay-dep-nam
171535804,Dép quai ngang nam nữ M Masler-MT đan mạch xanh dương với lớp đế chống nước và quai êm chân DMXD,5.0,8928263222141,458000,458000,0,0,4,giay-dep-nam
170069036,Giày công sở nam da cao cấp ORSIL mã CS-H hai màu đen và nâu,13.0,2333364246615,369000,369000,0,0,4,giay-dep-nam
145399495,Giày sandal nam da bò thật BIGGBEN cao cấp SD121,22.0,8742374583380,349000,400000,51000,13,13,giay-dep-nam
141591426,"Dép Sapo Dép Sục Nam Da Bò SUNPOLO SPO274 (Đen, Nâu)",11.0,8949629276667,510000,510000,0,0,7,giay-dep-nam
134776866,Giày lười da nam công sở Bụi Leather G110 - Da bò Nappa cao cấp - Bảo hành 12 tháng,57.0,7990385832580,589000,840000,251000,30,31,giay-dep-nam
134739207,"Giày da nam, giày oxford công sở G103 - Da bò Nappa cao cấp",462.0,4145934885056,569000,841000,272000,32,170,giay-dep-nam
132098603,"Giày Rọ Nam Da Bò SUNPOLO STA681 (Đen, Nâu)",11.0,1390575262856,610000,610000,0,0,1,giay-dep-nam
115263896,"Dép Xỏ Ngón Thái Lan Unisex Nam nữ RUBBER SOUL – Balance siêu êm, siêu nhẹ",55.0,1510746557902,180000,180000,0,0,13,giay-dep-nam
84197047,Giày Sandals Vento Nam Quai Chéo đi học đi chơi đi làm NV65 - NV117,34.0,5783346920143,260000,260000,0,0,10,giay-dep-nam
72215181,Giày Tây Nam Tăng Chiều Cao Da Bò BIGGBEN Cao Cấp GT204,1.0,8913562785860,899000,1100000,201000,18,1,giay-dep-nam
40363202,Lót giày vải cotton Hương quế CI-02 làm từ vải cotton - bột quế giúp hút ẩm - khử mùi - phòng cảm cúm và cải thiện sức khoẻ,60.0,1262884655502,25000,25000,0,0,1,giay-dep-nam
27768984,Dép Nam BIGGBEN Da Bò Thật Cao Cấp DN207,61.0,1756942241955,299000,400000,101000,25,20,giay-dep-nam
13356120,"Dép Nam Da Bò, Sandal Nam",51.0,1848646537806,450000,450000,0,0,16,giay-dep-nam
8003458,Dép Nam BIGGBEN Da Bò Thật Cao Cấp DN125,67.0,1659386342069,339000,450000,111000,25,25,giay-dep-nam
2597775,Dép Nam Quai Ngang Da Bò Cao Cấp SUNPOLO SUA6D - Đen,17.0,1446188863980,550000,550000,0,0,5,giay-dep-nam
277854495,Dép nhựa Biti's nam (39-44),2.0,9690110506810,165000,165000,0,0,0,giay-dep-nam
277250739,"New Arrivals | Giày Sneaker Nam Dincox DC42 Matcha - Phong Cách Năng Động, Chất Liệu Canvas Cao Cấp",2.0,6654855477338,495000,495000,0,0,0,giay-dep-nam
277013914,Dép Kẹp Nam da PABNO PN21043,1.0,3264957213739,275000,275000,0,0,1,giay-dep-nam
276580902,"Chai xịt tạo bọt tuyết vệ sinh giày cao cấp, chai tẩy rửa giày không dùng nước 1 CHAI 200ml",13.0,8144237041868,160000,160000,0,0,1,giay-dep-nam
276357382,Giày Thể Thao Nam Biti's Hunter Core LiteFoam 3.0​ - Original Edition 2K24​ HSM007801TRG (Trắng),3.0,2377527047844,869000,869000,0,0,0,giay-dep-nam
276259356,Giày Tây Nam Biti's BMM001477NAD (Nâu đậm),1.0,9215799849504,786000,786000,0,0,1,giay-dep-nam
275921766,Giày thể thao Bitis Hunter nam HSM006400(39-45),1.0,6040498055017,1209000,1209000,0,0,0,giay-dep-nam
275775909,Sandal Nam Biti's Hunter HEM000900,7.0,2108281141111,469000,469000,0,0,1,giay-dep-nam
275276260,"Dép tổ ong ĐỎ nhựa EVA siêu bền, siêu nhẹ, chống trơn trượt, đế dày (FORM LỚN ĐẶT LÙI 1-2 SIZE) Dép Nam Nữ Nhiều Màu Sắc",4.0,3327324216147,63000,85000,22000,26,2,giay-dep-nam
275021604,"Giày Sport Trekking, Giày Leo Núi, Giày Phượt, Giày Đi Bộ Dã Ngoại Siêu Nhẹ Màu Đen",1.0,9457779739109,119000,119000,0,0,0,giay-dep-nam
272040857,Dép nam xỏ ngón nhựa đúc  liền khối ADDA Thái Lan 58801,5.0,4218767578625,150000,150000,0,0,2,giay-dep-nam
271538225,Giày Thể Thao Thông Dụng Nam Biti's BSM000700DEN Đế EVA Siêu Nhẹ,5.0,6048249855794,470000,470000,0,0,1,giay-dep-nam
253110472,Bộ Dây Giày Co Giãn Kèm Phụ Kiện Khóa Dây Giày Không Cần Buộc Thắt Giày Thể Thao Bata Ngoài Trời Legaxi,100.0,9556810224102,10500,10500,0,0,10,giay-dep-nam
216384217,"Combo Xi Mút Đánh Bóng Giày, Da GoldCare GC4001 Màu Đen và Nâu",3.0,4778402194922,104000,104000,0,0,2,giay-dep-nam
210143697,"Lót giày thể thao có hạt massage lòng bàn chân, thoáng khí, chất liệu mềm mại dễ dàng vận động - Buybox - BBPK228",21.0,7029655309907,46604,46604,0,0,5,giay-dep-nam
195013905,Dép da nam đế cao 3.5cm may viền Trường Hải da bò thật màu vàng thời trang nam cao cấp DN156,8.0,5171329907864,450000,450000,0,0,1,giay-dep-nam
189635020,Giày Sandal Vento Nam 2 Quai Ngang dạo phố  đi học du lịch Big Size NV3610,10.0,5963179346734,345000,345000,0,0,1,giay-dep-nam
188412428,Dây Giày Loại Tròn Cao Cấp DGD2024a,14.0,9087332381027,10000,16000,6000,38,1,giay-dep-nam
183725406,"Lót giày thể thao, giày tây giày lười cao su non cao 1.5cm TH152",9.0,9216344649354,99000,99000,0,0,2,giay-dep-nam
183554496,Dép đế may sẵn quai ngang cao cấp KEEDO KD2906 Full hộp,5.0,9753536131369,460000,460000,0,0,1,giay-dep-nam
177674636,Dép Nam Quai Ngang Da Bò Thật BIGGBEN Cao Cấp DN310,1.0,5581196119748,289000,380000,91000,24,0,giay-dep-nam
177319011,Túi thể thao đựng giày TN Bags TN.B 9002 túi đựng giày đá bóng tiện ích,3.0,6647564737868,187600,268000,80400,30,0,giay-dep-nam
175901710,Dép nam đẹp hai quai cao cấp KEEDO KD2803 Full Box,23.0,9232952378744,290000,290000,0,0,3,giay-dep-nam
173635485,Giày Lười Nam Tăng Chiều Cao Da Bò Thật BIGGBEN Cao Cấp GM270,8.0,9676792105198,899000,1500000,601000,40,3,giay-dep-nam
163894759,"Dép Da Nam, Dép Nam Quai Ngang Da Bò SUNPOLO SQND36 (Nâu)",6.0,9616469050683,465000,465000,0,0,2,giay-dep-nam
162841600,"Dép Nam, Dép Bít Mũi Nam Da Bò SUNPOLO SUA011 (Đen, Nâu)",6.0,5481955560747,580000,580000,0,0,3,giay-dep-nam
149780140,Giày lười nam da bò ORSIL thời trang màu nâu lịch thiệp - ORL D10,13.0,6198645406771,309000,309000,0,0,3,giay-dep-nam
141740940,"Dép Sục Sapo Nam Da Bò SUNPOLO SUT322 (Đen, Nâu)",6.0,4810869373826,490000,490000,0,0,1,giay-dep-nam
138193990,Dép Xỏ Ngón Nam HÀ NAM Da Bò Thật Cao Cấp DNA2144,9.0,7219392830875,258000,325000,67000,21,1,giay-dep-nam
127686689,"Sandal Nam Da Bò SUNPOLO SDA002 Trẻ trung, năng động (Đen, Nâu)",7.0,1788338027444,580000,580000,0,0,2,giay-dep-nam
113215403,"Lót giày vải lưới Hương Quế, quế thật, quế thơm, tốt cho sức khỏe",179.0,2566617500801,38000,38000,0,0,17,giay-dep-nam
84198686,Dép Vento Nam xỏ ngón dạo phố đi chơi du lịch VT1189,7.0,3620868870968,230000,230000,0,0,3,giay-dep-nam
76368202,Dép nam da bò BIGGBEN cao cấp DN272,50.0,6014605699402,349000,450000,101000,22,17,giay-dep-nam
65778681,"Lót giày thể thao tổ ong EVA loại cao cấp đế dày 1.8cm đàn hồi cực êm chân, thoáng khí - buybox - BBPK128 - Đế vàng mặt đen - Size nam",732.0,9900092865673,32000,32000,0,0,135,giay-dep-nam
58837457,DÉP NAM QUAI NGANG GIA VY TL504,55.0,4829353594570,245000,245000,0,0,18,giay-dep-nam
26691723,Dép Nam BIGGBEN Da Bò Thật Cao Cấp DN201,26.0,3964935550832,319000,380000,61000,16,8,giay-dep-nam
26338670,Lót giày vải lưới 1 lớp CI-05,6.0,4748552220724,40000,40000,0,0,1,giay-dep-nam
6394813,Giày Tây Nam BIGGBEN Da Bò Thật GT17,14.0,3723708568418,619000,720000,101000,14,3,giay-dep-nam
2597577,Giày Sandal Nam Da Bò Cao Cấp SUNPOLO SUSDA1,34.0,4444599554531,580000,580000,0,0,7,giay-dep-nam
277519710,Dép Cross Quai hậu Hàng Cao Cấp - DNA1024,1.0,5220646817856,350000,700000,350000,50,1,giay-dep-nam
277510335,"Com bo dụng cụ làm sạch giày - Miếng xi mút + sáp lau đánh bóng giày, dép, đa năng và tiện lợi",2.0,9392884326132,84550,89000,4450,5,0,giay-dep-nam
277250756,"New Arrivals | Giày Vải Thể Thao Nam DINCOX DC42 Black Chất Liệu Canvas Cao Cấp, Thiết Kế Trẻ Trung",1.0,8272134453527,495000,495000,0,0,0,giay-dep-nam
276187640,"Giày thể thao nam đế êm nhẹ, thoáng khí đế cao su đúc, chống trơn trượt hạn chế mòn  – BEE GEE - GNA2020",3.0,6680997040478,520000,1040000,520000,50,2,giay-dep-nam
275499813,Sandal Bitis nam (38-44),3.0,9357490679581,445000,445000,0,0,1,giay-dep-nam
274182912,"Chai xịt khử mùi giày dép, chiết xuất từ thực vật tự nhiên dễ dàng khử mùi hôi, diệt vi khuẩn, bảo vệ giày - Hàng chính hãng",375.0,4597730852626,42750,45000,2250,5,18,giay-dep-nam
273611089,"Xi Đánh Bóng Giày Da Làm Bóng Nhanh Đồ Da, Xi Kem Dưỡng Da Có Đầu Mút Hỗ Trợ - HÀNG CHÍNH HÃNG MINIIN",12.0,2021635771255,35000,35000,0,0,3,giay-dep-nam
270139213,"Lót giày thể thao nam nữ Genky Comfort 4 lớp, tăng 1,5cm chiều cao, chống sốc, thấm mồ hôi, khử mùi, nâng vòm bàn chân",15.0,1466210802382,150000,150000,0,0,3,giay-dep-nam
252912786,Gói Khăn Lau Vệ Sinh Giày Nhanh Quick Wipe Sneak3r,7.0,1555493447435,25000,25000,0,0,0,giay-dep-nam
249006166,Túi Đựng Giày Dép Du Lịch Thể Thao Tiện Dụng 3 Ngăn Chống Nước,9.0,5990457928656,96000,96000,0,0,0,giay-dep-nam
248638295,Dép nam xỏ ngón Gambol 41129 Thái Lan,11.0,7212413188174,250000,250000,0,0,2,giay-dep-nam
217752612,Dép xỏ ngón nam  Aldo VOVCHENKO,2.0,9495539759422,1350000,1350000,0,0,0,giay-dep-nam
199597031,"Xi Đánh Giày Sáp Shoe Polish XIMO Đen, Không Màu, Nâu Đủ Màu XI08",31.0,9902839047408,29000,29000,0,0,2,giay-dep-nam
194131743,"Dép đúc quai ngang nam, nữ siêu nhẹ DUWA - Hàng chính hãng - TK193",152.0,6919905535646,89500,179000,89500,50,30,giay-dep-nam
192196939,"Dép Thái Lan nam quai Da dây chéo KITO A02M , Dép sandan quai da dành cho nam",8.0,1731904122504,295000,295000,0,0,3,giay-dep-nam
191732448,Giày Sandal Nam The Bily Quai Chéo - Đế Trắng Lót Đen Màu Trắng BLDTMD01,1.0,5303464445382,319000,319000,0,0,0,giay-dep-nam
191650844,"Dép nam quai ngang da bò Nappa cao cấp Bụi Leather E102, đế đúc nguyên khối khâu viền thủ công đi êm chân",111.0,9088327209741,289000,289000,0,0,37,giay-dep-nam
187482083,Dép da nam Giavy quai 2 dây ngang cao 2 phân U9021.6,4.0,3304045974397,360000,360000,0,0,0,giay-dep-nam
176692133,Dép Nam Chữ H Cao Cấp Mẫu Hot KEEDO KD822,43.0,2226924443918,290000,290000,0,0,10,giay-dep-nam
176037199,Dép Quai Ngang Nam Cao Cấp KEEDO-KD0604,86.0,7679827435189,290000,290000,0,0,30,giay-dep-nam
174438015,Dép nhựa Bitis nam,24.0,6595358547327,90000,90000,0,0,3,giay-dep-nam
170580327,Dép Nam Bít Đầu Da Bò Thật BIGGBEN Cao Cấp DN304,5.0,7148183965031,429000,450000,21000,5,2,giay-dep-nam
162053191,Dép nam hai quai ngang KEEDO-KD7722 mẫu mới cao cấp full hộp,10.0,4187263792135,290000,290000,0,0,1,giay-dep-nam
141388938,Giày Rọ Nam Da Bò SUNPOLO STA682 (Nâu),4.0,6979972796177,690000,690000,0,0,0,giay-dep-nam
126258408,Đón gót giày cho mọi tư thế gỗ tự nhiên nguyên khối (Đủ độ dài) Cho giày Nam & Nữ,11.0,6547360503018,33000,33000,0,0,5,giay-dep-nam
120035812,"HT9129-30-31-32-33 - Xi nước đánh bóng Huy Hoàng màu đen, nâu, vàng bò, trắng, không màu",66.0,2102417707577,99000,99000,0,0,8,giay-dep-nam
115264010,Dép Nam Quai Ngang Thái Lan size 36 đến 44 Gambol 43106,61.0,3898336907179,175000,175000,0,0,18,giay-dep-nam
98153125,Dép quai ngang Bitis xốp nam,374.0,7711738497663,106000,106000,0,0,78,giay-dep-nam
69177937,Dép nam xỏ ngón HÀ NAM da bò thật cao cấp DXN2035,5.0,2546474832535,268000,450000,182000,40,2,giay-dep-nam
59056036,Dép xỏ ngón nam nữ DUWA T405KG - Hàng chính hãng,596.0,6762368748959,64500,129000,64500,50,184,giay-dep-nam
55745928,Giày tây nam công sở Trường Hải mũi tròn màu đen da bò thật mềm mại không bong tróc đế cao su chống mòn không trơn GT0231,103.0,6334058896952,475000,475000,0,0,40,giay-dep-nam
55122864,Dép nam quai ngang Trường Hải da bò thật mềm mại may thủ công chắc chắn tỉ mỉ đế cao su không trơn QNN074 ,4.0,8783760022636,325000,325000,0,0,0,giay-dep-nam
55032368,Dép sandal nam Trường Hải da bò cao cấp mềm mại không bong tróc màu đen đế PU siêu nhẹ cao 5cm SDN001,41.0,1394406190878,319000,319000,0,0,8,giay-dep-nam
48319992,Dép Nam Da Bò BIGGBEN Cao Cấp DN226,22.0,7188383752952,299000,400000,101000,25,8,giay-dep-nam
45968195,Lót giày mặt vân massage lòng bàn chân buybox BBPK06,1036.0,5616025882832,18000,18000,0,0,208,giay-dep-nam
41657082,Cây xở giầy gỗ,23.0,2438702365888,153000,153000,0,0,5,giay-dep-nam
40978220,Dép quai ngang nam da bò cao cấp Trường Hải QN335,4.0,8282035550497,265000,265000,0,0,1,giay-dep-nam
10063962,Dép Nam Bít Mũi BIGGBEN Da Bò Thật Cao Cấp DN146,69.0,4262573786026,349000,500000,151000,30,28,giay-dep-nam
10063550,Giày Sandal Bít Mũi  Nam BIGGBEN Da Bò Thật SD78,83.0,6049408419339,349000,500000,151000,30,16,giay-dep-nam
1589759,Giày Tây Nam Da Bò SUNPOLO SU3020D - Đen,13.0,1751259735500,890000,890000,0,0,2,giay-dep-nam
276558348,Giày Bitis Hunter nam (39-45)699k,3.0,8144811917548,699000,699000,0,0,0,giay-dep-nam
276471998,Combo Hai đón gót giầy muồng đen Không Gỉ Duy Trì Hình Dáng Tăng Tuổi Thọ Của Giày Nam Nữ Móc Chìa Khóa MUỖNG XỎ GIÀY,4.0,2742276855849,100000,100000,0,0,0,giay-dep-nam
276353664,GIÀY LƯỜI DA BÒ NAM CAO CẤP VATIS VA2037,1.0,4273370173472,349000,499000,150000,30,1,giay-dep-nam
275991774,Giày thể thao nam Aldo AROS,1.0,2518206835456,2450000,2450000,0,0,0,giay-dep-nam
275276309,"Dép tổ ong ĐEN nhựa EVA siêu bền, siêu nhẹ, chống trơn trượt, đế dày (FORM LỚN ĐẶT LÙI 1-2 SIZE) Dép Nam Nữ Nhiều Màu Sắc",35.0,4712776915153,63000,85000,22000,26,0,giay-dep-nam
274920487,Giày Doctor Da Bò Full Đen SIGOURNEY Trẻ Trung Nam Tính SDR-03 Bảo Hành 18 Tháng,3.0,2459653267904,595000,595000,0,0,2,giay-dep-nam
274567901,"Dép Nam quai ngang Nesty an toàn, êm ái, dễ vệ sinh",60.0,2856721809523,89000,89000,0,0,7,giay-dep-nam
274529479,Lót giày thể thao Phiten insole cup type giảm sốc TI464003/TI464004/TI464005,2.0,1879471037600,1031800,1031800,0,0,0,giay-dep-nam
273172388,Giấy Vàng lau giầy thần thánh Sneaker - Hàng Nhập Khẩu,40.0,7248995628667,35000,35000,0,0,3,giay-dep-nam
253306906,Đón gót giầy gỗ,2.0,9502607179191,114240,119000,4760,4,0,giay-dep-nam
250550764,Dép quai kẹp xốp Biti's nam,2.0,5902427346602,265000,265000,0,0,1,giay-dep-nam
217760292,Giày Sandal Nam Da Bò Thật TiTi ĐÔ Cao Cấp DNA2166d,4.0,1294445826619,268000,396000,128000,32,1,giay-dep-nam
215214310,Dép nam quai ngang cao cấp siêu bền may quai sẵn KD2808 Full hộp,5.0,9389611087997,290000,290000,0,0,1,giay-dep-nam
204650059,GIÀY LƯỜI DA BÒ NAM CAO CẤP VATIS VA2036,2.0,5532776896976,349000,499000,150000,30,1,giay-dep-nam
204416667,Dép nam Gia Vy quai chéo đế cao su TL546 màu Đen và Nâu,6.0,2378099183866,230000,230000,0,0,3,giay-dep-nam
196344517,Đón gót giày dài 35cm gỗ Muồng nguyên khối sơn mài VIP - DGH909 - tiện dụng cho gia đình bạn,1.0,2824763278381,79000,79000,0,0,0,giay-dep-nam
191739529,Giày Sandal Nam The Bily Quai Chéo Đôi -  Đế Trắng Lót Đen Màu Đen BLDTMD02,3.0,6704966769784,329000,329000,0,0,1,giay-dep-nam
191657189,Giày nam Derby công sở da bò nappa cao cấp G113- Bụi leather- hộp sang trọng - Bảo hành 12 tháng,25.0,7408630010896,579000,579000,0,0,6,giay-dep-nam
184592803,GIÀY TÂY DA BÒ CAO CẤP VATIS VA2002,1.0,6342571622185,349000,499000,150000,30,0,giay-dep-nam
175967798,Dép Quai Ngang Nam Mẫu Đẹp KEEDO-KD1603 Full hộp,5.0,7144998044237,520000,520000,0,0,3,giay-dep-nam
175966113,Dép nam cao cấp mẫu đẹp KEEDO KD2802 siêu bền full hộp,13.0,9792556257927,290000,290000,0,0,1,giay-dep-nam
171536291,"Dép quai ngang nam nữ M Masler-MT màu đỏ sọc trắng với lớp quai chắc chắn, thoáng khí và đế chống nước DST",6.0,5186047665755,298000,298000,0,0,2,giay-dep-nam
171535250,"Dép quai ngang nam nữ M Masler-MT màu trắng sọc đen tinh tế với lớp đế dễ vệ sinh, chống nước và quai êm chân TD1",34.0,3838530860318,278000,278000,0,0,17,giay-dep-nam
165189410,Giày Boot Da Bò Thật Nam BIGGBEN Cao Cấp BT6,1.0,4903445942786,1099000,1400000,301000,22,0,giay-dep-nam
157046419,"Dép khách sạn cao cấp Hương Quế có lớp chiếu mềm, tự nhiên tiếp xúc trực tiếp với da bàn chân",13.0,7640506562158,70000,70000,0,0,0,giay-dep-nam
126257693,Đón gót giày gỗ tự nhiên nguyên khối - Dài 22cm (DGH906) Cho giày Nam & Nữ,12.0,6964429928983,33000,33000,0,0,3,giay-dep-nam
126155424,Đón gót giày bằng sừng liền khối (DGH904) Cứng chắc/ bền/ bóng đẹp /màu sắc tự nhiên - Cho giày Nam & Nữ ,21.0,8197236901036,69000,69000,0,0,5,giay-dep-nam
107801403,Khăn lau giày tiện lợi chuyên dụng XIMO siêu mềm mại (XKDGG01),3.0,2289021230172,10000,10000,0,0,0,giay-dep-nam
106361646,Dép Nam Quai Ngang HA NAM Da Bò Thật Cao Cấp DN2074,5.0,8361172952673,268000,430000,162000,38,1,giay-dep-nam
68590535,Giày Mọi Rọ Nam Da Bò BIGGBEN Cao Cấp GM244,2.0,1655557095352,629000,800000,171000,21,2,giay-dep-nam
50351462,Giày sục nam da bò mũi nhọn Trường Hải đế cao 3.5cm phong cách lịch sự BM0455,51.0,5732157681027,379000,379000,0,0,17,giay-dep-nam
49551859,"Dụng cụ bảo quản giày chống xẹp móp mũi giày, chống gãy da giày và giúp giữ dáng giày chuẩn thiết kế - buybox - PKBB45",145.0,5331374085306,100000,100000,0,0,23,giay-dep-nam
47141251,"Bộ Vệ Sinh Giày Dép Crep Protect Cure Kit (gồm bàn chải, khăn lau, chai dung dịch vệ sinh 100ml và sách hướng dẫn) ",417.0,8802326533703,470000,470000,0,0,111,giay-dep-nam
45272479,Dép xỏ ngón nam GIAVY - TL500,14.0,8804216366767,245000,245000,0,0,8,giay-dep-nam
42685602,Giầy Sneaker nam_20891-16,1.0,4837899716868,190500,190500,0,0,0,giay-dep-nam
36493130,"Combo 3 đôi lót giày Hương Quế (CI-01, CI-03, CI-04) giúp khử hôi chân - phòng cảm cúm tốt cho sức khỏe",124.0,2370895924773,75000,75000,0,0,25,giay-dep-nam
20837731,Dép giải phóng quân,279.0,6078482387692,295000,295000,0,0,65,giay-dep-nam
10054396,Giày Sandal Bít Mũi Nam BIGGBEN Da Bò Thật SD77,56.0,9903569995705,349000,500000,151000,30,20,giay-dep-nam
8407912,Giày Sandal Doctor Nam BIGGBEN Da Bò Thật SD70,99.0,4603069875969,329000,500000,171000,34,46,giay-dep-nam
7985951,Dép Xỏ Ngón Nam BIGGBEN Da Bò Thật DK28,4.0,1575610660788,339000,450000,111000,25,2,giay-dep-nam
274511048,"Tấm vải  phủ  tủ lạnh  siêu bền ,chống thấm ,chống bụi có túi đựng 2 bên ,hoa văn trang nhã ,màu sắc đẹp mắt ,tô điểm không gian gia đình bạn thêm sinh động ,sắc sỡ",0.0,7349499929757,75050,79000,3950,5,0,dien-tu-dien-lanh
274511051,"Khăn che tủ lạnh vải nilon  có túi đựng 2 bên ,chống thấm ,chống bụi  ,hoa văn trang nhã ,màu sắc đẹp mắt ,bảo vệ nóc tủ lạnh luôn sạch sẽ như mới ",1.0,7697067030701,79000,79000,0,0,0,dien-tu-dien-lanh
184067936,Tủ bảo quản rượu vang 28 chai ADELA-28-HÀNG NHẬP KHẨU,1.0,5104649224184,7500000,7500000,0,0,0,dien-tu-dien-lanh
277614217,"Remote Điều Khiển Cho Máy Lạnh, Điều Hòa Panasonic Inverter A75C3208, A75C3706, A75C3708 - Hàng nhập khẩu",3.0,4132590681338,79000,79000,0,0,1,dien-tu-dien-lanh
277612424,Điều khiển điều hòa dành cho Daikin Inverter - Hàng chính hãng ,9.0,4338358181815,85000,85000,0,0,2,dien-tu-dien-lanh
277520108,Máy lạnh LG Inverter 1.5 HP IEC12M1.ATYGEVH - Hàng Chính Hãng,1.0,9837650019862,8550000,9890000,1340000,14,0,dien-tu-dien-lanh
276425072,Máy giặt sấy LG Inverter FV1410D4W1 10/6kg - Hàng Chính Hãng,229.0,7800790607791,9990000,9990000,0,0,0,dien-tu-dien-lanh
276238781,Điều khiển tivi giọng nói dành cho Samsung - Remote tivi dành cho samsung 4k smart - Điều khiển từ xa tivi ss - Hàng Nhập Khẩu,26.0,8206465091773,295000,295000,0,0,2,dien-tu-dien-lanh
276178085,Smart Tivi LG 4K 55 inch 55UT8050PSB - Hàng Chính Hãng,538.0,3972127357261,9490000,9490000,0,0,1,dien-tu-dien-lanh
276087240,"Remote điều khiển tất cả máy lạnh, remote điều khiển máy lạnh mới, cũ nội địa Nhật các loại (Hàng Chính Hãng)",13.0,2862074323880,32000,32000,0,0,0,dien-tu-dien-lanh
276070213,"Remote Điều Khiển TV Dành Cho SAMSUNG Smart Tivi 4K có giọng nói, QLED, loại thẳng - Hàng nhập khẩu",47.0,9501780268671,287000,287000,0,0,5,dien-tu-dien-lanh
275975448,Smart Tivi LG 4K 65 inch 65UT8050PSB - Hàng Chính Hãng,1066.0,6450504224099,11390000,11390000,0,0,2,dien-tu-dien-lanh
275905233,"Remote Điều Khiển TV Giọng Nói Dành Cho SAMSUNG Smart Tivi 4K, QLED - Hàng nhập khẩu",195.0,9552808058467,297000,297000,0,0,19,dien-tu-dien-lanh
275856361,"Điều Khiển TiVi, Remote Ti Vi dành cho SamSung - Hàng nhập khẩu",22.0,1534941172459,95000,95000,0,0,5,dien-tu-dien-lanh
275677504,MẠCH ĐÈN LED TỦ LẠNH AQUA – HÀNG CHÍNH HÃNG,12.0,1175773092511,120000,120000,0,0,2,dien-tu-dien-lanh
275576583,"Remote Điều Khiển TV Dành Cho SAMSUNG Smart Tivi 4K, QLED - NO VOICE- Hàng nhập khẩu",166.0,4443831034211,92000,92000,0,0,12,dien-tu-dien-lanh
275538176,Smart Tivi LG 4K 43 inch 43UQ7550PSF - Hàng Chính Hãng,1497.0,9408809733113,6900000,6900000,0,0,4,dien-tu-dien-lanh
275348518,Máy giặt LG Inverter 9 kg FB1209S6W1 - Hàng Chính Hãng,4977.0,2822806206823,6900000,6900000,0,0,2,dien-tu-dien-lanh
275263463,"Remote Điều Khiển Giọng Nói Smart TV, Tivi Thông Minh Dành Cho SONY BRAVIA - Hàng nhập khẩu",160.0,2222423943736,292000,292000,0,0,22,dien-tu-dien-lanh
275127044,Máy giặt LG AI DD Inverter 10 kg FV1410S4W1  - Hàng Chính Hãng,2958.0,5804798578173,7900000,7900000,0,0,0,dien-tu-dien-lanh
274614718,"Áo vệ sinh máy lạnh tổ ong cao cấp, đuôi 2.5 mét chống thấm, dụng cụ vệ sinh máy lạnh, túi vệ sinh điều hòa, hàng chính hãng, Điện Lạnh Thuận Dung",27.0,2309968092344,69000,69000,0,0,5,dien-tu-dien-lanh
274171054,"Bàn Chải Vệ Sinh Khe Máy Giặt, Nhựa Xoay 360 Độ ,Tay Cầm Dài 60cm [MÀU NGẪU NHIÊN] hàng chính hãng, Điện Lạnh Thuận Dung",19.0,1692354021131,35000,35000,0,0,1,dien-tu-dien-lanh
273168499,"Remote điều khiển tất cả máy lạnh, remote điều khiển máy lạnh mới, cũ nội địa Nhật các loại (Hàng Chính Hãng)",10.0,8515587827168,32000,32000,0,0,3,dien-tu-dien-lanh
271187763,Bộ 2 sợi dây dù treo áo vệ sinh máy lạnh dài 100 cm [ Giao màu ngẫu nhiên] hàng chính hãng - Điện Lạnh Thuận Dung,114.0,4445918784947,19998,19998,0,0,0,dien-tu-dien-lanh
263764331,Tủ lạnh Samsung Inverter 305 lít RT31CG5424B1SV - Hàng chính hãng,2.0,1127589389963,7069000,12499000,5430000,43,0,dien-tu-dien-lanh
263629878,Smart Tivi LG 4K 55 inch 55UQ7550PSF - Hàng Chính Hãng,4101.0,9526561699909,10930000,16900000,5970000,35,4,dien-tu-dien-lanh
229715461,X18ZEW - Máy lạnh Sharp Inverter 2 HP AH-X18ZEW - Hàng chính hãng - Giao HCM,6.0,1241908489739,9699000,15799000,6100000,39,1,dien-tu-dien-lanh
185655667,Điều khiển LG Magic GIỌNG NÓI Remote AN-MR19BA cho smart tivi-HÀNG CHÍNH HÃNG,35.0,9399731639655,445000,445000,0,0,8,dien-tu-dien-lanh
155113398,"khung treo tivi Led cố định 26-60INCH HOÀNG THỊNH ,HÀNG CHÍNH HÃNG.",248.0,9334056237991,45000,45000,0,0,41,dien-tu-dien-lanh
123548222,Giá treo màn hình máy tính F80 - Xoay 360 độ ,360.0,8261923619197,450000,450000,0,0,88,dien-tu-dien-lanh
102683224,Giá Treo TiVi Di Động AVA1500 Màu Đen Lắp Cho Màn Hình 32 inch - 70 inch Hàng Nhập Khẩu,134.0,2969270420618,1250000,1250000,0,0,25,dien-tu-dien-lanh
98165016,Remote điều khiển cho quạt trần Vinawind điện cơ Thống Nhất QT1400X,4.0,6667691018490,89000,89000,0,0,1,dien-tu-dien-lanh
95269693,Remote Điều Khiển Điều Hòa Đa Năng - Dễ Sử Dụng - Thích Hợp Với Tất Cả  Các Loại Máy Lạnh,78.0,5750051629629,45000,45000,0,0,7,dien-tu-dien-lanh
87180717,Áo vệ sinh máy lạnh,527.0,5913666736622,49000,49000,0,0,142,dien-tu-dien-lanh
46221893,"Hàng Chính Hãng | Giá Treo Tivi Đa Năng Góc 2 Tay Nhập Khẩu NORTH BAYOU P4 Dùng Cho Tivi 32""-55""_Full Box",176.0,9907572106509,196000,196000,0,0,35,dien-tu-dien-lanh
32505959,Remote điều khiển đa năng - Dùng được cho tất cả các dòng máy lạnh ,516.0,1930655010422,78000,78000,0,0,87,dien-tu-dien-lanh
19401965,GIÁ TREO TIVI DI ĐỘNG AVA1500 - HÀNG CHÍNH HÃNG,21.0,5432780342707,1200000,1200000,0,0,6,dien-tu-dien-lanh
15817458,"Giá Treo Tivi Gắn Tường Góc Xoay 360 độ - Nhập Khẩu | Dùng cho tivi 45-70""",99.0,1612679787640,488000,488000,0,0,23,dien-tu-dien-lanh
14620479,Điều Khiển Thường FPT Play Box 2018,76.0,9312137061856,89000,89000,0,0,4,dien-tu-dien-lanh
7633108,Đầu Thu Kỹ Thuật Số DVB T2 LTP STB-1306 Chính Hãng,22.0,1670636049170,287000,287000,0,0,6,dien-tu-dien-lanh
4374799,Giá Treo Tivi Góc Xoay Nhập Khẩu North Bayou P4 (32-55inch) ,959.0,4857976528665,184000,184000,0,0,242,dien-tu-dien-lanh
4315713,Giá Treo Tivi Góc Xoay Nhập Khẩu North Bayou P5 (32-60inch),229.0,5991072248368,390000,390000,0,0,82,dien-tu-dien-lanh
3519947,Giá treo tivi di động nhập khẩu AVA1500-60-1P (Đ8) màu đen cho tivi 32-65 inch,115.0,3397546782581,1198000,1198000,0,0,28,dien-tu-dien-lanh
277611836,Điều khiển dành cho điều hoà Mitsubishi - Hàng chính hãng ,2.0,2019520145609,79000,79000,0,0,1,dien-tu-dien-lanh
277558784,"Bộ 4 Chân Kê Máy Giặt Chống Rung, Điều Chỉnh Được Độ Cao, Đế Chống Ồn Máy Giặt, Máy Sấy, Hàng chính hãng",1.0,2144151723442,66000,66000,0,0,1,dien-tu-dien-lanh
276492183,Tủ lạnh Aqua 90 lít AQR-D100FA(BS) - Freeship toàn quốc - Hàng chính hãng - Bảo hành 2 năm,3.0,5356873451844,3590000,3590000,0,0,0,dien-tu-dien-lanh
276268195,Smart Tivi Samsung 4K 65 Inch UA65DU7700 - HÀNG CHÍNH HÃNG - CHỈ GIAO HCM,0.0,1960473823670,12090000,15990000,3900000,24,0,dien-tu-dien-lanh
275803438,Smart Tivi LG 4K 65 inch 65UT8050PSB - hàng chính hãng - Chỉ giao tại HCM,0.0,8288003465278,11629000,18999000,7370000,39,0,dien-tu-dien-lanh
275692566,"BƠM XẢ THOÁT NƯỚC THAY THẾ CHO MÁY GIẶT CỬA NGANG LG, ELECTROLUX, SAMSUNG – HÀNG NHẬP KHẨU",6.0,5880684376736,165000,165000,0,0,0,dien-tu-dien-lanh
275614367,"Điều Khiển Giọng Nói Smart TV, Tivi Thông Minh Dành Cho SONY BRAVIA - Hàng nhập khẩu",32.0,4068339388507,265000,285000,20000,7,3,dien-tu-dien-lanh
275498761,Điều khiển tivi TCL ( Hàng Chính Hãng ),43.0,7591224033436,95000,95000,0,0,4,dien-tu-dien-lanh
275378680,Anten thông minh thu sóng DVB T2 + 15m dây cáp + Jack nối (Hàng chính hãng),11.0,6609450159142,79000,79000,0,0,1,dien-tu-dien-lanh
275270796,"Chân máy giặt , tủ lạnh đủ kích thước ,Hàng Chính Hãng.",8.0,3918343114116,150000,150000,0,0,3,dien-tu-dien-lanh
275028599,Máy Giặt Sấy Panasonic Inverter Giặt 9 kg - Sấy 6 Kg NA-S96FC1LVT - Hàng Chính Hãng - Chỉ Giao HCM,0.0,5645653516743,8609000,10290000,1681000,16,0,dien-tu-dien-lanh
274917062,Điều Hòa Casper Inverter 1 Chiều 9000BTU (1HP) TC-09IS35 - Hàng Chính Hãng,1.0,8648164982610,5990000,5990000,0,0,1,dien-tu-dien-lanh
274844513,Box Truyền Hình (Nước Ngoài EVPAD 10P/10S | Trong Nước EVBOX/EVBOX Plus) Android 10 chuẩn 4K (Ram 4GB Rom 64GB | Ram 2GB Rom 32GB) - Hàng chính hãng,8.0,7399602827992,488000,488000,0,0,2,dien-tu-dien-lanh
274780857,LÒ XO NẸP CỬA TỦ LẠNH HITACHI – HÀNG CHÍNH HÃNG,11.0,8577350263198,150000,150000,0,0,2,dien-tu-dien-lanh
273787016,Tủ lạnh Casper 95 lít RO-95PG - Hàng Chính Hãng - Chỉ Giao HCM,8.0,8881305605131,2409000,3200000,791000,25,2,dien-tu-dien-lanh
272837549,"NGÀM CỬA, LẪY CỬA TỦ LẠNH HITACHI 4 CÁNH – HÀNG CHÍNH HÃNG",22.0,4681557628738,250000,250000,0,0,6,dien-tu-dien-lanh
262687684,Máy Lạnh Điều Hòa Inverter Toshiba COMFEE CFS-10VAF (1HP - 9000BTU) - Hàng Nhập Khẩu Thái Lan Của Toshiba,15.0,4782521803533,6750000,6750000,0,0,8,dien-tu-dien-lanh
196897091,"GIÁ TREO TIVI DI ĐỘNG 32-75 INCH,HÀNG CHÍNH HÃNG",53.0,8837194460044,780000,780000,0,0,8,dien-tu-dien-lanh
193878761,|THW-HCM| Máy giặt mini gấp gọn THW35 nhập khẩu chính hãng xuất USA,22.0,7128308665871,799000,1290000,491000,38,3,dien-tu-dien-lanh
191576892,"[2kg] Than hoạt tính dùng cho máy hút mùi, Than hút mùi, lọc không khí - Chính Hãng BK TOTECH",64.0,3601566142359,85000,85000,0,0,1,dien-tu-dien-lanh
185655713,"Điều khiển TV dành cho LG AN-MR18BA giọng nói, chuột bay-HÀNG CHÍNH HÃNG",82.0,3484063406766,445000,445000,0,0,13,dien-tu-dien-lanh
167558939,"Tấm Chắn Gió Điều Hòa - Hàng Chính Hãng -  Tản Nhiệt Máy Lạnh - Xoay 180 Độ , Thiết Kế Lỗ Thông Gió Nhỏ",100.0,4341384869680,129000,129000,0,0,4,dien-tu-dien-lanh
157425183,Điều khiển tivi Toshiba CT-90336,6.0,4119397272936,79000,79000,0,0,0,dien-tu-dien-lanh
123547565,Giá Treo Màn Hình NB H100 22 - 35 Inch - Tay Treo Màn Hình Máy Tính Gắn Bàn Xoay 360 Độ,131.0,6786296632106,399000,399000,0,0,30,dien-tu-dien-lanh
118053414,TÚI VỆ SINH MÁY LẠNH CAO CẤP CÓ ỐNG,10.0,9144299674417,150000,150000,0,0,0,dien-tu-dien-lanh
114924880,"Túi vệ sinh máy lạnh, đuôi 2.5 mét, miệng 1.8 mét, áo bạt trùm rửađiều hòa treo tườn, dụng cụ vệ sinh máy lạnh, tặng kèm dây xỏ, hàng chính hãng, Điện Lạnh Thuận Dung",73.0,4782520449832,68993,68993,0,0,13,dien-tu-dien-lanh
114696020,"Băng quấn bảo ôn, Simili cuốn ống cách nhiệt, băng quấn ống",171.0,8398471002011,12000,12000,0,0,6,dien-tu-dien-lanh
114078635,Giá treo 2 màn hình máy tính NB-H180 (Hàng Nhập Khẩu),110.0,2049434762510,690000,690000,0,0,27,dien-tu-dien-lanh
110791834,Giá Treo Màn Hình Máy Tính North Bayou F80 Lắp Cho Màn Hình LCD 17 inch - 30 inch Hàng Nhập Khẩu,295.0,6706874410555,658000,758000,100000,13,69,dien-tu-dien-lanh
94857614,"Chuyển hướng gió bằng sắt hoặc nhựa cao cấp, mặt nạ dành cho cục nóng điều hoà",283.0,5228667841036,199000,199000,0,0,71,dien-tu-dien-lanh
92020692,Tủ lạnh Samsung Inverter 488 lít RF48A4000B4/SV - Hàng chính hãng (chỉ giao HCM),10.0,9744799076041,14439000,25899000,11460000,44,2,dien-tu-dien-lanh
91272462,Giá Treo TiVi North Bayou P6 Xoay Đa Năng Màu Đen Mẫu 2021 Lắp Cho Màn Hình Từ 45 inch - 75 inch Nhập Khẩu,96.0,1896442648591,399000,399000,0,0,21,dien-tu-dien-lanh
68697181,"Viên nén thông tắc máy lạnh 1,5 tấn - Pan Clear màu vàng - Xử lý rong rêu, cặn bẩn - Hộp 10 viên",126.0,1902532229661,121000,121000,0,0,17,dien-tu-dien-lanh
52780228,Tủ lạnh Samsung Inverter 208 lít RT20HAR8DBU/SV - HÀNG CHÍNH HÃNG,98.0,3209953280553,4789000,7999000,3210000,40,35,dien-tu-dien-lanh
17589148,"Giá treo TV nhập khẩu NB-P6 (40""- 80"")",10.0,8551600169519,389000,389000,0,0,3,dien-tu-dien-lanh
16878549,Kệ Tivi Di Dộng Ava1500c dùng cho TV 32-65 inch ( Hàng Nhập Khẩu ),130.0,8263564398736,1250000,1250000,0,0,25,dien-tu-dien-lanh
1954105,"Máy nước nóng trực tiếp Ferroli slim DIVO SSP 4.500W, có bơm tăng áp - Hàng chính hãng",25.0,3904668709909,2610000,2610000,0,0,11,dien-tu-dien-lanh
543062,Máy Nước Nóng Ferroli Rita FS-4.5TE (4500W),44.0,1028736037182,1338000,1338000,0,0,9,dien-tu-dien-lanh
459566,Máy Nước Nóng FERROLI QQ EVO 15L ME (2500W),25.0,1027825480991,1988000,1988000,0,0,10,dien-tu-dien-lanh
277614233,"Remote Điều Khiển Dành Cho Máy Lạnh, Điều Hòa LG Inverter AKB73315601 (Kèm pin AAA) - Hàng nhập khẩu",2.0,5683471767112,79000,79000,0,0,0,dien-tu-dien-lanh
277519940,Máy lạnh LG Inverter 1 HP IEC09M1.ATYGEVH - Hàng Chính Hãng,1.0,2790700287762,7850000,9890000,2040000,21,0,dien-tu-dien-lanh
277413875,DAMPER CỬA GIÓ TỦ LẠNH PANASONIC - HÀNG CHÍNH HÃNG,1.0,1540028705925,380000,380000,0,0,0,dien-tu-dien-lanh
276503408,Freeship toàn quốc - Tủ lạnh ngăn đông trên Aqua 328L AQR-T380FA(SL) - Bảo hành 2 năm - Hàng chính hãng,1.0,5581701292103,8990000,8990000,0,0,0,dien-tu-dien-lanh
276048808,"GIÁ TREO TIVI DI ĐỘNG 32-70INCH,HÀNG CHÍNH HÃNG",11.0,4962598084507,850000,850000,0,0,1,dien-tu-dien-lanh
275765373,Box Truyền Hình EVBOX chuẩn 4K kết nối wifi HÀNG CHÍNH HÃNG. xem bóng đá ngoại hạng anh miễn phí,5.0,6746446884347,480000,480000,0,0,2,dien-tu-dien-lanh
275659244,L55MA-ASEA - Google Tivi Xiaomi A 4K 55 inch L55MA-ASEA - Hàng Chính Hãng - Chỉ Giao Hồ Chí Minh,1.0,2838291499140,7289000,9990000,2701000,27,0,dien-tu-dien-lanh
275613461,"Điều khiển Tivi dành cho SAMSUNG có Voice, remote thay thế hầu hết các loại Smart Tivi , QLED - Hàng Nhập Khẩu",39.0,4428249078991,285000,285000,0,0,4,dien-tu-dien-lanh
275269727,Google Tivi Sony 4K 43 inch K-43S30 Mới 2024 - Hàng chính hãng - Giao HCM và 1 số tỉnh thành,3.0,4847032970255,12581000,14400000,1819000,13,1,dien-tu-dien-lanh
275244440,Máy giặt LG Inverter 9 kg FB1209S6W - Hàng chính hãng - Giao HCM và 1 số tỉnh thành,1.0,1619797241567,6897000,7700000,803000,10,0,dien-tu-dien-lanh
275196464,"chân tivi đa năng nhập khẩu 26-75inch ,Hàng Chính Hãng",10.0,3862515338090,179000,179000,0,0,2,dien-tu-dien-lanh
273905380,Máy sấy bơm nhiệt LG 9 kg DVHP09W - Hàng chính hãng,420.0,2592918462767,14900000,14900000,0,0,0,dien-tu-dien-lanh
273445958,Giá Treo TiVi Thẳng Cố Định 32-55 Inch - Hàng Chính Hãng,9.0,5395220631826,99000,99000,0,0,0,dien-tu-dien-lanh
273353940,Chân Kê Máy Giặt Tủ Lạnh Loại To 8 Trụ 4 Bánh - Chịu Lực Tối Đa 200kg - Hàng Chính Hãng V SportLike,300.0,6859293716879,350000,350000,0,0,2,dien-tu-dien-lanh
272850060,Máy giặt LG AI DD Inverter 9 kg FV1409S4M - Hàng Chính Hãng - Giao HCM,1.0,3980855789338,8832000,10000000,1168000,12,0,dien-tu-dien-lanh
271438039,Máy nước nóng trực tiếp ARISTON AURES PREMIUM + 4.5 HÀNG CHÍNH HÃNG,16.0,3296095300492,2399000,2399000,0,0,3,dien-tu-dien-lanh
270100821,TỦ LẠNH TOSHIBA GR-RT252WE-PMV(52) 194 Lít - hàng chính hãng - chỉ giao HCM,0.0,4995427288597,4799000,7999000,3200000,40,0,dien-tu-dien-lanh
255421912,Máy Giặt Mini Tự Động Máy Giặt Gấp Gọn,26.0,4917846973721,255000,255000,0,0,3,dien-tu-dien-lanh
252580700,Máy lạnh Casper GC-12IS35 inverter 1.5HP - Hàng chính hãng (chỉ giao HCM),6.0,5470389372614,6628000,7700000,1072000,14,0,dien-tu-dien-lanh
208498986,Điều khiển tivi Toshiba CT-8068 ( Hàng Chính Hãng ),25.0,4345670222341,95000,95000,0,0,0,dien-tu-dien-lanh
203317290,"Giá Treo Tivi Xoay Góc đa năng P6 từ 40-80 inch, hàng Nhập Khẩu ",45.0,8606749568210,450000,450000,0,0,4,dien-tu-dien-lanh
201679034,Máy giặt Toshiba 8 kg AW-M905BV(MK) - Hàng chính hãng (Chỉ giao HCM) ,41.0,2791686407167,4019000,6799000,2780000,41,11,dien-tu-dien-lanh
197572104,Máy Rửa Chén Ecalite EDW-SMS6080WH (Trắng) - 8 Bộ - 6 Chương Trình Rửa - Hàng Chính Hãng,11.0,7351026511941,11000000,11000000,0,0,5,dien-tu-dien-lanh
186107153,"Set 4 cái chân đế cao su đặc chống rung lắc, va đập, trơn trượt cho máy giặt, tủ lạnh, bàn ghế, thiết bị điện Morado- Hàng chính hãng",13.0,6549210774660,99000,99000,0,0,2,dien-tu-dien-lanh
174311813,Tủ lạnh Electrolux 45 lít EUM0500AD-VN - Hàng chính hãng (chỉ giao HCM),1.0,4258975751894,2449000,3790000,1341000,35,0,dien-tu-dien-lanh
142709389,Tủ Lạnh Aqua Inverter 212 Lít AQR-T239FA(HB)  HÀNG CHÍNH HÃNG chỉ giao  Hồ Chí Minh ,3.0,7733909464339,4709000,7899000,3190000,40,1,dien-tu-dien-lanh
115993780,Remote máy lạnh đa năng,12.0,7218658361699,43000,43000,0,0,1,dien-tu-dien-lanh
105626609,Phao máy giặt các loại,15.0,5378188357438,61750,61750,0,0,3,dien-tu-dien-lanh
100087607,"điều khiển NETBOX B2 ,KÈM PIN AAA Tìm Kiếm Giọng Nói ,BAY  HÀNG CHÍNH HÃNG",37.0,3271045117179,149900,149900,0,0,16,dien-tu-dien-lanh
91272600,Giá Treo TiVi Di Động North Bayou AVA1500 Màu Đen Lắp Cho Màn Hình 32 inch - 65 inch Nhập Khẩu,21.0,6357905771203,1190000,1190000,0,0,4,dien-tu-dien-lanh
75815880,"Bộ 04 chân đế cao su chống rung máy giặt   - HT SYS - Đế chống rung máy giặt - Đế chống ồn máy giặt, máy sấy,tủ lạnh, bàn ghế - Giao màu ngẫu nhiên",4.0,3428367938083,55000,55000,0,0,132,dien-tu-dien-lanh
73947787,Điều Khiển giọng nói NETBOX V2 - Tích hợp MIC VOICE siêu nhạy - Hàng chính hãng,25.0,3854585042088,115000,115000,0,0,8,dien-tu-dien-lanh
62754437,Giá treo ti vi có tay kéo XOAY TRÁI PHẢI NBP6- 2021 cho ti vi 45 -75 inch (Northbayou VIỆT NAM phân phối chính hãng ),20.0,8887076279675,383000,383000,0,0,5,dien-tu-dien-lanh
54020025,"Android MyTV Net RAM 2G- 2020 Tặng Tài khoản HDplay, Android 7.1.2 hỗ trợ điều khiển Giọng nói - Hàng chính hãng",15.0,1975242615369,695000,695000,0,0,5,dien-tu-dien-lanh
53639843,Tủ Lạnh Inverter Samsung 208 Lít RT20HAR8DBU/SV- Hàng Chính Hãng - Chỉ Giao tại HCM,37.0,5407881736182,4799000,7999000,3200000,40,8,dien-tu-dien-lanh
49291897,"Chân đế TV LCD 19-75 inch, chân đế TV để bàn cho tất cả các loại tivi Samsung, LG, Sony, TCL, Panasonic, Sharp, vv - Hàng Nhập Khẩu",208.0,5895967296819,188000,188000,0,0,36,dien-tu-dien-lanh
15972213,Giá Treo Tivi Máy Tính Để Bàn F80 (17-27 inch) - Hàng nhập khẩu,205.0,1412742646979,354000,354000,0,0,44,dien-tu-dien-lanh
15672319,Giá Treo 2 Màn Hình Để Bàn F160 (17-27 inch) - Hàng Nhập Khẩu,151.0,8784376627734,559000,559000,0,0,34,dien-tu-dien-lanh
7749111,Android Tivi Box Xiaomi Mibox S 4K Global Quốc Tế - Hàng Chính Hãng,44.0,9373212539783,1389000,1389000,0,0,14,dien-tu-dien-lanh
459562,Máy Nước Nóng Gián Tiếp FERROLI QQ EVO 30L M (2500W) - Hàng Chính Hãng,17.0,1021542005611,2395000,2395000,0,0,4,dien-tu-dien-lanh
277612174,Điều Khiển Điều Hòa 1 Chiều Cho Panasonic - Hàng chính hãng ,2.0,2697282975922,79000,79000,0,0,0,dien-tu-dien-lanh
277539329,"Smart Tivi Toshiba 43 inch Full HD 43E31MP, Lắp Đặt Toàn Quốc -Hàng Chính Hãng",1.0,8437068326260,6990000,10990000,4000000,36,1,dien-tu-dien-lanh
277416831,Tủ lạnh Aqua 130 lít AQR-T160FA(BS) - Hàng chính hãng,1.0,3696540629982,4190000,4690000,500000,11,0,dien-tu-dien-lanh
276343117,DAMPER CỬA GIÓ THAY THẾ TỦ LẠNH ELECTROLUX – HÀNG CHÍNH HÃNG,2.0,1820398710843,450000,450000,0,0,0,dien-tu-dien-lanh
276271026,Máy giặt Electrolux UltimateCare 300 Inverter 10 kg EWF1024D3WC - HÀNG CHÍNH HÃNG - CHỈ GIAO HCM,1.0,4656359878140,8990000,12990000,4000000,31,0,dien-tu-dien-lanh
276157621,"Thiết bị khuếch đại tín hiệu sóng Anten KTS Mặt Đất DVB-T2 dò được nhiều kênh, đường truyền ổn định, hàng nhập khẩu",10.0,2407786473407,62000,62000,0,0,1,dien-tu-dien-lanh
275465010,Remote điều khiển đầu thu VNPT SMARTBOX SMART BOX sử dụng 2 viên pin AA phím bấm mềm êm tay - Hàng nhập khẩu,9.0,1181266648588,85000,85000,0,0,1,dien-tu-dien-lanh
275438704,Máy giặt Cửa Trước Panasonic 9kg NA-V90FA1LVT - Giặt thông minh - Giặt diệt khuẩn - Tự động vệ sinh lồng giặt & vòng đệm - Hàng chính hãng,1.0,1896452787211,8849000,9390000,541000,6,0,dien-tu-dien-lanh
275378828,"Anten Trong Nhà, Tích Hợp với TIVI & Đầu Thu KTS, DVB T2 (Hàng chính Hãng) ",14.0,8759134094898,149000,149000,0,0,1,dien-tu-dien-lanh
275265201,"Chai xịt vệ sinh máy lạnh, máy điều hòa 520ml vệ sinh điều hòa, khử khuẩn - Hàng nhập khẩu",5.0,2135201559856,75000,75000,0,0,3,dien-tu-dien-lanh
275245136,Smart Tivi QNED LG 4K 65 inch 65QNED86TSA Mới 2024 - Hàng chính hãng - Giao HCM và 1 số tỉnh thành,1.0,5689550824207,18953000,22700000,3747000,17,0,dien-tu-dien-lanh
274855604,Máy Lạnh Casper Inverter 1.5 H.p QC-12IS36 - Hàng chính hãng - Giao HCM và 1 số tỉnh thành,1.0,5680587970711,6309000,10199000,3890000,38,0,dien-tu-dien-lanh
274156203,REMOTE ĐIỀU KHIỂN SMART TIVI LG MODEL 2023 MR23GA – HÀNG CHÍNH HÃNG,5.0,1898851929927,595000,595000,0,0,0,dien-tu-dien-lanh
274031620,Chuột Bay g10s Điều Khiển Tìm Kiếm Giọng Nói Air Mouse Remote Voice tìm kiếm nội dung bằng giọng nói và cử chỉ tay người dùng - Hàng Nhập Khẩu,20.0,9690070558980,81081,81081,0,0,4,dien-tu-dien-lanh
273386285,Khung mâm chính hãng CP giá treo tivi led cố định cho mọi hãng tivi từ 43-100 inch kèm ốc vít M100 - Hàng Chính Hãng,2.0,8267589838007,116000,116000,0,0,0,dien-tu-dien-lanh
254138309,Máy lạnh Mitsubishi Heavy Inverter 1.5 HP SRK13YXS-W5 - Hàng chính hãng - Chỉ giao HCM,0.0,1306396821249,14749000,15990000,1241000,8,0,dien-tu-dien-lanh
252295492,"anten bàn HOÀNH KIẾN ĐẠT 105 cho chung cư cao tầng hoặc nhà gần trạm phát sóng DVB T2, Hàng Chính Hãng.",86.0,3018426621852,188000,188000,0,0,18,dien-tu-dien-lanh
205924678,Máy giặt Toshiba 8 kg AW-M905BV(MK) - Chỉ giao HCM,13.0,6665980168764,4089000,6799000,2710000,40,5,dien-tu-dien-lanh
200653390,Máy giặt mini DOUX LUX phiên bản mới nhất bảo hành 1 năm - Hàng nhập khẩu,1.0,3959262467596,3948000,3949000,1000,0,0,dien-tu-dien-lanh
184897356,Khung mâm giá treo tivi led cố định CP hàng loại dày  từ 19-65inch - Hàng chính hãng,1.0,6841552812577,115000,115000,0,0,0,dien-tu-dien-lanh
184475236,Khung kệ treo tivi cố định Cảnh Phong hàng loại dày kích thước từ 19-85inch - Hàng Chính Hãng,22.0,3649700677021,80000,80000,0,0,1,dien-tu-dien-lanh
171447474,Tủ Lạnh Mini KEMIN 25L Chính Hãng - Chỉnh Nhiệt - màu Xanh,5.0,8835748024393,2350000,2350000,0,0,0,dien-tu-dien-lanh
157425785,ĐIỀU KHIỂN DÙNG CHO PANASONIC THƯỜNG 1 CHIỀU,41.0,3446420072165,95000,95000,0,0,6,dien-tu-dien-lanh
123548101,Giá Treo Máy Tính Hai Màn Hình NB H180 22-32 Inch -Hàng Chính hãng ,359.0,9348455194253,690000,690000,0,0,83,dien-tu-dien-lanh
123547771,Khung giá treo tivi di động AVA1500 hàng chính hãng model mới từ 32 - 65inch,48.0,2607076366223,1330000,1330000,0,0,9,dien-tu-dien-lanh
116135563,Sò lạnh tủ lạnh  Nhật âm 4 loại tốt,33.0,3708915759635,30000,30000,0,0,3,dien-tu-dien-lanh
114447971,Giá Treo Màn Hình NB H100 22 - 35 Inch - Hàng chính hãng,49.0,8396892714352,349000,349000,0,0,13,dien-tu-dien-lanh
104810156,ĐIỀU KHIỂN TIVI PANASONIC (SP 1166)HÀNG NHẬP KHẨU,59.0,9722278226982,57000,57000,0,0,16,dien-tu-dien-lanh
102583133,Van cấp nước dành cho máy giặt SANYO các loại,8.0,2436187908614,45000,45000,0,0,0,dien-tu-dien-lanh
88789945,"Remote Điều Khiển Dành Cho Máy Lạnh, Điều Hòa Không Khí DAIKIN ARC480A33 - Hàng chính hãng",32.0,4632068400722,88000,88000,0,0,5,dien-tu-dien-lanh
73157319,Máy giặt cửa trên Toshiba Inverter 9.0 kg AW-DK1000FV(KK) Model 2020 - Chỉ giao HCM,1.0,9142695537117,5769000,9399000,3630000,39,0,dien-tu-dien-lanh
70202311,Máy tắm nước nóng OTTOWA TH4501- Hàng chính hãng,3.0,2256339161426,2749000,2749000,0,0,1,dien-tu-dien-lanh
68760491,Máy nước nóng Ariston SL BLU 20 - 2.5 - FE (2500W),3.0,7016129950655,2369000,3400000,1031000,30,1,dien-tu-dien-lanh
56713023,MÁY NƯỚC NÓNG TRỰC TIẾP AMORE GSN 4.500W -HÀNG CHÍNH HÃNG,23.0,4616006776137,2090000,2090000,0,0,7,dien-tu-dien-lanh
21180803,Giá treo tivi đa năng North Bayou P5 (32-60 Inch) - Hàng Chính Hãng,68.0,9519763956284,395000,395000,0,0,25,dien-tu-dien-lanh
15870462,Giá Treo Góc Xoay Vuông Góc 90 Độ NBSP5 (50-80 Inch) - Hàng Nhập Khẩu,0.0,2576217453611,1748700,1748700,0,0,0,dien-tu-dien-lanh
14867897,Điều khiển tivi SHARP Internet LCD-LED - hàng chính hãng,49.0,3157048262598,110000,110000,0,0,16,dien-tu-dien-lanh
10214414,Android TV Mi Box S 2018 4K Quốc Tế - Hàng Nhập Khẩu,58.0,7350957523347,1390000,1390000,0,0,10,dien-tu-dien-lanh
4678979,Giá Treo Tivi Tay Dài Vuông Góc 90 Độ Nhập Khẩu North Bayou SP2  (40-70 inch),1.0,1969403163158,1250000,1250000,0,0,0,dien-tu-dien-lanh
459554,Máy Nước Nóng Gián Tiếp FERROLI QQ EVO 15L M (2500W) - Hàng Chính Hãng,6.0,1025435423063,2097000,2097000,0,0,5,dien-tu-dien-lanh
277545002,Chân Đế Máy Giặt Bộ 4 Chân Chống Rung Chống Trơn Trượt Có Thể Điều Chỉnh Tăng Giảm Đa Năng - Hàng chính hãng dododios,1.0,2313420694189,29000,29000,0,0,1,dien-tu-dien-lanh
277304404,Tủ Lạnh LG Inverter 461 Lít LTB46BLG - HÀNG CHÍNH HÃNG - CHỈ GIAO HCM,1.0,3010937300110,11389000,17990000,6601000,37,0,dien-tu-dien-lanh
277207564,"LƯỚI LỌC MÁY GIẶT AQUA 10KG (AQW - FR100ET, DR100ET, DR110FT, DR105FT) HÀNG CHÍNH HÃNG",152.0,3745666992543,145000,145000,0,0,20,dien-tu-dien-lanh
276389560,Smart TV Full HD Coocaa 43 Inch 43S3U+ - Hàng Chính Hãng,199.0,1210504955134,3390000,3390000,0,0,0,dien-tu-dien-lanh
276271291,Máy giặt Electrolux UltimateCare 900 Inverter 11 kg EWF1142R9SC - HÀNG CHÍNH HÃNG - CHỈ GIAO HCM,0.0,3444171229840,17759000,21300000,3541000,17,0,dien-tu-dien-lanh
276145982,Tủ lạnh LG Inverter 508 lít Multi Door InstaView LFI50BLMAI - hàng chính hãng - chỉ giao nội thành HCM,0.0,1378309592453,28725000,37400000,8675000,23,0,dien-tu-dien-lanh
276087801,"Remote điều khiển máy lạnh nội địa Nhật, điều khiểu máy lạnh điều hòa (xả hàng) (Hàng Chính Hãng)",1.0,2490144730959,32000,32000,0,0,0,dien-tu-dien-lanh
276087799,"Điều khiển remote tất cả máy lạnh thay thế remote cũ nội địa Nhật, Thái Lan, Việt Nam (có hàng sẵn) (Hàng Chính Hãng)",2.0,9391008961277,32000,32000,0,0,0,dien-tu-dien-lanh
275709316,DÂY CÁP ĐỒNG TRỤC RG6 100YA HÀNG CHÍNH HÃNG 2 LỚP BẠC,3.0,7365146023611,188000,188000,0,0,3,dien-tu-dien-lanh
275187246,"Chân Đế Máy Giặt, Kệ Máy Giặt Và Tủ Lạnh Daikiosan Có Thể Điều Chỉnh Kích Thước Phù Hợp Mọi Loại Thiết Bị - Hàng Chính Hãng",3.0,1458645446316,310000,310000,0,0,0,dien-tu-dien-lanh
274870710,Smart QLED Tivi 4K Samsung 55Q60DA 55 inch QA55Q60DA QA55Q60D 55Q60D - Hàng chính hãng - Chỉ giao HCM,1.0,1391428144813,11289000,12890000,1601000,12,0,dien-tu-dien-lanh
274447767,Máy Lạnh Panasonic CU/CS-RU9AKH-8 Inverter 1HP - Hàng Chính Hãng (Chỉ Giao HCM),0.0,8241381084060,9429000,15699000,6270000,40,0,dien-tu-dien-lanh
274356803,"Máy lạnh Samsung AR13DYHZAWKNSV Digital Inverter 12,000 BTU/h (HÀNG CHÍNH HÃNG - CHỈ GIAO HCM)",1.0,8785225318691,7329000,12599000,5270000,42,1,dien-tu-dien-lanh
274115035,Mâm Máy Giặt Dành Cho TOSHIBA Hàng nhập khẩu 37cm Hàng nhập khẩu - Điện lạnh Thuận Dung,5.0,7979278796246,280000,280000,0,0,0,dien-tu-dien-lanh
274034438,Android T95H 4GB RAM 32GB ROM ANDROID 10 CÀI SẴN ỨNG DỤNG XEM PHIM HD VÀ TRUYỀN HÌNH CÁP miễn phí vĩnh viễn - Hàng Nhập Khẩu,1.0,4832307467989,890000,890000,0,0,0,dien-tu-dien-lanh
273472182,Máy giặt Electrolux Inverter 10 kg EWF1025DQWB - Hàng chính hãng - Giao HCM và 1 số tỉnh thành,2.0,5956594020839,7519000,12299000,4780000,39,0,dien-tu-dien-lanh
273284723,CẦN GẠT LẤY NƯỚC TỦ LẠNH LG – HÀNG CHÍNH HÃNG,8.0,6590678291755,250000,250000,0,0,4,dien-tu-dien-lanh
273171839,"Remote điều khiển máy lạnh nội địa Nhật, điều khiểu máy lạnh điều hòa (xả hàng) (Hàng Chính Hãng)",3.0,5332247089246,32000,32000,0,0,0,dien-tu-dien-lanh
272052268,Điều khiển tivi Toshiba CT-90336 ( Hàng Chính Hãng ),10.0,6566683144353,95000,95000,0,0,0,dien-tu-dien-lanh
261947472,Máy lạnh Panasonic Inverter 1 HP CU/CS-XU9ZKH-8 - Hàng Chính Hãng - Giao Hàng Toàn Quốc,0.0,7693189996427,12400000,12400000,0,0,0,dien-tu-dien-lanh
253016547,Máy lạnh LG Inverter 1 HP V10API1 - Hàng Chính Hãng,0.0,2769926776002,7290000,7290000,0,0,0,dien-tu-dien-lanh
205899428,Remote điều khiển từ xa quạt Lifan - Màu đen,26.0,8073161201165,85000,85000,0,0,6,dien-tu-dien-lanh
194456469,Máy nước nóng trực tiếp Ariston 4500W AURES PREMIUM 4.5 - Hàng Chính Hãng,1.0,7726510909934,1999000,2920000,921000,32,0,dien-tu-dien-lanh
189658693,"Máy lạnh di động 7000 BTU Fujihome PAC07, điều hòa di động mini 4 trong 1 làm lạnh, hút ẩm, quạt, lọc không khí, điều khiển từ xa - Hàng chính hãng",43.0,5061334409626,6500000,6500000,0,0,19,dien-tu-dien-lanh
178331613,BỘ 2 TẤM LƯỚI LỌC MÁY LẠNH PANASONIC 1HP– HÀNG CHÍNH HÃNG,5.0,3411740233611,180000,180000,0,0,1,dien-tu-dien-lanh
162152249,Tủ lạnh mini Kemin Chính hãng 10L,156.0,3420054231156,1300000,1300000,0,0,34,dien-tu-dien-lanh
119692012,"CÔNG TẮC CỬA MÁY GIẶT ELECTROLUX EWF 10843, 10844, 10744, 12843, 85743, 12944 - HÀNG CHÍNH HÃNG",54.0,5157711336961,275000,275000,0,0,8,dien-tu-dien-lanh
118537278,Smart Tivi Coocaa HD 32 inch 32S3U,4.0,4472032224426,3100000,3100000,0,0,3,dien-tu-dien-lanh
116396523,Van cấp nước dành cho máy giặt đơn TOSHIBA,15.0,8064652345692,50000,50000,0,0,3,dien-tu-dien-lanh
114853076,Giá Treo Tivi từ 14 – 42 inch đa năng,2.0,8630291895341,75000,75000,0,0,1,dien-tu-dien-lanh
113048561,Điều khiển điều hòa 1 chiều Daikin - Hàng Chính Hãng,9.0,5230322441977,69000,69000,0,0,2,dien-tu-dien-lanh
109190689,DÂY CUROA MÁY SẤY ELECTROLUX 7PH 1930 - HÀNG CHÍNH HÃNG,212.0,4265118016062,130000,130000,0,0,19,dien-tu-dien-lanh
107223650,Smart Tivi LG Full HD 43 inch 43LM5750PTC,10.0,1882121010973,6729000,8700000,1971000,23,2,dien-tu-dien-lanh
106083056,Cánh quạt dùng cho máy làm mát hơi nước các loại,11.0,7889937824968,170000,170000,0,0,1,dien-tu-dien-lanh
91550407,Máy Nước Nóng Ariston SL BLU 30 - 2.5 - FE (2500W) Hàng Chính Hãng,25.0,7837038677757,2549000,2549000,0,0,8,dien-tu-dien-lanh
91272464,Giá Treo TiVi Xoay Đa Năng North Bayou P4 Mẫu 2021 Màu Đen Lắp Cho Màn Hình 32 inch - 55 inch Nhập Khẩu,201.0,6094049181290,189000,189000,0,0,51,dien-tu-dien-lanh
77918979,TỦ ĐÔNG SANAKY 208 LÍT VH-255A2 NHÔM (R600A) (HÀNG CHÍNH HÃNG) (CHỈ GIAO HCM),0.0,9033452274758,5637000,5637000,0,0,0,dien-tu-dien-lanh
49360002,Khuếch Đại Truyền Hình Cáp PACIFIC DA20,75.0,1584631108711,279000,279000,0,0,24,dien-tu-dien-lanh
19844214,Hộp Android tivi box MyTVNet Net 1 - Hàng Chính Hãng,17.0,2096872161862,699000,699000,0,0,4,dien-tu-dien-lanh
4175491,Máy Nước Nóng Ferroli VERDI 30L AE (2500W),8.0,2463512728257,2830000,2830000,0,0,1,dien-tu-dien-lanh
277614201,"Remote Điều Khiển Cho Máy Lạnh, Điều Hòa Panasonic A75C4137, A75C2913, CS-E9EKU - Hàng nhập khẩu",1.0,3592764437801,79000,79000,0,0,0,dien-tu-dien-lanh
277429931,"Smart Tivi Xiaomi TV A43"" FUD 2025 - 43 Inch - Hàng Chính Hãng, Bảo Hành 24 Tháng",0.0,2045920803792,5990000,5990000,0,0,0,dien-tu-dien-lanh
276931435,Tivi Android  LED Hisense 40 inch 40A4N - HÀNG CHÍNH HÃNG - CHỈ GIAO HCM,2.0,3156007575433,7990000,7990000,0,0,0,dien-tu-dien-lanh
276884866,"Máy Giặt Hisense 8kg WTZQ8012UT Bộ Giặt Xơ Vải Làm Sạch, Vệ Sinh Lồng Giặt, Vắt Khô, Bảo Hành Chính Hãng 24 Tháng - Hàng Chính Hãng",1.0,9466397771306,4590000,7890000,3300000,42,0,dien-tu-dien-lanh
276492187,[DAILY] Tủ lạnh AQUA ngăn đá trên 130L AQR-T160FA(BS) - Freeship toàn quốc - Hàng chính hãng - Bảo hành 2 năm,2.0,2799171768361,4890000,4890000,0,0,0,dien-tu-dien-lanh
276379149,Máy giặt Aqua 9 kg AWM9-316K(B) - Bảo hành 2 năm - Hỗ trợ lắp đặt - Hàng chính hãng,2.0,2323343682736,6190000,6190000,0,0,0,dien-tu-dien-lanh
276252722,Smart Tivi LG 4K 65 inch 65UT7350PSB - HÀNG CHÍNH HÃNG - CHỈ GIAO HCM,0.0,5557636760819,11239000,15990000,4751000,30,0,dien-tu-dien-lanh
275686537,"Dây cấp nước máy giặt lồng đứng các loại 1.5m, 2m, 3m - Hàng chính hãng",4.0,4560313083951,69000,69000,0,0,0,dien-tu-dien-lanh
274356503,"Máy lạnh Samsung AR10DYHZAWKNSV Digital Inverter 9,000 BTU/h (HÀNG CHÍNH HÃNG - CHỈ GIAO HCM)",0.0,2912001909568,6249000,10899000,4650000,43,0,dien-tu-dien-lanh
273682944,Tủ Lạnh Sharp Inverter 215 Lít SJ-X215V-SL - Hàng Chính Hãng (Chỉ giao HCM),3.0,4188862427682,4539000,7399000,2860000,39,0,dien-tu-dien-lanh
273458681,Tủ lạnh Casper Inverter 458 lít Side By Side RS-460PG - Hàng chính hãng - Chỉ giao HCM,2.0,7291737155955,8469000,13799000,5330000,39,0,dien-tu-dien-lanh
272748477,Smart Tivi LG 4K 43 Inch 43UQ7050PSA - Model 2023,2.0,9208669014407,7092000,8300000,1208000,15,1,dien-tu-dien-lanh
271304184,Tủ lạnh Toshiba GR-RT234WE-PMV(52) Inveter 2023 - Hàng Chính Hãng (chỉ giao HCM),10.0,3437997259610,4639000,7899000,3260000,41,3,dien-tu-dien-lanh
262687934,Máy Lạnh Điều Hòa Inverter Toshiba COMFEE CFS-13VAF (1.5HP-12.000BTU) - Hàng Nhập Khẩu Thái Lan Của Toshiba,1.0,7151522597258,7900000,7900000,0,0,0,dien-tu-dien-lanh
252179398,"Máy lạnh di động 12.000 BTU FUJIHOME PAC12, máy lạnh đứng di động mini kết nối Wifi điều khiển qua App, 4 chức năng, làm lanh, hút ẩm, lọc không khí, quạt - Hàng chính hãng",4.0,6867071232992,14000000,14000000,0,0,2,dien-tu-dien-lanh
249145993,Máy lạnh Panasonic Inverter 1.5 HP CU/CS-XU12ZKH-8 - Chỉ giao HCM,0.0,5771798053830,15391000,18100000,2709000,15,0,dien-tu-dien-lanh
231072585,Hệ Thống Máy Lạnh Multi Split Panasonic Inverter Combo Công suất 3HP + 03 dàn lạnh 1.0HP - Hàng Chính Hãng,0.0,4901770925491,34125000,34125000,0,0,0,dien-tu-dien-lanh
230311943,Giá Treo Tivi Góc Xoay Đa Năng 45 - 80 Inch Model: NB P6 - HÀNG CHÍNH HÃNG,24.0,8724084974755,385000,385000,0,0,4,dien-tu-dien-lanh
213701862,"Điều hòa di động 9000 BTU-14.000 BTU FUJIHOME, máy lạnh đứng di động mini 4 chức năng, làm lanh, hút ẩm, lọc không khí, quạt điều khiển qua App, không cần lắp đặt - Hàng chính hãng",83.0,7356653725455,9000000,9000000,0,0,31,dien-tu-dien-lanh
202490833,Google Tivi Sony 4K 43 inch KD-43X75K VN3 - Hàng chính hãng,0.0,6768557735844,8709000,14199000,5490000,39,0,dien-tu-dien-lanh
201686993,MÁY GIẶT TOSHIBA 9kg AW-M1000FV(MK) - Hàng chính hãng( Chỉ giao HCM),3.0,5545099600966,5039000,8299000,3260000,39,1,dien-tu-dien-lanh
197596814,Máy Giặt Sharp Inverter 7.5 Kg ES-Y75HV-S -Hàng chính hãng( Chỉ giao HCM),21.0,1312680521922,3269000,5199000,1930000,37,4,dien-tu-dien-lanh
191689962,Smart Tivi 4K Sony KD-43X75K 43 inch Google TV - Hàng Chính Hãng,0.0,5381248584219,8659000,14199000,5540000,39,0,dien-tu-dien-lanh
186391912,Tủ lạnh Sharp Inverter 362 lít SJ-FX420VG-BK - Hàng chính hãng (chỉ giao HCM),0.0,4440676973642,12290000,17200000,4910000,29,0,dien-tu-dien-lanh
177629263,[HCM] Tủ Lạnh Electorlux EUM0930BD-VN / EUM0930AD-VN - Dung Tích 94L - Hàng Chính Hãng,0.0,5433432734364,3439000,5499000,2060000,37,0,dien-tu-dien-lanh
177609910,[HCM] Tủ Lạnh Mini Bar Electrolux EUM0500AD-VN - Dung Tích 45 lít - Hàng Chính Hãng,35.0,2000224511554,2569000,3700000,1131000,31,7,dien-tu-dien-lanh
174241109,Máy lạnh Toshiba Inverter 1.5 HP RAS-H13E2KCVG-V-Hàng Chính Hãng-Giao Hàng Toàn Quốc.,3.0,5807874181404,11539000,18299000,6760000,37,1,dien-tu-dien-lanh
171091306,Máy lạnh Funiki 1.0 HP HSC09TMU - Hàng chĩnh hãng (chỉ giao HCM),1.0,1619335469569,4479000,7399000,2920000,39,1,dien-tu-dien-lanh
146363487,Hệ Thống Máy Lạnh Multi S Daikin Inverter Combo 2HP + 02 dàn lạnh 1.0HP + 1.5HP - MKC50RVMV/CTKC25RVMV+CTKC35RVMV - Hàng Chính Hãng - Chỉ giao tại TP.HCM,1.0,8729265079126,22042000,22042000,0,0,0,dien-tu-dien-lanh
140192388,"Giá treo tivi thẳng tường cố định hàng xuất khẩu dùng cho tivi siêu mỏng, Hàng Chính Hãng.",18.0,8167790036476,166900,166900,0,0,1,dien-tu-dien-lanh
133736092,"MAGIC REMOTE LG ANMR21, MR21GA (2021) – HÀNG CHÍNH HÃNG",20.0,7347996378905,595000,595000,0,0,6,dien-tu-dien-lanh
102088301,Máy Nước Nóng Gián Tiếp Ariston Vitaly 15L Hàng chính hãng,33.0,9955043450719,1839000,1839000,0,0,7,dien-tu-dien-lanh
85378388,Máy giặt Samsung Inverter 10kg WW10TP44DSH/SV - Chỉ giao HCM,0.0,8267404540477,7790000,7790000,0,0,0,dien-tu-dien-lanh
85376469,"ANTEN BÀN DVB T2 HKD 105 HOÀNH KIẾN ĐẠT ,HÀNG CHÍNH HÃNG.",142.0,5869038261300,195000,195000,0,0,33,dien-tu-dien-lanh
51235920,Điều Hòa Daikin 9300 BTU FTF25UV1V - Chỉ giao tại Hà Nội,0.0,5875072024866,7950000,7950000,0,0,0,dien-tu-dien-lanh
50560441,Tủ Lạnh Aqua 130 lít AQR-T150FA-BS,16.0,4430813501702,4408000,4408000,0,0,6,dien-tu-dien-lanh
50560420,Tủ lạnh Aqua 90 lít AQR-D99FA(BS),55.0,7082803191232,2799000,2799000,0,0,13,dien-tu-dien-lanh
7532597,Smart Tivi Asanzo Full HD 43 inch 43AS560,4.0,5710820581591,4699000,4699000,0,0,2,dien-tu-dien-lanh
3716571,Giá treo màn hình máy tính nhập khẩu 1 tay NB F80 cho màn hình 17-27inch,78.0,1838003392704,365000,365000,0,0,11,dien-tu-dien-lanh
1956689,"Bình nước nóng Ferroli Verdi DE20L, 3 công suất, hiển thị nhiệt độ, có chống giật, 2500W - Hàng Chính Hãng",0.0,7565185473443,2530000,2530000,0,0,0,dien-tu-dien-lanh
276952099,"Máy Giặt Hisense 13kg WTJH1313UB Giặt thông minh AI tiết kiệm điện và nước, bảo hành 2 năm - HÀNG CHÍNH HÃNG",1.0,4129716828300,9990000,9990000,0,0,0,dien-tu-dien-lanh
276606084,"Máy nước nóng Năng lượng mặt trời Tân Á GO 130L 160L 180L 200L 230L 300L Chính hãng, Chỉ bán khu vực miền Bắc",1.0,2413390973474,5545000,7899000,2354000,30,0,dien-tu-dien-lanh
276379775,"Tủ lạnh Mini Bar Hisense 94 Lít HR09DB làm lạnh nhanh, tiết kiệm điện, bảo hành 24 tháng - HÀNG CHÍNH HÃNG",0.0,5266276513634,2549000,3990000,1441000,36,0,dien-tu-dien-lanh
276377624,"Tủ lạnh Mini Bar Hisense 45 Lít HR05DB tiết kiệm điện, thiết kế gọn nhẹ, bảo hành 24 tháng - HÀNG CHÍNH HÃNG",0.0,1916780418730,2090000,2990000,900000,30,0,dien-tu-dien-lanh
276331456,Tủ lạnh Samsung Inverter 583 lít Side By Side RS57DG400EM9SV - HÀNG CHÍNH HÃNG - CHỈ GIAO HCM,0.0,6247557839412,14290000,15990000,1700000,11,0,dien-tu-dien-lanh
276094790,"Remote điều khiển tất cả máy lạnh nội địa Nhật, Việt Nam (Hàng Nhập Khẩu)",1.0,2440531255285,32000,32000,0,0,0,dien-tu-dien-lanh
276087883,"Điều khiển Remote tất cả máy lạnh hiện nay thay thế khi bị hư Remote cũ, nội địa Nhật loại tốt (Hàng Chính Hãng)",3.0,6039340134575,32000,32000,0,0,0,dien-tu-dien-lanh
275250782,Máy lạnh Daikin 1.0 HP FTF25XAV1V - Hàng chính hãng - Giao HCM và 1 số tỉnh thành,0.0,9087603189891,7190000,7990000,800000,10,0,dien-tu-dien-lanh
275024030,Tủ Lạnh Casper Inverter Side By Side 458 Lít EcoFresh RS-460PBW - Hàng Chính Hãng - Chỉ Giao HCM,0.0,1640657667646,9409000,15199000,5790000,38,0,dien-tu-dien-lanh
274862540,Điều Hòa Casper Inverter 1 Chiều 9000BTU/12000BTU/18000BTU (1HP/1.5HP/2HP) - Hàng Chính Hãng,0.0,7939564448211,5990000,5990000,0,0,0,dien-tu-dien-lanh
273682672,Tủ Lạnh Sharp SJ-X215V-DG 215L Inverter - Hàng Chính Hãng (Chỉ giao HCM),3.0,3556383494297,4749000,7699000,2950000,38,0,dien-tu-dien-lanh
273238212,Máy lạnh Panasonic 1.0HP CU/CS-N9ZKH-8 - Hàng chính hãng - Chỉ giao HCM,0.0,3442542592874,7959000,12799000,4840000,38,0,dien-tu-dien-lanh
271772708,Đầu thu Xiaomi Tivi Box S Gen 2 4K | Hàng Chính Hãng,20.0,2670971877566,1369000,1369000,0,0,6,dien-tu-dien-lanh
271419995,Tủ lạnh Toshiba Inverter 233 lít GR-RT303WE-PMV(52) - Hàng Chính Hãng (Chỉ giao HCM) ,4.0,3955283316294,5219000,8499000,3280000,39,1,dien-tu-dien-lanh
271328770,Máy rửa bát Junger DWJ-100 Dung tích 10 bộ Sấy khô Diệt khuẩn UV Hàng Chính Hãng Bảo Hành 24 Tháng,1.0,4040890741907,16990000,16990000,0,0,0,dien-tu-dien-lanh
260812131,Tủ lạnh Electrolux  EQE5660A-B  Inverter 562 lít - hàng chính hãng - chỉ giao HCM,0.0,9564896235343,25249000,32260000,7011000,22,0,dien-tu-dien-lanh
246208809,Smart Tivi NanoCell LG 4K 55 Inch 55NANO76SQA [Hàng Chính Hãng],0.0,8823107848840,11009000,13400000,2391000,18,0,dien-tu-dien-lanh
229721760,Máy nước nóng trực tiếp Ariston 4500W AURES PREMIUM 4.5 - Hàng Chính Hãng,0.0,2549747371343,2079000,3000000,921000,31,0,dien-tu-dien-lanh
214924155,Smart Tivi Samsung HD 32 inch 32T4202 - Model 2022,5.0,2029261405945,4149000,6799000,2650000,39,0,dien-tu-dien-lanh
214813268,Máy giặt Sharp 7.5kg ES-Y75HV-S 5 chương trình giặt - Hàng chính hãng (Chỉ giao HCM),2.0,4186456168833,3290000,4990000,1700000,34,2,dien-tu-dien-lanh
214497224,Smart Tivi Samsung 32 inch UA32T4202 - Hàng chính hãng (chỉ giao HCM),12.0,1526880662500,4069000,6799000,2730000,40,1,dien-tu-dien-lanh
198111642,"Máy rửa sóng siêu âm RAMA R0.8L dung tích 0.8 lít, công suất 60W, 40kHz-Hàng chính hãng",8.0,2649448834251,1480000,1480000,0,0,0,dien-tu-dien-lanh
192988345,HÀNG CHÍNH HÃNG - Máy lạnh Daikin Inverter 1 HP FTKY25WAVMV - Chỉ Giao HCM,0.0,2786715376186,11339000,18599000,7260000,39,0,dien-tu-dien-lanh
189204315,Máy rửa bát 15 bộ cao cấp Nagakawa NAG3601M15 - Made in Malaysia - Hàng chính hãng,4.0,8756521417683,11499000,11499000,0,0,1,dien-tu-dien-lanh
186133756,Tủ lạnh Aqua 50 lít AQR-D59FA (BS) - Hàng Chính Hãng [Giao hàng toàn quốc],0.0,2297625137591,2450000,3400000,950000,28,0,dien-tu-dien-lanh
178264538,Tủ lạnh Electrolux 94 Lít EUM0930AD-VN,0.0,9255222536448,3459000,5499000,2040000,37,0,dien-tu-dien-lanh
178058676,Google Tivi Sony 4K 43 inch KD-43X81DK - Model 2022,1.0,8113680907989,11719000,13900000,2181000,16,0,dien-tu-dien-lanh
176463766,MÁY LẠNH PANASONIC INVERTER 1.5HP CU/CS-XPU12XKH-8-HÀNG CHÍNH HÃNG-GIAO HÀNG TOÀN QUỐC,0.0,9655739926494,11980000,11980000,0,0,0,dien-tu-dien-lanh
174309159,Tủ lạnh Electrolux 94 Lít EUM0930AD-VN - Hàng chính hãng (chỉ giao HCM),4.0,3234951105808,3309000,5499000,2190000,40,0,dien-tu-dien-lanh
158959632,Tủ lạnh Panasonic NR-BA190PPVN - Hàng Chính Hãng - Giao toàn quốc,2.0,6866672148484,6390000,6390000,0,0,1,dien-tu-dien-lanh
145680962,Tủ lạnh hai cửa Samsung Digital Inverter 216L RT20HAR8DBU - Hàng chính hãng - Giao toàn quốc,5.0,8594985929691,7250000,7250000,0,0,2,dien-tu-dien-lanh
136666493,Tủ lạnh Toshiba Inverter 249 lít GR-RT325WE-PMV(06)-MG - Hàng chính hãng (chỉ giao HCM),38.0,8123630704482,6409000,10799000,4390000,41,13,dien-tu-dien-lanh
131007332,Máy lạnh Casper Inverter 1 HP GC-09IS32 - Hàng chính hãng - Giao hàng toàn quốc,0.0,4956553039092,6500000,6500000,0,0,0,dien-tu-dien-lanh
109693112,Máy Nước Nóng Gián Tiếp Ariston Vitaly 30 2.5 FE (2500W) - Hàng chính hãng,8.0,1673332961114,2149000,2149000,0,0,2,dien-tu-dien-lanh
93159118,Máy lạnh di động 1.0HP Casper PC-09TL33 - Hàng chính hãng (chỉ giao HCM),0.0,7625645933704,5099000,5099000,0,0,0,dien-tu-dien-lanh
74526984,BỘ ĐẦU THU TRUYỀN HÌNH KỸ THUẬT SỐ K+ 7 MÓN HÀNG CHÍNH HÃNG,52.0,8294261915445,150000,150000,0,0,22,dien-tu-dien-lanh
73681047,Smart Tivi Casper HD 32 inch 32HX6200,5.0,5672481251025,2819000,3500000,681000,19,0,dien-tu-dien-lanh
56403960,Máy giặt Toshiba Inverter 9.0 kg AW-DK1000FV-KK - HÀNG CHÍNH HÃNG,34.0,7399870568769,5679000,9399000,3720000,40,14,dien-tu-dien-lanh
16033028,Máy Rửa Chén Electrolux ESF6010BW - Hàng Chính Hãng,26.0,1798597438557,6439000,10099000,3660000,36,6,dien-tu-dien-lanh
1615801,Máy Lạnh Mitsubishi Heavy 1.5 HP SRK/SRC12CT-S5,1.0,1368482398206,9199000,14699000,5500000,37,0,dien-tu-dien-lanh
277579013,Điều khiển tivi Asanzo - hàng nhập khẩu,1.0,6901559096689,79000,79000,0,0,0,dien-tu-dien-lanh
276931162,Smart Tivi Casper 43 Inch FULL HD E43FAC110 - HÀNG CHÍNH HÃNG - CHỈ GIAO HCM,0.0,6195981874973,7990000,7990000,0,0,0,dien-tu-dien-lanh
276882142,"Tủ Lạnh Mini Hisense 94 Lít HR09DB Làm Lạnh Nhanh, Tiết Kiệm Điện, Bảo Hành Chính Hãng 24 Tháng - Hàng Chính Hãng",0.0,6174139016176,3790000,5690000,1900000,33,0,dien-tu-dien-lanh
276503330,Tủ lạnh AQUA ngăn đá trên 130L AQR-T160FA(BS) - Freeship toàn quốc - Hàng chính hãng - Bảo hành 2 năm,0.0,9082440167747,4890000,4890000,0,0,0,dien-tu-dien-lanh
276415652,"Android Tivi LED Hisense 32 inch 32A4N trợ lý ảo Google Voice Control, bảo hành 2 năm - HÀNG CHÍNH HÃNG",0.0,3005328458816,5990000,5990000,0,0,0,dien-tu-dien-lanh
276380107,"Tủ Lạnh Hisense Inverter Side By Side RS668N4EW-PU 519 Lít tiết kiệm điện, bảo hành 3 năm - HÀNG CHÍNH HÃNG",0.0,7662191094674,22990000,22990000,0,0,0,dien-tu-dien-lanh
276374893,Máy nước nóng trực tiếp Panasonic( không bơm) DH-3VS1VW - HÀNG CHÍNH HÃNG - CHỈ GIAO HCM,0.0,3313590345791,2250000,2990000,740000,25,0,dien-tu-dien-lanh
276054258,[DAILY] Tủ lạnh Aqua 90 lít AQR-D100FA(BS) - Freeship toàn quốc - Hàng chính hãng,3.0,9799696125624,3590000,3590000,0,0,0,dien-tu-dien-lanh
275506258,"Chân Máy Giặt, Chân Chống Rung Máy Giặt, Chân Chống Ồn Máy Giặt - Hàng Chính Hãng",5.0,5502286614423,49000,49000,0,0,1,dien-tu-dien-lanh
275495487,Điều Khiển  Giọng Nói Dùng cho Ti vi MR20 ( Hàng Chính Hãng ),3.0,9561748206983,285000,285000,0,0,0,dien-tu-dien-lanh
275438276,Tủ Lạnh Kháng Khuẩn Panasonic 251L NR-SP275CPAV - Cấp Đông Mềm - Ngăn Đá Dưới - Hàng chính hãng,0.0,3206728939985,8189000,13199000,5010000,38,0,dien-tu-dien-lanh
275400293,"Chân Kê Đế Chống Rung Máy Giặt, Tủ Lạnh Sét 4 Đế Tăng Giảm Độ Cao Hàng Nhập Khẩu",18.0,4306016338307,39000,46000,7000,15,1,dien-tu-dien-lanh
275386925,Tủ lạnh LG ngăn đá trên Smart Inverter 572L màu đen LTB55BLMD - Hàng Chính Hãng,0.0,3274732655954,11190000,13790000,2600000,19,0,dien-tu-dien-lanh
275377930,Anten thông minh thu sóng DVB T2 + 15m dây cáp + Jack nối (Hàng chính hãng),11.0,5217252700701,79000,79000,0,0,0,dien-tu-dien-lanh
275269812,Google Tivi Sony 4K 50 inch K-50S30 Mới 2024 - Hàng chính hãng - Giao HCM và 1 số tỉnh thành,0.0,8323111354205,14569000,22990000,8421000,37,0,dien-tu-dien-lanh
275245427,Smart Tivi NanoCell LG 4K 43 inch 43NANO81TSA Mới 2024 - Hàng chính hãng - Giao HCM và 1 số tỉnh thành,1.0,4994404042216,9089000,11000000,1911000,17,0,dien-tu-dien-lanh
275088970,Máy giặt LG Inverter 10 kg FV1410S4P - Hàng chính hãng,0.0,5890274005142,8990000,14990000,6000000,40,0,dien-tu-dien-lanh
275033001,GR-RF665WIA-PGV(22)-XK - Tủ Lạnh Thông Minh Toshiba GR-RF665WIA-PGV(22)-XK - Hàng Chính Hãng - Chỉ Giao Hồ Chí Minh,0.0,5974701339585,19349000,32199000,12850000,40,0,dien-tu-dien-lanh
274843279,Smart Tivi Samsung 4K 43 inch UA43DU8000 43DU8000 - Hàng chính hãng - Chỉ giao HCM,1.0,4209660065015,7790000,8990000,1200000,13,0,dien-tu-dien-lanh
274805929,Gioăng nam châm cho cánh tủ lạnh đã luồn sẵn vào ron Hàng Chính Hãng - Điện Lạnh Thuận Dung,3.0,4174498249447,30000,30000,0,0,1,dien-tu-dien-lanh
274185329,"Ron cửa máy giặt dành cho máy To, Gioăng máy giặt cửa ngang không vòi model 3017, Zoăng cửa máy giặt, hàng chính hãng, Điện Lạnh Thuận Dung",1.0,1374813560725,350000,350000,0,0,0,dien-tu-dien-lanh
271412113,Tủ lạnh Toshiba Inverter 253 lít GR-RT329WE-PMV(52) - Hàng Chính Hãng (Chỉ giao HCM),1.0,2490436924609,5579000,9099000,3520000,39,0,dien-tu-dien-lanh
254147802,"Máy lạnh di động đứng 14.000 BTU FUJIHOME PAC14, điều hòa di động mini kết nối Wifi điều khiển qua App, 4 chức năng, làm lanh, hút ẩm, lọc không khí, quạt - Hàng chính hãng",6.0,6161682540972,16000000,16000000,0,0,0,dien-tu-dien-lanh
252762586,Tủ lạnh Toshiba GR-RS775WI-PMV(06)-MG Inverter 596 lít - Hàng chính hãng ( chỉ giao HCM ),0.0,2878029608468,13790000,15990000,2200000,14,0,dien-tu-dien-lanh
216335320,Máy lạnh Sharp Inverter 2.0hp AH-X18ZEW - Hàng chính hãng( Chỉ giao HCM),3.0,2213910049575,9549000,15799000,6250000,40,0,dien-tu-dien-lanh
204337932,Google  ti vi Asanzo 32EX9- hàng chính hãng- ĐIỀU KHIỂN GIỌNG NÓI,1.0,7264699411970,3699000,3699000,0,0,0,dien-tu-dien-lanh
194212059,"Máy giặt cửa trên 9kg Aqua AQW-F91GT.S - Hàng chính hãng - Chỉ giao HCM, Hà Nội, Đà Nẵng, Hải Phòng, Bình Dương, Đồng Nai, Cần Thơ",0.0,4517915416443,6190000,6190000,0,0,0,dien-tu-dien-lanh
190140797,Điều Hòa Casper Inverter 9000Btu GC-09IS33 - Hàng chính hãng - Chỉ giao Hà Nội,0.0,6329210256006,5990000,5990000,0,0,0,dien-tu-dien-lanh
188974314,Máy Rửa Chén Ecalite EDW-UF6080BL (8 Bộ) - Có Rửa Điệt Khuẩn - Lắp Bán Âm Cực Gọn - Điều Khiển Cảm Ứng - Hàng Chính Hãng,6.0,3859362382098,16400000,16400000,0,0,1,dien-tu-dien-lanh
178268021,Tủ lạnh Electrolux 94 Lít EUM0930BD-VN,16.0,3426709435862,3329000,5499000,2170000,39,2,dien-tu-dien-lanh
171574649,Tủ lạnh mini KEMIN 32L Chính Hãng - Chỉnh nhiệt có ngăn đá,31.0,9023202119933,3750000,3750000,0,0,6,dien-tu-dien-lanh
145680950,Tủ lạnh Samsung Multidoor 488L RF48A4000B4 - Hàng chính hãng - Giao toàn quốc,0.0,9776058057562,23350000,23350000,0,0,0,dien-tu-dien-lanh
142259671,Hệ Thống Máy lạnh Multi S Daikin Inverter 2.0HP + 02 Dàn lạnh 1.0HP MKC50RVMV/CTKC25RVMV+CTKC25RVMV - Hàng Chính Hãng- Chỉ giao tại HCM,2.0,3863556965896,21621000,21621000,0,0,0,dien-tu-dien-lanh
77745320,Tủ lạnh Inverter AQR-T239FA(HB) - Hàng chính hãng ( chỉ giao HCM ),0.0,9338712727972,4729000,6090000,1361000,22,0,dien-tu-dien-lanh
71149573,Máy rửa bát Fujishan FJVN08-S07F (8 Bộ) - Hàng Chính Hãng,5.0,7503984710314,8470000,8470000,0,0,2,dien-tu-dien-lanh
48574854,"Bộ Chia 2 Pacific Dùng Chia Truyền Hình Cáp, Anten KTS - Hàng Nhập Khẩu",33.0,2698498534411,34900,34900,0,0,11,dien-tu-dien-lanh
17010861,Máy Lạnh Mitsubishi Heavy Srk09ctr-S5 ( -) - Hàng Chính Hãng,0.0,4841736550188,6679000,9530000,2851000,30,0,dien-tu-dien-lanh
16966885,Máy Rửa Chén Hafele HDW-T50A 538.21.190 - Hàng Chính Hãng,2.0,5639049269656,7809000,12199000,4390000,36,0,dien-tu-dien-lanh
567976,Tivi LED Asanzo HD 25 inch 25S200T2,6.0,8903573261064,2450000,2450000,0,0,2,dien-tu-dien-lanh
459574,Máy Nước Nóng Ferroli QQ EVO 15L TE (2500W),9.0,1024681960476,2050000,2050000,0,0,0,dien-tu-dien-lanh
277614131,Remote điều khiển dành cho tivi led Asanzo smart - Hàng chính hãng,1.0,2550685119745,79000,79000,0,0,0,dien-tu-dien-lanh
277612346,Remote Điều khiển dành cho tivi led Asanzo - Hàng chính hãng ,1.0,3842686063886,79000,79000,0,0,0,dien-tu-dien-lanh
277138700,Máy lạnh LG Inverter 1.5 HP V13API1 - Hàng chính hãng,0.0,7014595340095,8290000,8290000,0,0,0,dien-tu-dien-lanh
276492185,Tủ lạnh Aqua 50 lít AQR-D60FA(BS) - Freeship toàn quốc - Hàng chính hãng - Bảo hành 2 năm,1.0,7144147640057,3090000,3090000,0,0,0,dien-tu-dien-lanh
276408949,EWF1023P5SC - Máy giặt Electrolux UltimateCare 500 Inverter 10 kg EWF1023P5SC - Hàng Chính Hãng - Chỉ Giao HCM,0.0,8815413263170,10789000,13990000,3201000,23,0,dien-tu-dien-lanh
276390032,Chai xịt vệ sinh điều hòa Cleanz làm sạch diệt khuẩn bằng công nghệ ion bạc Ag+ -500ml- Hàng chính hãng ,1.0,4887073037311,89000,89000,0,0,1,dien-tu-dien-lanh
276319145,"Smart Tivi TOSHIBA 43 inch 43E31MP, Màn Hình LED FULL HD - Giao Hàng Toàn Quốc - Hàng Chính Hãng",1.0,2481169308784,6990000,10990000,4000000,36,0,dien-tu-dien-lanh
276248835,Máy sấy thông hơi Electrolux UltimateCare 9 kg EDV904H3WC - HÀNG CHÍNH HÃNG - CHỈ GIAO HCM,0.0,3852875548669,9429000,15299000,5870000,38,0,dien-tu-dien-lanh
276209754,MẶT KÍNH KÈM MẠCH CẢM ỨNG MÁY GIẶT PANASONIC - HÀNG NHẬP KHẨU,0.0,3731930268077,450000,450000,0,0,0,dien-tu-dien-lanh
276087927,"Remote điều khiển máy lạnh đa năng 1000 tần số dùng cho các dòng máy vn, thái lan, nội địa nhật (Hàng Chính Hãng)",2.0,7297935329061,6400,6400,0,0,0,dien-tu-dien-lanh
275657894,TỦ LẠNH SAMSUNG INVERTER RT20HAR8DBU/SV - Hàng chính hãng,1.0,1226970369690,4949000,5190000,241000,5,0,dien-tu-dien-lanh
275378737,"Anten Trong Nhà, Tích Hợp với TIVI & Đầu Thu KTS, DVB T2 (Hàng chính Hãng)",4.0,3739797598080,99000,99000,0,0,0,dien-tu-dien-lanh
275347139,Điều Hòa Inverter 1 Chiều Toshiba COMFEE 9000BTU/12000BTU/17500BTU (1HP/1.5HP/2HP) - Hàng Nhập Khẩu Thái Lan Của Toshiba,7.0,4485624434328,6750000,6750000,0,0,1,dien-tu-dien-lanh
274870762,Smart QLED Tivi 4K Samsung 65Q60DA 65 inch QA65Q60DA QA65Q60D 65Q60D - Hàng chính hãng - Chỉ giao HCM,0.0,8845549833291,14149000,15149000,1000000,7,0,dien-tu-dien-lanh
270258877,Smart Tivi LG 43 Inch 4K 43UQ7050PSA - Hàng chính hãng - Chỉ giao HCM,4.0,6926052436587,6879000,11399000,4520000,40,1,dien-tu-dien-lanh
247878603,Máy lạnh Panasonic Inverter 1.5 HP CU/CS-XU12ZKH-8 - Hàng chính hãng - Chỉ giao HCM,0.0,3188473729828,15391000,18100000,2709000,15,0,dien-tu-dien-lanh
208092608,[Hàng Chính Hãng] Giá Treo Tivi Di Động NB AVA1500 32 - 75 Inch Giá Treo Tivi Có Bánh Xe Di Chuyển,5.0,2287518239867,1360000,1360000,0,0,2,dien-tu-dien-lanh
207284447,Máy nước nóng Panasonic DH-4MS1VW 4.500W - Hàng chính hãng (chỉ giao HCM),0.0,7588550630808,2690000,4099000,1409000,34,0,dien-tu-dien-lanh
206502457,Máy Rửa Bát Để Bàn Bosch HMH.SKS62E32EU Series 4 - Hàng chính hãng,0.0,7373454304811,25830000,25830000,0,0,0,dien-tu-dien-lanh
204874701,Ống gen cách nhiệt ống đồng điều hòa ĐƠN XÁM PHI 35 (loại dài 1 mét và 2 mét) hàng nhập khẩu - Điện Lạnh Thuận Dung,5.0,6556122354481,20000,20000,0,0,0,dien-tu-dien-lanh
201843045,Máy giặt Toshiba 9.0kg AW-M1000FV(MK) - Hàng chính hãng (chỉ giao HCM),2.0,8509835907781,5069000,8299000,3230000,39,0,dien-tu-dien-lanh
197853158,[Giao toàn quốc] Máy giặt Bosch WGG234E0SG - Khối Lượng Giặt 8kg - 9 Chương Trình Giặt - Hàng Chính Hãng,0.0,7668696096780,13890000,13890000,0,0,0,dien-tu-dien-lanh
196250720,Máy nước nóng trực tiếp Ariston AURES PREMIUM+ 4.5 (4500W) - Hàng chính hãng,0.0,9767864850289,2239000,2700000,461000,17,0,dien-tu-dien-lanh
194212012,Freeship Toàn Quốc - Tủ lạnh ngăn đông dưới Aqua 324 Lít AQR-IG378EB(GB) - Bảo hàng 2 năm - Hàng chính hãng,0.0,6327743305950,14790000,14790000,0,0,0,dien-tu-dien-lanh
192074170,Máy Rửa Chén Âm Bán Phần KAFF KF-BDWSI12.6 - 14 Bộ - Hàng Chính Hãng,0.0,5668507498631,26800000,26800000,0,0,0,dien-tu-dien-lanh
178058668,Google Tivi Sony 4K 43 inch KD-43X75K - Model 2022,25.0,4230600010646,8749000,14199000,5450000,38,5,dien-tu-dien-lanh
97769229,MÁY LẠNH AKINO 1HP Inverter ID-09INT1FA-9000BTU-GAS32-HÀNG CHÍNH HÃNG-GIAO HÀNG TOÀN QUỐC,0.0,2555705360926,6000000,6000000,0,0,0,dien-tu-dien-lanh
95923190,Điều Hòa Di Dộng Casper 9000 Btu PC-09TL33 - Chi Giao Tại Hà Nội,7.0,2664713254085,5459000,5459000,0,0,2,dien-tu-dien-lanh
91272439,Giá Treo TiVi Di Động North Bayou AVA1500 Màu Đen Lắp Cho Màn Hình 32 inch - 70 inch Nhập Khẩu,392.0,5108443897791,1250000,1250000,0,0,86,dien-tu-dien-lanh
83344560,Máy Lạnh Mitsubishi Electric 1 HP MS-JS25VF - Chỉ giao HCM,0.0,2175671680106,7489000,11999000,4510000,38,0,dien-tu-dien-lanh
81362797,Máy Lạnh Toshiba Inverter 2.5 HP RAS-H24E2KCVG-V - Chỉ giao tại HCM,0.0,9245335972448,21090000,23990000,2900000,12,0,dien-tu-dien-lanh
57340004,BÌNH NƯỚC NÓNG GIÁN TIẾP AQUA E 150 LÍT TREO ĐỨNG (SEV)-HÀNG CHÍNH HÃNG,0.0,1065795019926,11250000,11250000,0,0,0,dien-tu-dien-lanh
20478646,TỦ ĐÔNG SANAKY 220 LÍT VH-2299HY2 ĐỒNG (R134A) -HÀNG CHÍNH HÃNG,12.0,4534283796634,4589000,7699000,3110000,40,1,dien-tu-dien-lanh
16464321,Tủ Đông Dàn Đồng Sanaky VH-2599A1 1 Ngăn 2 Cánh (250L) - Hàng Chính Hãng,3.0,4280708672914,5609000,9099000,3490000,38,1,dien-tu-dien-lanh
13674032,Máy nước nóng trực tiếp Ferroli Slim Divo SSN 4500W - Hàng Chính Hãng,22.0,2354839113157,1865000,1865000,0,0,1,dien-tu-dien-lanh
11998183,Android tivi box VNPT MyTVNet Net 1 - Tặng kèm chuột không dây chính hãng  ,5.0,6789961525244,725000,725000,0,0,0,dien-tu-dien-lanh
4678975,Giá Treo Tivi Góc Xoay Nhập Khẩu North Bayou L600 (45-70 inch),21.0,6792152647120,576980,576980,0,0,7,dien-tu-dien-lanh
4178855,Máy Nước Nóng Ferroli VERDI 15L SE (2500W),0.0,2792445081758,2580000,2580000,0,0,0,dien-tu-dien-lanh
4176685,Máy Nước Nóng Ferroli VERDI 30L TE (2500W),0.0,7737501643827,2670000,2670000,0,0,0,dien-tu-dien-lanh
604757,Tivi LED Asanzo 25 inch 25T350 - Hàng Chính Hãng,24.0,8909375143584,2399000,2399000,0,0,2,dien-tu-dien-lanh
274638952,"Giày thể thao nữ đế êm nhẹ, thoáng khí đế cao su đúc, chống trơn trượt hạn chế mòn – GNU1007",14.0,1211096195048,360000,840000,480000,57,6,giay-dep-nu
200519451,Giày búp bê  da bò mũi tròn màu xám đính nơ Trường Hải da mềm mại BB130,1.0,9971556620276,299000,299000,0,0,0,giay-dep-nu
274795393,Dép bánh mì Cross nữ siêu nhẹ kèm Sticker dễ thương - dép nữ hot trend DNU9021,26.0,8509793466249,180000,360000,180000,50,6,giay-dep-nu
252596684,"Giày búp bê mũi tròn trơn da bò mềm mại Trường Hải GBB118 có 2 màu đen, đỏ",4.0,2107480562086,285000,285000,0,0,0,giay-dep-nu
252597179,"Giày búp bê đế bằng da bò trơn Trường Hải da mềm GBB120 có 2 màu đen, trắng",7.0,8828422365402,195000,195000,0,0,2,giay-dep-nu
277878610,[QUÀ TẶNG] Túi đựng đồ đa năng Miley Lignerie,4.0,4514148113196,20000,20000,0,0,0,giay-dep-nu
276767395,"Cặp lót giày khử mùi hôi chân cho nam và nữ , vải lưới đàn hồi thông hơi thoáng khí giúp khử mùi  hiệu quả bảo vệ bàn chân , luôn  sạch sẽ  và  khô ráo",9.0,1620563107077,89000,89000,0,0,0,giay-dep-nu
276254042,Dép Eva Phun Nữ Biti's BEW001102DEN (Đen),4.0,7167447487772,275000,290000,15000,5,0,giay-dep-nu
276004096,Sandal Nhựa Bitis (35-40),8.0,2613286659042,295000,295000,0,0,0,giay-dep-nu
275140754,"Dép tổ ong [Size 35-38] KÈM STICKER NGẪU NHIÊN cao cấp siêu bền, siêu nhẹ, chống trơn trượt",43.0,4915267287851,68000,100000,32000,32,4,giay-dep-nu
252596105,"Giày búp bê trơn da bò mũi vuông Trường Hải có 2 màu xanh ,đen GBB115",2.0,9888273256724,285000,285000,0,0,1,giay-dep-nu
275711130,"Giày thể thao nữ, giày chạy bộ đế êm nhẹ, thoáng khí đế cao su đúc, chống trơn trượt hạn chế mòn  – GNU2077HO",6.0,1110682791641,520000,1040000,520000,50,0,giay-dep-nu
263582380,Dép Quai Ngang Eva Nữ Biti's BEW000500DEN (Đen),24.0,6220646865150,154000,175000,21000,12,7,giay-dep-nu
73120993,"IÀY BÚP BÊ TRƯỜNG HẢI DA BÒ MỀM MÀU VÀNG BÒ SANG TRỌNG MŨI GIÀY TRÒN, ĐẾ MỀM DẺO BÊN CHẮC VÀ THỜI TRANGBB025",0.0,5516366726218,289000,289000,0,0,0,giay-dep-nu
274536266,"Dép sục Nesty Vintage an toàn, êm ái, dễ vệ sinh",30.0,1608139674463,89000,89000,0,0,4,giay-dep-nu
273410682,"Lót giày tăng chiều cao,  tăng 1.5 cm/ 2.5cm/3.5cm chất liệu PU êm chân, thoáng khí - BuyBox - BBPK367",59.0,2873595675645,37000,37000,0,0,5,giay-dep-nu
272913565,"Dép Massage Chân Đi Trong Nhà, Căn Hộ Chung Cư, Văn Phòng, Nhà Tắm Siêu Êm Chống Trơn Trượt",178.0,6580796613393,75000,75000,0,0,14,giay-dep-nu
242812826,"Kem Sáp Tẩy Trắng, Vệ Sinh Giày, Túi Da, Bàn Ghế Đa Năng Không Dùng Nước - HÀNG CHÍNH HÃNG MINIIN",30.0,9574400570405,25000,25000,0,0,4,giay-dep-nu
276473329,"Giày thể thao nữ chất liệu da mềm mại, phong cách cá tính năng dộng – GNU2043A",4.0,3639673784686,350000,700000,350000,50,1,giay-dep-nu
261824879,Dép Quai Ngang Eva Nữ Biti's BEW000500HOG (Hồng),27.0,3592655027730,154000,175000,21000,12,4,giay-dep-nu
274709869,"Giày thể thao nữ đế êm nhẹ, thoáng khí đế cao su đúc, chống trơn trượt hạn chế mòn – GNU2062",9.0,2610266159495,410000,820000,410000,50,2,giay-dep-nu
213724172,Giày búp bê da bò mũi tròn Trường Hải đính nơ xinh da mềm mại GBB110,4.0,9720325740390,299000,299000,0,0,1,giay-dep-nu
275707536,Dép nữ kiểu dáng dễ thương - dép nữ hot trend DNU9020,9.0,3328338565840,170000,340000,170000,50,2,giay-dep-nu
214917532,"Dép đi trong nhà chống trượt, quai ngang - Hàng chính hãng",305.0,5416567143602,71250,75000,3750,5,25,giay-dep-nu
214188835,"Dép đi trong nhà FuNu hình ô vuông chống trượt, bề mặt da PU hấp thụ sốc giúp êm mềm thoải mái bàn chân, Dép nhà tắm - Hàng chính hãng",106.0,1292451013912,61750,65000,3250,5,4,giay-dep-nu
210429292,"Bộ đôi nút bọc gót giày cao gót hình tròn, chữ U giảm tiếng ồn chống mòn gót - Buybox - BBPK291",111.0,6955998052487,14000,14000,0,0,5,giay-dep-nu
208496276,Dép Biti's Eva Phun Nam DEM012500XNH (Xanh Nhớt),37.0,6900344775475,162000,180000,18000,10,6,giay-dep-nu
199896249,"Dép đi trong nhà, văn phòng, dép nhà tắm phong cách Hàn Quốc - Hàng chính hãng",332.0,2888225266481,71250,75000,3750,5,16,giay-dep-nu
197419814,Giày Sandal Nữ Đế Xuồng BIGGBEN Da Bò Cao Cấp SDX11,169.0,2146566034987,329000,450000,121000,27,44,giay-dep-nu
195536360,Giày Sandal Nữ Da Bò Thật BIGGBEN Cao Cấp SDN84,13.0,9660000794025,319000,350000,31000,9,5,giay-dep-nu
192135155,Dép Nữ Da Bò Thật BIGGBEN Cao Cấp DNQN51,35.0,6282491633242,299000,350000,51000,15,6,giay-dep-nu
188487235,Lót giày bảo vệ gót hình vỏ sò tăng độ bám chân chuyên dùng mang giày thể thao - buybox - BBPK224,78.0,7390980347963,70000,70000,0,0,5,giay-dep-nu
188486981,"Quai giày thun đan hồi, bản to phối khoen, thiết kế chắc chắn, chống tuột gót giày, dùng cho nữ - buybox - BBPK218",41.0,2085797981653,36000,36000,0,0,4,giay-dep-nu
181247134,Giày Bốt Nữ Da Bóng Trắng Đen Ôm Chân Đẹp Gót 7 Phân Cổ cao Mũi Nhọn Không Có Khóa,24.0,8411181066840,285000,458000,173000,38,13,giay-dep-nu
177772693,"Giày sandal nữ BIGGBEN cao 4,5cm SDN76",55.0,3986213810239,349000,500000,151000,30,16,giay-dep-nu
177750603,Giày sandal nữ da bò thật BIGGBEN cao cấp SDN73,32.0,8489149993720,339000,450000,111000,25,9,giay-dep-nu
177642266,Giày Búp Bê Nữ Da Bò BIGGBEN Cao Cấp BB122,36.0,5388528728842,309000,350000,41000,12,13,giay-dep-nu
158631445,"Dép Đi Trong Nhà Cói Mây Đế Cao Su Chống Trơn, Thoáng Mát Mã DP07",731.0,5904856252346,98000,98000,0,0,67,giay-dep-nu
157062466,Khăn Giấy Lau Giày Sneaker Chuyên Dụng Khăn Ướt Vệ Sinh Giày Dép Dép Da Siêu Sạch 1 Gói 30 Tờ - Hàng Chính Hãng MINIIN,117.0,7059884025383,25000,25000,0,0,18,giay-dep-nu
141490261,Giày sandal nữ da bò thật BIGGBEN cao cấp SDN70,71.0,9311046444026,339000,450000,111000,25,20,giay-dep-nu
106901880,Giày Búp Bê Nữ Da Bò BIGGBEN Cao Cấp BB109,61.0,6270435718962,309000,400000,91000,23,29,giay-dep-nu
104438755,"Giày nhựa đi mưa, đi biển",88.0,3220191082611,59000,59000,0,0,19,giay-dep-nu
86860057,Giày Sandal Cao Gót Da Bò BIGGBEN Cao 5 Phân SDCG60,41.0,1627283548178,359000,550000,191000,35,12,giay-dep-nu
74301261,Giày Búp Bê Nữ Da Bò BIGGBEN Cao Cấp BB76,108.0,4453593761289,309000,450000,141000,31,41,giay-dep-nu
66494165,Dép Nữ Cao Gót BIGGBEN Cao Cấp DCG39,45.0,7009330004613,309000,350000,41000,12,26,giay-dep-nu
59207075,Giày Sandal Nữ Da Bò BIGGBEN Cao Cấp SDCG49,31.0,7166159491649,349000,400000,51000,13,8,giay-dep-nu
55060972,Combo 2 cặp Lót gót giày 4D hình cánh bướm có mặt gai silicone chống trầy rách da và chống tuột gót chân - buybox - BBPK70_2,439.0,2046515099991,90000,90000,0,0,93,giay-dep-nu
52252644,"Lót độn đế silicon nguyên khối trong suốt tăng 1cm, 2cm, 3cm chiều cao - buybox - BBPK47",343.0,2332838581085,70000,70000,0,0,61,giay-dep-nu
52240827,Giày Sandal Nữ Đế Xuồng BIGGBEN Da Bò Thật SDX17,68.0,8342353991690,349000,400000,51000,13,26,giay-dep-nu
43126126,Bộ 2 cặp lót giày 4D bảo vệ gót chân và chống tuột gót giày (loại bầu) - buybox - BBPK54,1143.0,8672910881677,26000,26000,0,0,179,giay-dep-nu
36979068,Giày Sandal Nữ BIGGBEN Da Bò Thật SDN43,35.0,6062959025392,339000,450000,111000,25,10,giay-dep-nu
20818009,"Giày Lười Nữ , Giày Mọi Nữ , Giày Búp Bê Nữ",77.0,5642919912224,219000,219000,0,0,17,giay-dep-nu
159913,Xi Nước Đánh Giày GoldCare - GC 2001,243.0,5703284435241,63000,63000,0,0,9,giay-dep-nu
276838257,"Giày Sandal nữ kiểu dáng mới chống trơn, trượt – GSDN04",1.0,9469348470562,370000,740000,370000,50,0,giay-dep-nu
272723148,"Giày thể thao nữ, giày chạy bộ đế êm nhẹ, thoáng khí đế cao su đúc, chống trơn trượt hạn chế mòn  – GNU1004A",54.0,7999378108642,360000,720000,360000,50,12,giay-dep-nu
277361819,Dép Eva Phun Nữ Biti's E-Soft BEW001100TRG (Trắng),3.0,2262762762163,275000,295000,20000,7,0,giay-dep-nu
277359892,"Dép Đi Trong Nhà Bằng EVA Kiểu Mới Dành Cho Cặp Đôi – Ấm Áp, Tiện Lợi và Thoải Mái - HÀNG CHÍNH HÃNG MINIIN",21.0,9285366515692,29000,29000,0,0,1,giay-dep-nu
276829883,"Sét 2 miếng lót gót chân cao su mềm cho nam và nữ ,bảo vệ gót chân ,cổ chân ,chống nứt gót , khi mang giày ",7.0,6272446065373,65550,69000,3450,5,1,giay-dep-nu
276756866,"Dép  xốp đi trong nhà, mang trong văn phòng, nhà tắm, hàng xuất Nhật, chất liệu nhựa siêu bền chống trơn trượt",3.0,9901847474038,89000,89000,0,0,0,giay-dep-nu
276357500,Giày Thể Thao Nữ Biti’s Hunter X LiteDash - Original Edition 2K24 ​HSW007501KEM (Kem),1.0,7806388608707,802000,1050000,248000,24,1,giay-dep-nu
276098451,Xăng đan nữ học sinh Trường Hải 3 màu đế ếm nhẹ SD150,5.0,5734247416259,305100,339000,33900,10,0,giay-dep-nu
275377178,Giày Sandal Cao Gót Da Bò BIGGBEN Cao 8 Phân SDCG129,2.0,2489076986636,319000,500000,181000,36,1,giay-dep-nu
274657854,Giày Sandal Cao Gót Da Bò BIGGBEN Cao 5 Phân SDCG124,6.0,9723819714350,299000,450000,151000,34,2,giay-dep-nu
273546542,"DÉP LÀO XỎ NGÓN EVA cao cấp siêu bền, siêu nhẹ, chống trơn trượt, Form SIZE LỚN CHÂU ÂU",4.0,6307965888469,75000,75000,0,0,3,giay-dep-nu
273264083,"Xi đánh giày, vệ sinh đồ da, mùi hương dịu nhẹ, làm sạch và bảo dưỡng giày da hiệu quả - BuyBox - BBPK318",9.0,4253258813612,65000,65000,0,0,2,giay-dep-nu
271235550,"Lót giày nam nữ êm chân chất liệu vải mesh cấu trúc vòm nâng đỡ lòng bàn chân, kết hợp ốpTPU chống thốn và bảo vệ gót chân - buybox - BBPK363",27.0,1012403993570,37500,37500,0,0,3,giay-dep-nu
271101726,"Lót giày nam nữ êm chân chất liệu vải mesh cấu trúc vòm nâng đỡ lòng bàn chân, massage các huyệt đạo - buybox - BBPK364",28.0,3044815873308,59800,59800,0,0,2,giay-dep-nu
270873952,Khăn giấy ướt lau giày siêu sạch Sneaker Wipes hương quế tạo bọt tự tan làm sạch nhanh chóng mang đi tiện lợi,66.0,8727692298228,30000,51000,21000,41,3,giay-dep-nu
263484028,Lót giày thể thao mesh 4D ốp mút đệm khí giảm chấn vòm ngang và chống thốn gót - buybox - BBPK360,56.0,6174074124151,74000,74000,0,0,5,giay-dep-nu
262796298,"Bộ 3 mẫu lót giày thể thao, đêm êm bàn chân khi vận động, dùng để thay thế lót cũ - Buybox - BBPK26_BBPK128_BBPK155",5.0,6448575025282,172000,172000,0,0,1,giay-dep-nu
262453338,Dép Nữ Da Bò Thật BIGGBEN Cao 5 Phân DNQN55,9.0,6458302664891,359000,450000,91000,20,2,giay-dep-nu
214499918,"Dép đi trong nhà hình trái cây, êm mềm, chống trượt - Hàng chính hãng",34.0,7786378141738,132050,139000,6950,5,2,giay-dep-nu
210144694,"Lót giày tăng chiều cao chất liệu cao cấp êm chân thoáng khí, siêu nhẹ dành cho nam và nữ - Buybox - BBPK229",91.0,4777597778309,48000,48000,0,0,9,giay-dep-nu
210138445,"Lót độn đế giày silicone nguyên khối trong suốt, mềm dẻo, chống thốn, tăng 1.5cm, 2.5cm, 3.5cm chiều cao - BuyBox - BBPK217",36.0,2834804452543,75000,75000,0,0,1,giay-dep-nu
207382122,"Dép phòng ngủ khách sạn, dép đi trong nhà - Hàng chính hãng",218.0,2354023211708,28500,30000,1500,5,11,giay-dep-nu
205299054,"Chai xịt tạo bọt vệ sinh giày cao cấp, chất tẩy rửa giày, làm sạch, trắng sáng và khử mốc giày hiệu quả - Hàng chính hãng",833.0,4886132068938,42750,45000,2250,5,99,giay-dep-nu
203875211,"Lót giày cao gót, giày lười, sandal chống trượt chân về phía trước, giúp êm nửa bàn chân trước, có keo dán cố định - Buybox - BBPK226",65.0,4187249915679,24750,24750,0,0,6,giay-dep-nu
190792597,Giày đế xuồng nữ da bò cao cấp BIGGBEN SDX24,74.0,2003494498284,369000,500000,131000,26,18,giay-dep-nu
177827445,"Dép quai ngang nam nữ M Masler-MT màu xanh navy với lớp đế êm chân và chống trượt, quai khử mùi tốt NV2",34.0,7181098524646,298000,298000,0,0,16,giay-dep-nu
177644514,Dép nữ da bò thật BIGGBEN cao cấp DNQN44,7.0,4106760012287,299000,350000,51000,15,2,giay-dep-nu
120970633,"Dép Nữ Gấu Trúc Cực Cute, Dép Nữ Thời Trang Chống Trơn Mã DP06",367.0,6791620827634,178000,178000,0,0,90,giay-dep-nu
112957249,Sandal 3 phân vân cá sấu hot trend  trẻ trung năng động 20830,1.0,1554322847267,150000,150000,0,0,0,giay-dep-nu
108563064,Giày Sandal Cao Gót Da Bò BIGGBEN SDCG68,26.0,7132344385122,309000,350000,41000,12,9,giay-dep-nu
104438684,Giày Lười Nữ Đế Độn Da Mềm Cao Cấp,7.0,2375021576859,259000,259000,0,0,4,giay-dep-nu
84196932,Hộp Giày Vento Chính Hãng,26.0,4030032503088,15000,15000,0,0,0,giay-dep-nu
83479559,Lót gót giày 4D hình cánh bướm vân tròn chống trầy rách da và chống tuột gót chân - buybox - BBPK164,418.0,4921858332272,17150,17150,0,0,42,giay-dep-nu
72303328,Dép nữ quai ngang 1 bản da bò đế đúc cao cấp Trường Hải QNN01261,37.0,8425103456134,214000,214000,0,0,8,giay-dep-nu
57382862,Dép Đi Trong Văn Phòng - Trong Nhà Tắm Lock&Lock ETM646/ETM645,340.0,4705307047586,125000,190000,65000,34,41,giay-dep-nu
31716333,"2 cặp lót giày cao gót mũi nhọn giảm size cho giày bị rộng, thoáng khí và êm chân- buybox - BBPK55",1052.0,6963123261519,54000,54000,0,0,104,giay-dep-nu
28731166,"2 cặp lót giày chống tuột gót, chống trầy gót cực êm chân - buybox - BBPK09",1763.0,8184942434788,35000,35000,0,0,140,giay-dep-nu
23166857,Giày Sandal Nữ BIGGBEN Da Bò Thật SDN33,50.0,4363054849015,329000,400000,71000,18,18,giay-dep-nu
22968792,Giày Sandal Xuồng Nữ Da Bò BIGGBEN Cao Cấp SDX10,207.0,6016667904104,339000,420000,81000,19,63,giay-dep-nu
14040365,Giày Sandal Nữ Đế Xuồng BIGGBEN Da Bò Thật SDX04,49.0,7221449389768,339000,450000,111000,25,15,giay-dep-nu
276817786,"Dép xốp  sọc cao cấp  đi trong nhà , mang trong văn phòng, nhà tắm , đế dép làm bằng nhựa chống trơn trượt ,chống thấm nước , êm nhẹ  ,mềm mại mang lại cảm giác thoải mái  cho người sử dụng",6.0,8442038188202,75050,79000,3950,5,0,giay-dep-nu
276779703,"Combo 2 miếng lót gót chân cao su mềm  , bảo vệ gót chân ,cổ chân ,khi mang giày",7.0,1756569022627,69000,69000,0,0,0,giay-dep-nu
275183379,Chai Xịt Tạo Bọt Vệ Sinh Giày SNOKER Cao Cấp 300ml Làm Sạch Giày Cao Cấp Giúp Giày Trắng Sáng,8.0,2366448972965,52000,65000,13000,20,1,giay-dep-nu
275183194,"Chai Vệ Sinh Giày, Bình Xịt Bọt Tuyết Giặt Khô Giày Snoker Dung Dịch Vệ Sinh Giày Dép Snoker Cao Cấp",0.0,4318652314770,49000,49000,0,0,1,giay-dep-nu
274795850,"Dép Đi Trong Nhà, Dép Chống Trơn Siêu Nhẹ Mã DP102",71.0,3481772859090,158000,158000,0,0,12,giay-dep-nu
274337143,"Dép Mang Trong Nhà Bằng Vải Cho Khách Sạn, Homestay",260.0,8773447461754,19000,20000,1000,5,8,giay-dep-nu
273951828,Lọ/Bình/Chai Xịt Khử Mùi Giày Công Nghệ NANO BẠC Mùi Dịu Nhẹ 260ml khử Mùi Hôi Dép Chân Tủ Giày Bình Sịt Khử mùi Giày,25.0,3861164973851,35000,42000,7000,17,4,giay-dep-nu
273399791,"Bộ 02 cặp gồm 04 miếng lót gót giày silicon chống trầy bảo vệ gót chân, giảm size giày",33.0,9842955702785,35000,45000,10000,22,1,giay-dep-nu
263628625,"Lót giày nam nữ êm chân chất liệu cao su non, đàn hồi tốt, chống thốn và bảo vệ gót chân - buybox - BBPK361",68.0,4301978419703,36340,36340,0,0,7,giay-dep-nu
213942693,"Dép đi trong nhà hình vịt, chống trơn trượt, dép nhà tắm bằng nhựa cao cấp - Hàng chính hãng",190.0,2257783682118,114000,120000,6000,5,15,giay-dep-nu
210425483,"Nút bọc bảo vệ gót giày gót nhọn, chống trơn trượt, chống lún và giảm tiếng ồn - Buybox - BBPK256",91.0,3711771973564,15000,15000,0,0,1,giay-dep-nu
210145567,"Lót giày bảo vệ gót sau dày 6mm giảm size giày, chất liệu cao cấp giúp êm chân - buybox - BBPK230",83.0,7723432081726,30000,30000,0,0,6,giay-dep-nu
209896689,"Lót giày cao gót chống trầy, giảm size, chống tuột gót chất liệu EVA ép mặt nhung - Buybox - BBPK279",23.0,1460874433979,19492,19492,0,0,1,giay-dep-nu
197966679,"Miếng dán đế giày chống trơn trượt dùng mang giày cao gót, giày tây - Buybox - BBPK270",159.0,4410534203687,14000,14000,0,0,10,giay-dep-nu
190759720,Dép Đế Xuồng Nữ Da Bò Thật BIGGBEN Cao 5cm DX39,1.0,6826577044628,299000,400000,101000,25,0,giay-dep-nu
187396210,Giày Sandal Xuồng Nữ Da Bò Thật BIGGBEN Cao 5cm SDX38,7.0,8238765835592,349000,400000,51000,13,3,giay-dep-nu
170069022,Giày cao gót nữ 7 phân gót vuông cao cấp ORSIL,20.0,1889083627825,149000,149000,0,0,5,giay-dep-nu
163035058,"Dép Đi Trong Nhà, Văn Phòng, Xốp Lỗ Siêu Nhẹ Siêu Rẻ, Chống Trơn Trượt - Hàng Loại 1 - Giao Màu Ngẫu Nhiên",133.0,7473105755573,36000,36000,0,0,9,giay-dep-nu
149969265,Dép nhựa siêu nhẹ Bitis nữ,255.0,1767143572658,104000,104000,0,0,56,giay-dep-nu
147419466,"Dép cói, mây đan đế chống trượt đi trong nhà, trong văn phòng, trong khách sạn , large size (38-39&39-40&40-41), màu săc họa tiết giao ngẫu nhiên",207.0,5582650880850,60000,60000,0,0,16,giay-dep-nu
141500349,Giày sandal xuồng nữ da bò BIGGBEN cao cấp SDX33,18.0,4882575526793,299000,410000,111000,27,4,giay-dep-nu
140573000,Dép Bông Đi Trong Nhà Đế Cao Su Đúc Cao Cấp LACEVA DP95,209.0,9309818897212,99000,99000,0,0,32,giay-dep-nu
135373475,Sandal Biti's nữ,41.0,2032141088521,275000,275000,0,0,19,giay-dep-nu
133847001,Combo Dép Đi Trong Nhà Thu Đông Đế Chống Thấm Chất Nỉ Nhung Thiết Kế Sang Trọng Cho Nam Và Nữ- Hàng Loại 1- Chính Hãng MINIIN,54.0,7979578463428,39000,39000,0,0,17,giay-dep-nu
107667053,"Lót giày nam nữ êm chân bằng EVA cấu trúc vòm nâng đỡ lòng bàn chân, chống thốn và bảo vệ gót chân - buybox - BBPK177",123.0,6323197161757,41650,41650,0,0,11,giay-dep-nu
106546363,Giày búp bê nữ da bò BIGGBEN cao cấp BB93,114.0,2160003134735,299000,400000,101000,25,38,giay-dep-nu
91010827,Giày búp bê nữ BIGGBEN da bò cao cấp BB87,31.0,7219645196659,309000,400000,91000,23,13,giay-dep-nu
86963159,Giày Sandal Cao Gót Da Bò BIGGBEN Cao 5 Phân SDCG61,31.0,3985686866730,359000,400000,41000,10,12,giay-dep-nu
76289908,Giày Búp Bê Nữ Da Bò BIGGBEN Cao Cấp BB77,31.0,1226548992457,309000,400000,91000,23,14,giay-dep-nu
72851806,"Dép Bông Đi Trong Nhà Hình Mèo Dễ Thương Cực Êm, Đế Nhựa Dẻo Được Khâu Rất Chắc Chắn. DP97",1855.0,9671211149911,178000,178000,0,0,514,giay-dep-nu
66563614,Giày Sandal Nữ Đế Xuồng BIGGBEN Da Bò Thật SDX21,50.0,1028192589409,369000,450000,81000,18,23,giay-dep-nu
66499993,Dép Nữ Da Bò BIGGBEN Cao Cấp DNQN32,177.0,3261263390681,299000,350000,51000,15,48,giay-dep-nu
59211695,Giày Sandal Nữ Đế Xuồng BIGGBEN Da Bò Thật SDX19,58.0,5968256381029,349000,420000,71000,17,19,giay-dep-nu
54671476,"Dép chiếu xỏ ngón Hương Quế DKS-10 làm từ lụa tơ tằm - vải cotton - lớp đế cao su xốp cho đôi chân thơm, mát và khô thoáng",87.0,1761941879818,68000,68000,0,0,15,giay-dep-nu
52236446,Giày Sandal Nữ Đế Xuồng BIGGBEN Da Bò Thật SDX14,86.0,2210466743498,339000,400000,61000,15,23,giay-dep-nu
37719201,Dép Nữ BIGGBEN Da Bò Thật Cao Cấp DNQN23,64.0,4036029354547,299000,450000,151000,34,23,giay-dep-nu
37703250,Giày Sandal Cao Gót BIGGBEN Da Bò Thật SDCG37,65.0,4148572618318,369000,450000,81000,18,25,giay-dep-nu
22969322,Dép Nữ BIGGBEN Da Bò Thật DNQN20,99.0,8450780193997,289000,400000,111000,28,30,giay-dep-nu
19984182,Xi nước đánh giày Kangaroo Hàn Quốc - Nhập khẩu chính hãng,208.0,3851109880577,59000,59000,0,0,17,giay-dep-nu
8005161,Giày Sandal Nữ BIGGBEN Da Bò Thật SDN0399,94.0,5869713868377,329000,450000,121000,27,27,giay-dep-nu
277512280,Dép Cross Nữ Hàng Cao Cấp - DNU9074,3.0,7048171285448,520000,1040000,520000,50,0,giay-dep-nu
277380701,Giày Thể Thao sneaker Nữ Biti's Hunter HSW002301TRG (Trắng),2.0,9391256690424,1199000,1199000,0,0,0,giay-dep-nu
277380472,Giày Chạy Bộ Nữ Biti's Hunter Running HSW004800XMN (Xanh minơ),1.0,5689959984679,882000,1259000,377000,30,0,giay-dep-nu
277273206,"Giày thể thao nữ, giày chạy bộ đế êm nhẹ, thoáng khí đế cao su đúc, chống trơn trượt hạn chế mòn  – GNU2093",2.0,9733321246317,570000,1140000,570000,50,0,giay-dep-nu
276952413,Dép đúc răng cưa dép bánh mì nam nữ vân nhám đế êm chân không thấm nước  có big size,7.0,8367897638058,79000,79000,0,0,2,giay-dep-nu
276817764,"Dép xốp sọc đi trong nhà , trong văn phòng, nhà tắm ,  chống trơn trượt ,chống thấm nước , êm nhẹ ,mang lại cảm giác thoải mái cho người sử dụng",7.0,7930711191698,75050,79000,3950,5,0,giay-dep-nu
276254115,Dép Eva Phun Nữ Biti's BEW001301KEM (Kem),2.0,1934541014501,163000,175000,12000,7,1,giay-dep-nu
270123060,GIày Búp Bê BIGGBEN Da Bò Thật Cao Cấp BB43,43.0,1120267130764,299000,400000,101000,25,8,giay-dep-nu
195528473,Giày Sandal Nữ Da Bò Thật BIGGBEN Cao Cấp SDN82,2.0,7278468769595,339000,400000,61000,15,0,giay-dep-nu
192134946,Giày Búp Bê Nữ Da Bò Thật BIGGBEN Cao 5 Phân BB128,43.0,6054666195265,299000,450000,151000,34,10,giay-dep-nu
189313332,Giày Sandal Nữ The Bily 04W 3 Quai Ngang - Màu Đen BL04WD ,5.0,7805984737580,339000,339000,0,0,0,giay-dep-nu
189179216,Giày Sandal Nữ The Bily 01W Quai Chéo Dây Rút - Màu Xám BL01WX,3.0,3143155826113,359000,359000,0,0,0,giay-dep-nu
187375766,Giày sandal Nữ Da Bò Thật BIGGBEN Cao Cấp SDN79,23.0,9870956005692,309000,400000,91000,23,2,giay-dep-nu
186740219,Giày Cao Gót Da Bò Thật BIGGBEN Gót 7 Phân SDCG78,21.0,6702919806370,299000,400000,101000,25,5,giay-dep-nu
177651328,Dép Cao Gót Nữ BIGGBEN Cao 7 Phân DCG60,11.0,7513288202811,339000,400000,61000,15,2,giay-dep-nu
176714650,Dép quai kẹp Bitis nữ đế 1cm,17.0,5211030372818,79000,79000,0,0,8,giay-dep-nu
165997328,Giày sandal xuồng nữ da bò BIGGBEN cao cấp SDX34,10.0,3384332556428,359000,400000,41000,10,2,giay-dep-nu
151778357,Giày sandal nữ xỏ ngón da bò thật BIGGBEN cao cấp SDN72,15.0,4114008655916,309000,400000,91000,23,5,giay-dep-nu
151757207,Giày Sandal Cao Gót Da Bò Thật BIGGBEN SDCG69,11.0,3570224494361,319000,350000,31000,9,5,giay-dep-nu
144236060,Dép nữ da bò thật BIGGBEN cao cấp DNQN37,39.0,2717242788369,319000,400000,81000,20,18,giay-dep-nu
130069901,GIÀY LƯỜI DA NỮ CAO CẤP ,36.0,7374717466567,219000,219000,0,0,10,giay-dep-nu
114740376,"GIÀY CƯỚI - GIÀY CÔ DÂU BEJO H79 2HOA, BABY - WEDDING SHOES",4.0,4046872234074,699000,699000,0,0,3,giay-dep-nu
108392260,Dép Sục Nữ Da Bò BIGGBEN Cao Cấp SBN40,53.0,7705498181890,319000,450000,131000,29,8,giay-dep-nu
106876783,Giày Búp Bê Nữ Da Bò BIGGBEN Cao Cấp BB107,22.0,2663995418412,309000,400000,91000,23,10,giay-dep-nu
106583924,Giày búp bê nữ đế xuồng da bò BIGGBEN BB95,28.0,7042662271368,309000,400000,91000,23,10,giay-dep-nu
91255452,Giày Sandal Đế Xuồng Nữ Da Bò BIGGBEN Cao Cấp SDX28,33.0,1453267939259,339000,460000,121000,26,6,giay-dep-nu
91254419,Giày Sandal Đế Xuồng Nữ Da Bò BIGGBEN Cao Cấp SDX26,31.0,1688645551272,339000,450000,111000,25,7,giay-dep-nu
91229995,Dép Sục Nữ Da Bò BIGGBEN Cao Cấp SBN36,44.0,1214646698064,309000,400000,91000,23,12,giay-dep-nu
91019369,Giày búp bê nữ BIGGBEN da bò cao cấp BB90,40.0,8461116830391,309000,400000,91000,23,18,giay-dep-nu
76385061,Giày sandal nữ kẹp BIGGBEN da bò thật cao cấp SDN67,16.0,4422249701474,339000,400000,61000,15,5,giay-dep-nu
59211896,Giày Sandal Nữ Đế Xuồng BIGGBEN Da Bò Thật SDX20,52.0,2013044842558,369000,420000,51000,12,28,giay-dep-nu
59211327,Giày Sandal Nữ BIGGBEN Da Bò Thật SDN62,53.0,5662085734406,329000,460000,131000,28,25,giay-dep-nu
57325782,Giày Bata  Học Sinh Học Thể Dục Nam Nữ Cao Cấp,48.0,1202047010090,250000,250000,0,0,14,giay-dep-nu
52275051,Giày Sandal Cao Gót BIGGBEN Da Bò Thật SDCG43,31.0,5535283432897,339000,420000,81000,19,10,giay-dep-nu
46810419,Combo 01 cặp lót giày nguyên bàn chân đa năng và 01 cặp lót mũi giày đệm êm ngón chân_buybox_BBPK11&BBPK50,139.0,7916537069515,120000,120000,0,0,26,giay-dep-nu
36980153,Giày Sandal Nữ BIGGBEN Da Bò Thật SDN44,96.0,8685179369183,339000,400000,61000,15,37,giay-dep-nu
22969892,Dép Nữ BIGGBEN Da Bò Thật DNQN21,99.0,4635586582235,329000,400000,71000,18,29,giay-dep-nu
10039479,Sandal Nữ BIGGBEN Da Bò Thật SDN15,90.0,9078861415432,349000,400000,51000,13,36,giay-dep-nu
8005362,Giày Sandal Nữ Da Bò BIGGBEN Cao Cấp SDN04,22.0,7312313148588,329000,400000,71000,18,7,giay-dep-nu
277378705,Giày Thể Thao Nữ Biti's Hunter Street HSW006100KEM (Kem),1.0,3724183224494,616000,700000,84000,12,0,giay-dep-nu
277364735,Giày Thể Thao Nữ Biti's Hunter X LiteDash Go For Love 2k25 Edition HSW007505TRG (Trắng),1.0,9284829306012,1099000,1099000,0,0,0,giay-dep-nu
276316071,"Lót giày tăng chiều cao tăng 5cm chất liệu Đệm Khí êm chân, thoáng khí Nguyên Bàn - Đen",9.0,1514773331174,140000,140000,0,0,0,giay-dep-nu
276168374,Giày Búp Bê Bé Gái Kiểu Dáng Dễ Thương – GBB9036,1.0,4565140647143,300000,740000,440000,59,0,giay-dep-nu
275984954,Sandal Bitis Embrace (35-39),2.0,4437104069073,429000,429000,0,0,0,giay-dep-nu
275892449,Dép quai kẹp Bitis nữ (35-39),4.0,8624346173194,275000,275000,0,0,0,giay-dep-nu
275892390,Giày thể thao Bitis Embrace nữ (35-40),3.0,2090720948250,559000,559000,0,0,1,giay-dep-nu
273647314,"Chai Xịt Bọt Tuyết Vệ Sinh Giày Dép Tẩy Trắng Cao Cấp SNOKER Giặt Khô Siêu Tốc Bảo Vệ Giày Snoker Thể Thao Khỏi Bị Ố Vàng, Phai Màu ",4.0,4800884682604,30090,59000,28910,49,0,giay-dep-nu
273640348,"Lót giày thể thao Eva chống sốc, đàn hồi cao và khử mùi hiệu quả EVA-01",7.0,4802558747365,47000,55000,8000,15,0,giay-dep-nu
273639809,Giày thể thao Bitis nữ (35-39),2.0,6849693528277,565000,565000,0,0,0,giay-dep-nu
273533435,"Set 2 Miếng Lót Gót Giày Chống Rộng, Chống Nhấc Gót và Bảo Vệ Gót Tránh Trầy Xước - HÀNG CHÍNH HÃNG MINIIN",3.0,4934144762932,15200,15200,0,0,0,giay-dep-nu
273386037,"Dép chiếu đi trong nhà Hương Quế DC-05 thích hợp mang trong nhà, trong văn phòng ",17.0,4772378623800,36000,36000,0,0,5,giay-dep-nu
271424068,Giày Cao Gót Công Sở BIGGBEN Da Bò Thật Cao 5 Phân SDCG101,2.0,8573917492441,369000,400000,31000,8,0,giay-dep-nu
263339105,"Lót giày nam nữ êm chân chất liệu vải mesh cấu trúc vòm nâng đỡ lòng bàn chân, kết hợp ốp PU chống thốn và bảo vệ gót chân - buybox - BBPK359",33.0,8850661722861,52962,52962,0,0,5,giay-dep-nu
250104261,Giày Cao Gót Nữ Công Sở Da Bò Thật BIGGBEN GCG9,27.0,7950188612050,319000,450000,131000,29,5,giay-dep-nu
249935663,Giày Boot Nữ Cổ Thấp Da Bò Thật BIGGBEN Cao 5 phân BON5,1.0,2625772841196,799000,1000000,201000,20,0,giay-dep-nu
196812698,Dép nhựa Nữ  quai ngang Thái Lan có hạt Massage Monobo Moniga 25.1,10.0,6528833556516,110000,110000,0,0,1,giay-dep-nu
194453935,"Lót giày Hương Quế CL06 chính hãng, êm, bền, bột quế thật, thơm, chống hôi chân và tốt cho sức khỏe.",9.0,2349459539235,40000,53000,13000,25,0,giay-dep-nu
192937948,Giày Thể Thao Trung Cấp Nữ Biti's DSW066300,0.0,3925296000371,519000,519000,0,0,2,giay-dep-nu
190740844,Dép Nữ Da Bò Thật BIGGBEN Cao Cấp DNQN49,8.0,6601270397191,299000,360000,61000,17,3,giay-dep-nu
188410416,Dép quai kẹp Bitis nữ đế 5cm,14.0,9804156802390,245000,245000,0,0,2,giay-dep-nu
186630810,Giày Búp Bê Nữ Hỡ Mũi Da Bò Thật BIGGBEN Cao 5 Phân BB126,3.0,8813257445772,299000,380000,81000,21,2,giay-dep-nu
177667094,Dép Lông Đi Trong Nhà Hình Tai Thỏ Dễ Thương PaKaSa -Hàng Chính Hãng,15.0,4683469295400,171360,250000,78640,31,1,giay-dep-nu
150860309,Dép Eva Phun Nữ Biti's DEW007900XAM (Xám),83.0,7515605974567,102000,102000,0,0,12,giay-dep-nu
150735516,"Dép chiếu Hương Quế DCQ-38 có lớp chiếu tỏa ra hơi ấm, hương thơm nhẹ giúp kích thích các huyệt đạo trong lòng bàn chân",22.0,6033650002857,68000,68000,0,0,3,giay-dep-nu
145771465,Giày lười nữ da bò thật BIGGBEN cao cấp BB116,25.0,4335598628863,309000,400000,91000,23,10,giay-dep-nu
126303704,Đón gót giày dài 70cm gỗ Chiu Liu nguyên khối sơn mài VIP - DGH911 - Đón giày mọi tư thế cho Nam & Nữ,18.0,9608770214833,99000,99000,0,0,2,giay-dep-nu
115263821,"Dép Thái Lan Quai Ngang Nữ Mobono Moniga 4.2 , Dép đi bộ, dép đi trong nhà",56.0,9642205260784,90000,90000,0,0,11,giay-dep-nu
112959976,Giày nữ da bóng cao gót hot trend  trẻ trung năng động 21366,1.0,7234088804123,80000,80000,0,0,0,giay-dep-nu
101029840," Lót giày chống rộng, chống rớt gót cao cấp, bảo vệ chân khi mang giày - PK04",7.0,4617388869686,16000,16000,0,0,0,giay-dep-nu
91258729,Dép Đế Xuồng Nữ Da Bò BIGGBEN Cao Cấp DX30,26.0,4081573168476,309000,400000,91000,23,8,giay-dep-nu
91029933,Dép Cao Gót Nữ Da Bò BIGGBEN Cao 5 Phân DCG49,5.0,4681653010599,329000,400000,71000,18,3,giay-dep-nu
77715686,Lót giày cao gót chống trượt bàn chân về phía mũi và đệm êm gang bàn chân - 1 cặp - buybox - BBPK161,209.0,2048679588393,15000,15000,0,0,23,giay-dep-nu
59208547,Giày Sandal Cao Gót BIGGBEN Da Bò Thật Cao 4 Phân SDCG52,22.0,7090961450368,329000,400000,71000,18,8,giay-dep-nu
52251205,Dép Nữ Đế Xuồng BIGGBEN Da Bò Thật DX23,27.0,2222881580947,339000,400000,61000,15,7,giay-dep-nu
7993385,Dép Nữ BIGGBEN Da Bò Thật Cao Cấp DNQN06,53.0,1114281755524,329000,400000,71000,18,12,giay-dep-nu
7992647,Dép Nữ BIGGBEN Da Bò Thật DNQN05,40.0,1152126347220,329000,380000,51000,13,11,giay-dep-nu
6187099,Dép Cao Gót Nữ BIGGBEN Da Bò Thật DCG02,35.0,1645456094815,349000,400000,51000,13,6,giay-dep-nu
277139163,Dép Sục Nữ Da Bò Thật BIGGBEN Cao Cấp SBN57,2.0,7668286284890,329000,450000,121000,27,0,giay-dep-nu
276767436,"Lót giày cho nam và nữ khử mùi sợi tre , thơm tự nhiên , vải lưới đàn hồi thông hơi , thoáng khí khử mùi hôi hiệu quả  , giúp bảo vệ bàn chân , giữ chân sạch sẽ và khô ráo nhỏ gọn tiện lợi ",1.0,5331151483890,89000,89000,0,0,0,giay-dep-nu
276477945,Túi 50 gói khăn ướt lau giày da túi da ví da siêu tốc Leather EcoWipes tinh chất sáp ong dưỡng bóng,3.0,9903590563059,125000,212000,87000,41,0,giay-dep-nu
276437607,"Dép quai ngang đi trong nhà Hương Quế DQN-07 thích hợp mang trong nhà, trong văn phòng ",10.0,6937223814263,85000,85000,0,0,0,giay-dep-nu
276435922,"Dép chiếu Hương Quế DCQ-65 thích hợp mang trong nhà, trong văn phòng",1.0,8181127991333,85000,85000,0,0,1,giay-dep-nu
276019851,Giày Sục Đạp Gót Mules Vải Sneaker Unisex Tăng Chiều Cao 4cm DINCOX E10 Dark Navy,4.0,4120170298567,359000,520000,161000,31,1,giay-dep-nu
275973851,Khăn lau vệ sinh giày Hando 30pcs,4.0,6106412038336,35000,35000,0,0,0,giay-dep-nu
275922100,Giày thể thao Bitis Hunter  nữ HSW006400 (35-39),2.0,2835815505197,1209000,1209000,0,0,2,giay-dep-nu
275856170,Giày Đế Xuồng Nữ BIGGBEN Da Bò Thật Cao 7 Phân SDX73,4.0,4761601520242,349000,500000,151000,30,1,giay-dep-nu
275570366,"Gói 30 Tờ Giấy Ướt Lau Giày Chuyên Dụng Khăn Lau Giày Sneaker Siêu Sạch, Tiện Lợi Loại 30 Tờ Lau Giày Trắng Như Mới",0.0,9527185168526,12000,19000,7000,37,0,giay-dep-nu
273659266,Giày Sandal BIGGBEN Da Bò Thật Cao 5 Phân SDCG114,1.0,1748217421092,349000,500000,151000,30,1,giay-dep-nu
262581799,Giày Sandal Nữ Kẹp Da Bò Thật BIGGBEN Cao Cấp SDN91,3.0,9450848510001,349000,450000,101000,22,1,giay-dep-nu
262504452,Giày Sandal Cao Gót BIGGBEN Da Bò Thật Cao 12 Phân SDCG95,10.0,4911981051501,369000,500000,131000,26,1,giay-dep-nu
262469662,Dép Đế Xuồng Nữ BIGBEN Da Bò Thật Cao 5 Phân DX42,1.0,6470192825383,339000,450000,111000,25,0,giay-dep-nu
253169804,Giày Cao Gót Nữ HÀ NAM Da Bò Thật Cao Cấp 5cm GBBN2076,1.0,6314516518982,268000,450000,182000,40,0,giay-dep-nu
252070250,Giày cao gót hở mũi cao 7cm Trường Hải màu đen da mềm mại CG125Đ,7.0,3343703959971,279000,279000,0,0,2,giay-dep-nu
210762451,"Bộ đôi lót giày giúp tăng độ bám, tự tin trên mỗi bước chân - Buybox - BBPK290",10.0,8153468419002,80000,80000,0,0,0,giay-dep-nu
207854185,Giày cao gót nữ bít mũi cao 5 phân RO440 ROSATA tại BCASHOP quai ngang gắn hạt kim cương nhỏ và gót kiểu guốc sành điệu - màu đen,1.0,8653880576966,429000,429000,0,0,0,giay-dep-nu
203883935,"Lót giày cánh bướm loại lớn dày 6mm có hạt silicone chống trầy da, chống tuột gót sau - Buybox - BBPK275",13.0,1144006456366,25540,25540,0,0,1,giay-dep-nu
189266374,"Miếng lót giày cao cấp ép vải, hạt lồi tặng độ bám giúp giảm size giày và chống đau gót sau - BuyBox - BBPK198",173.0,7225781742658,20790,20790,0,0,24,giay-dep-nu
177274182,Dép Unisex Quai Ngang Hàng Cao Cấp BEE GEE DN1011- Màu Hồng,3.0,4029937571791,195000,390000,195000,50,2,giay-dep-nu
161943939,Dép Quai Ngang Nam Nữ Siêu Nhẹ Tăng Chiều Cao Chống Trơn DP02,607.0,6802163332982,73500,73500,0,0,147,giay-dep-nu
160403634,Dây Giày Cao Su Đàn Hồi Thắt BuộcThông Minh Sneaker V-Laces 14 Sợi 2 Nút Chỉnh Size Nam Nữ,51.0,5322705508781,12000,12000,0,0,7,giay-dep-nu
112961003,Giày sục nữ thời trang hở gót mũi nhọn siêu độc cực trend 21289,3.0,9467313822502,150000,150000,0,0,1,giay-dep-nu
112959714,"Dép nữ,Dép cói nữ thời trang phong cách 21436",2.0,7553875972761,135200,135200,0,0,1,giay-dep-nu
112958141,Giầy da thật nữ cao cổ Martin 20410,3.0,6651788466731,200000,200000,0,0,0,giay-dep-nu
112957947,giày nữ da thật gót 5 phân phong cách hàn quốc 21679,3.0,1510892060495,150000,150000,0,0,0,giay-dep-nu
108747100,Chai xịt giày khử mùi hôi giày hôi chân Nano Xclean For Shoes 100ml - Hương Trà Xanh - Nano Bạc AHT Corp (AHTC),1506.0,3125066602908,88000,99000,11000,11,209,giay-dep-nu
107675669,"Lót giày vòm cao ốp nhựa chuyên dùng cho bàn chân bẹt phẳng cải thiện dáng đi chân chữ X, giảm đau mỏi lòng bàn chân - buybox - V01BBPK179",125.0,6618492111128,56000,56000,0,0,11,giay-dep-nu
105159478,"Chai Xịt Khử Mùi Giày Nano Xclean Nano Bạc 100ml AHT Corp Hương Bạc Hà - Khử Mùi, Diệt Khuẩn, Làm Sạch Giày Dép Hiệu Quả An Toàn",303.0,4760527742377,88000,99000,11000,11,47,giay-dep-nu
91877043,"[Combo 3 ] Chai xịt khử mùi giày Nano Xclean Nano Bạc AHT Corp 50ml - Khử mùi, diệt khuẩn giày dép",19.0,8620194954689,181500,181500,0,0,2,giay-dep-nu
76384537,Dép Sục Nữ Hở Mũi BIGGBEN Da Bò Cao Cấp SBN32,60.0,4930664018775,319000,450000,131000,29,12,giay-dep-nu
74300815,Giày Búp Bê Nữ Da Bò BIGGBEN Cao Cấp BB75,154.0,4586405661276,309000,400000,91000,23,37,giay-dep-nu
59207398,Giày Sandal Cao Gót Nữ BIGGBEN Cao Cấp SDCG50,14.0,2222239756253,349000,400000,51000,13,3,giay-dep-nu
54066106,Dép Xỏ Ngón Nữ Da Bò BIGGBEN Cao Cấp DXN27,42.0,4062744106444,279000,380000,101000,27,15,giay-dep-nu
43182509,Bộ 2 cặp lót giày bảo vệ gót chân và chống tuột gót giày (loại hạt xoài) - buybox - BBPK20,10.0,4325954316769,20500,20500,0,0,2,giay-dep-nu
42980065,Quai giày cao gót ẩn bằng silicon trong suốt kiểu chữ Y - buybox - BBPK51,608.0,7962864945220,75000,75000,0,0,98,giay-dep-nu
42737920,Dép Nữ TLG 21022-10,2.0,8312699136482,150200,150200,0,0,0,giay-dep-nu
41996560,Dép khách sạn Hương Quế DKS-09 làm từ lụa tơ tằm - vải cotton - lớp đế cao su xốp cho đôi chân thơm - mát và khô thoáng,247.0,4496894453880,68000,68000,0,0,46,giay-dep-nu
23360693,Combo 2 bộ miếng lót cho giày rộng V.10 (Màu đen),57.0,3313015684880,40000,40000,0,0,2,giay-dep-nu
277357552,"Xịt Bọt Tuyết Vệ Sinh Giày Thể Thao, Khử Mùi & Làm Trắng Giày NAM NỮ (XGRT1) - HÀNG CHÍNH HÃNG MINIIN",1.0,6453321425636,35000,35000,0,0,0,giay-dep-nu
277226997,"Dép chiếu đi trong nhà Hương Quế DCQ-78 thích hợp mang trong nhà, trong văn phòng ",2.0,4908219852494,95000,95000,0,0,0,giay-dep-nu
276848287,"Giấy lau giày bịch 30 tờ , vệ sinh giày thể thao , các loại da , siêu sạch , tiện lợi nhỏ gọn dễ dàng mang theo mọi nơi ",1.0,4428285222556,75050,79000,3950,5,0,giay-dep-nu
276821730,"Lót giày cho nam và nữ khử mùi sợi tre, thơm tự nhiên khử mùi hôi hiệu quả  , vải lưới đàn hồi thông hơi thoáng khí giúp bảo vệ bàn chân , giữ chân sạch sẽ và khô ráo nhỏ gọn tiện lợi ",7.0,6704572025384,84550,89000,4450,5,0,giay-dep-nu
276671055,Giày cao gót BASSIC 8P PABNO PN22014,1.0,4931985756454,365000,365000,0,0,1,giay-dep-nu
276621226,Giày sneaker Thể Thao Nam Biti's Hunter Street HSM008600XLD (Xanh lá cây đậm),0.0,5792595230521,687000,687000,0,0,0,giay-dep-nu
276464401,Sandal Nữ Biti’s Hunter Dune Edition HEW001300,1.0,2573148613660,595000,595000,0,0,0,giay-dep-nu
276415969,Miếng Dán Gót Chân Gel Bio Bảo Vệ Làn Da 2cm*100cm,2.0,9240743566612,33250,35000,1750,5,0,giay-dep-nu
276190873,"Dép nữ xixitiao mềm nhẹ giá rẻ, dép đi trong nhà phong cách dễ thương mẫu mới",2.0,7673639754006,43600,43600,0,0,0,giay-dep-nu
275975462,Sục nữ da thật hàng xuất khẩu đẹp cho nàng 21684,0.0,5775999528349,185200,185200,0,0,0,giay-dep-nu
275850268,Chai xịt bọt tuyết vệ sinh giày dép tẩy trắng Snoker - Hàng chính hãng,3.0,7820500679020,75000,120000,45000,38,0,giay-dep-nu
275381850,"Giày Sandal Cao Gót Da Bò BIGGBEN Cao 3,5 Phân SDCG131",1.0,6347551477872,299000,450000,151000,34,0,giay-dep-nu
275177586,"Giày lười thể thao nữ đế êm nhẹ, thoáng khí đế cao su đúc, chống trơn trượt hạn chế mòn – GNU2077",1.0,9157913019204,390000,780000,390000,50,0,giay-dep-nu
270814743,"Giày thể thao nữ chất liệu da mềm mại, phong cách cá tính năng dộng – GNU2044",3.0,4326451093599,310000,620000,310000,50,1,giay-dep-nu
270305964,Dép Sục Nữ Da Bò Thật BIGGBEN Cao 3 phân SBN51,1.0,5089393479665,359000,450000,91000,20,0,giay-dep-nu
263276377,Chuck 70 Black High | Giày Converse Đen 1970s Cổ Cao 162050C,1.0,8752160700101,2200000,2200000,0,0,0,giay-dep-nu
252068592,"Combo 4 Túi đựng giày chất liệu vải dệt thoáng khí, chống bụi bẩn, chống ẩm ướt cho giày, dễ dàng mang theo - BuyBox - BBPK352",9.0,2347917363793,85300,85300,0,0,1,giay-dep-nu
251462728,Dép quai kẹp xốp Biti's nữ đế 7cm,8.0,9454684992719,265000,265000,0,0,2,giay-dep-nu
197608669,Sandal Eva Phun Nữ Biti's Hunter DEWH01100,1.0,4646298960664,480000,480000,0,0,0,giay-dep-nu
195547325,Giày Sandal Nữ Da Bò Thật BIGGBEN Cao Cấp SDN85,6.0,1799289408409,309000,350000,41000,12,2,giay-dep-nu
190737358,Giày Búp Bê Nữ Hỡ Mũi Da Bò Thật BIGGBEN Cao 5 Phân BB127,3.0,3945182923366,309000,400000,91000,23,0,giay-dep-nu
184955659,Lót giày Mizuno chính hãng,159.0,8810191464435,80000,80000,0,0,24,giay-dep-nu
120168820,Dụng cụ Đón gót giày bằng sừng cho mọi tư thế (Dài 38 - 42cm) DGH901-40 - Đón gót giày cho cả nam và nữ,2.0,7147817746090,139000,139000,0,0,0,giay-dep-nu
115263791,Dép Thái Lan Nữ Quai Ngang Monobo Thái Lan - Kelly 9,32.0,2000444951076,170000,170000,0,0,14,giay-dep-nu
114740166,GIÀY CƯỚI - GIÀY CÔ DÂU BEJO H70 VIỀN XOÀN - WEDDING SHOES,1.0,2382689178665,840000,840000,0,0,0,giay-dep-nu
114740058,GIÀY CƯỚI - GIÀY CÔ DÂU BEJO H51 HOA PHA LÊ - WEDDING SHOES,2.0,4682611527379,910000,910000,0,0,0,giay-dep-nu
112960802,Dép Tông thái nữ đẹp hot trend  trẻ trung năng động 21354,4.0,5460917368203,46200,46200,0,0,0,giay-dep-nu
112960472,Sandal cao gót 9 phân nữ hot trend  trẻ trung năng động 21155,1.0,6030032264010,150000,150000,0,0,0,giay-dep-nu
112958135,Sục nữ da thật siêu dễ thương 21669,1.0,7772692705729,150000,150000,0,0,0,giay-dep-nu
112955976,sandal gót 3p phối mầu 21341,1.0,8725651144493,310400,310400,0,0,0,giay-dep-nu
92161380,Chai xịt giày diệt khuẩn khử mùi hôi giày hôi chân nano bạc Nano Xclean For Shoes,492.0,7659895259489,53240,60500,7260,12,65,giay-dep-nu
88979578,"[Ảnh Thật] Dép Quai Ngang, Dép Đi Trong Nhà, Ngoài Trời Họa Tiết Cá Sấu Siêu Dễ Thương, Logo Nổi. Form Nhỏ Các Bạn Đặt Tăng 1 Size Nha Mã DP19",1270.0,6112414779005,178000,178000,0,0,330,giay-dep-nu
83480711,Lót giày cao gót 4D chống trượt bàn chân về phía trước - buybox - BBPK165,159.0,6636879002039,17000,17000,0,0,26,giay-dep-nu
76796961,Giày Mọi Da Nữ Cao Cấp Full Box Chất Liệu Da Mềm,56.0,6410320172499,219000,219000,0,0,11,giay-dep-nu
42733854,Giày lười nữ TLG 20829-4,2.0,5021360349726,150200,150200,0,0,1,giay-dep-nu
35029677,Miếng lót cho giày rộng V.8 - Màu nâu,34.0,1226878375326,15000,15000,0,0,4,giay-dep-nu
28737579,2 cặp miếng lót mũi giày cao gót 4D êm chân thoáng khí - buybox - BBPK14,30.0,5508196060556,20000,20000,0,0,4,giay-dep-nu
26848576,Dép Cao Gót Nữ BIGGBEN Cao Cấp DCG26,71.0,6631008739810,329000,400000,71000,18,26,giay-dep-nu
20235117,Xi đánh giày Kangaroo Hàn Quốc - Nhập khẩu chính hãng,481.0,5528160162536,39000,39000,0,0,35,giay-dep-nu
277617422,"Giày Sandal nữ kiểu dáng mới chống trơn, trượt – GSDN09",2.0,6120459379448,506000,1012000,506000,50,0,giay-dep-nu
277615645,"Giày Sandal nữ kiểu dáng mới chống trơn, trượt – GSDN08",0.0,5709682407868,530000,1060000,530000,50,0,giay-dep-nu
277532657,"Giày nữ quai sau da lì ROSATA RO683 - 3p - Đen, Nude - HÀNG VIỆT NAM - BKSTORE",0.0,4026438224990,399000,399000,0,0,0,giay-dep-nu
277506601,Dép Cross Nữ Hàng Cao Cấp - DNU9072,1.0,8506009588772,560000,1120000,560000,50,0,giay-dep-nu
277294524,"Giày thể thao nữ, giày chạy bộ đế êm nhẹ, thoáng khí đế cao su đúc, chống trơn trượt hạn chế mòn  – GNU2084",1.0,5545546840993,570000,1140000,570000,50,1,giay-dep-nu
276437578,"Dép chiếu đi trong nhà Hương Quế DCQ-69 thích hợp mang trong nhà, trong văn phòng ",6.0,1737523085915,40000,40000,0,0,0,giay-dep-nu
276367522,Giày Cao Gót Nữ Da Bò Thật BIGGBEN Cao 5 Phân GCG17,2.0,4833320285486,379000,500000,121000,24,0,giay-dep-nu
276357696,Giày Thể Thao Nữ Biti’s Hunter X LiteDash - Festive Edition 2K24: Lush Beige ​HSW007506KEL (Kem lợt),0.0,6641841461787,802000,1050000,248000,24,0,giay-dep-nu
276194397,"Giày thể thao nữ, giày chạy bộ đế êm nhẹ, thoáng khí đế cao su đúc, chống trơn trượt hạn chế mòn  – GNU2079",0.0,1922030069999,290000,580000,290000,50,0,giay-dep-nu
274938961,"Giày thể thao nữ, giày chạy bộ đế êm nhẹ, thoáng khí đế cao su đúc, chống trơn trượt hạn chế mòn  – GNU2066",22.0,3586682318684,360000,720000,360000,50,2,giay-dep-nu
273639484,Dép quai kẹp Biti's nữ (35-39),5.0,7422765704520,265000,265000,0,0,0,giay-dep-nu
273466572,Giày Thể Thao Nữ Biti's Hunter X HSW004400XAL (Xám lợt),3.0,4008897684106,883000,932000,49000,5,1,giay-dep-nu
262503952,Giày Cao Gót BIGGBEN Da Bò Thật Cao 7 Phân SDCG94,3.0,3904630691818,379000,500000,121000,24,0,giay-dep-nu
197637839,Giày Đế Xuồng Nữ BIGGBEN Da Bò Thật Đế Cao 5cm SDX42,7.0,7642533422326,339000,400000,61000,15,1,giay-dep-nu
197418062,Giày Sandal Nữ BIGGBEN Da Bò Thật SDN08,124.0,3690408472205,339000,450000,111000,25,40,giay-dep-nu
197044015,Giày Sandals Bít mũi Vento OPTIMUS du lịch/trekking SD08003,36.0,1444976717612,395000,395000,0,0,7,giay-dep-nu
195528889,Giày Sandal Nữ Da Bò Thật BIGGBEN Cao Cấp SDN83,20.0,6296740061100,309000,350000,41000,12,7,giay-dep-nu
195520342,Dép Sục Nữ Da Bò Thật BIGGBEN Cao 3 phân SBN45,12.0,6919315591831,329000,450000,121000,27,7,giay-dep-nu
192937741,Giày Thể Thao Nữ Êmbrace DSW066400,7.0,7966269677086,539000,539000,0,0,2,giay-dep-nu
192643040,Giày Thể Thao Nữ Biti's Hunter X LITEPLEX DSWH09800,0.0,5441193659626,961000,961000,0,0,0,giay-dep-nu
188657473,Giày Đế Xuồng Nữ Da Bò Thật BIGGBEN Cao 9cm SDX39,17.0,1627881456949,369000,450000,81000,18,3,giay-dep-nu
186740130,Giày Cao Gót Da Bò Thật BIGGBEN Gót 5 Phân SDCG77,9.0,8732077837817,369000,500000,131000,26,6,giay-dep-nu
174384911,Sandal đế bệt nữ Aldo MARASSI,2.0,2967335271410,1650000,1650000,0,0,0,giay-dep-nu
166034273,Dép nữ da bò thật BIGGBEN cao cấp DNQN42,13.0,9726680918637,299000,350000,51000,15,3,giay-dep-nu
165998023,Giày sandal xuồng nữ da bò BIGGBEN cao cấp SDX35,15.0,7592550323949,369000,500000,131000,26,4,giay-dep-nu
147588439,Giày búp bê nữ BIGGBEN da bò cao cấp BB117,21.0,6767097614234,309000,450000,141000,31,4,giay-dep-nu
129354416,Giày Sandal Vento Nam Nữ Quai Ngang dạo phố/đi chơi/đi học NV1001 Nhiều Màu,30.0,5461558680227,325000,325000,0,0,13,giay-dep-nu
114740625,GIÀY CƯỚI - GIÀY CÔ DÂU H100.03 REN HOA HỒNG - WEDDING SHOES,0.0,6035998846824,840000,840000,0,0,0,giay-dep-nu
91255482,Giày Sandal Đế Xuồng Nữ Da Bò BIGGBEN Cao Cấp SDX29,17.0,5472205666371,339000,400000,61000,15,4,giay-dep-nu
91205516,Giày Sandal Cao Gót Da Bò BIGGBEN Cao 7 Phân SDCG63,15.0,3712077255873,319000,350000,31000,9,5,giay-dep-nu
91011976,Giày búp bê nữ BIGGBEN da bò cao cấp BB89,19.0,5496591481494,309000,400000,91000,23,3,giay-dep-nu
84197046,Giày Sandals Vento Nam Nữ Quai Ngang dạo phố đi chơi đi học du lịch NB80,13.0,9997758962536,385000,385000,0,0,2,giay-dep-nu
74370871,Giày sandal nữ kẹp da bò thật cao cấp BIGGBEN SDN65,27.0,2712781029849,339000,450000,111000,25,14,giay-dep-nu
72101747,Giày Sandal Cao Gót BIGGBEN Da Bò Thật SDCG56,16.0,9712741727092,349000,400000,51000,13,9,giay-dep-nu
52274758,Giày Sandal Nữ Cao Gót BIGGBEN Da Bò Thật SDCG41,24.0,5103205749240,339000,400000,61000,15,13,giay-dep-nu
52188508,Giày Sandal Nữ BIGGBEN Da Bò Thật SDN50,10.0,9443764791585,329000,350000,21000,6,2,giay-dep-nu
45948108,Bộ 2 miếng lót gót giày nữ chống nhấc gót (Lót Vải Mềm),26.0,6654351975421,15000,15000,0,0,2,giay-dep-nu
36978574,Giày Sandal Nữ BIGGBEN Da Bò Thật SDN42,34.0,8104998158865,339000,400000,61000,15,5,giay-dep-nu
22986513,Dép Xỏ Ngón Nữ BIGGBEN Da Bò Thật DXN20,39.0,5078518283852,279000,350000,71000,20,14,giay-dep-nu
12696057,Giày Búp Bê BIGGBEN Da Bò Thật Cao Cấp BB35,31.0,9850606298629,299000,350000,51000,15,11,giay-dep-nu
277615168,"Giày Sandal nữ kiểu dáng mới chống trơn, trượt – GSDN06",0.0,9846495684385,520000,1040000,520000,50,0,giay-dep-nu
277512333,Dép Cross Nữ Hàng Cao Cấp - DNU9075,0.0,6597224530972,500000,1000000,500000,50,0,giay-dep-nu
277278263,"Giày thể thao nữ, giày chạy bộ đế êm nhẹ, thoáng khí đế cao su đúc, chống trơn trượt hạn chế mòn  – GNU2089",4.0,5945398841230,380000,760000,380000,50,1,giay-dep-nu
276617595,Sandal thể thao đế Eva phun Nữ Biti's Hunter HEW001001XAM (Xám),0.0,4749046069349,435000,435000,0,0,0,giay-dep-nu
276610111,Dép Eva Phun Nữ Biti's E-Soft BEW001100XMN (Xanh minơ),1.0,9197032881456,266000,295000,29000,10,0,giay-dep-nu
275790311,Giày thể thao nữ Aldo GRADSKIY,2.0,5944081980967,2550000,2550000,0,0,1,giay-dep-nu
275789431,Dép Bitis nữ (35-40),1.0,8704822232831,295000,295000,0,0,0,giay-dep-nu
274567288,"Dép sục Nesty Synthetic an toàn, êm ái, dễ vệ sinh",11.0,1034492383487,89000,89000,0,0,2,giay-dep-nu
274535356,"Giày thể thao nữ phong cách cá tính, thoáng khí, đế cao su đúc, chống trơn trượt hạn chế mòn  - gnu2061",1.0,3578417562196,540000,1080000,540000,50,1,giay-dep-nu
274524012,"Giày Sandal Nữ cao gót TRường Hải quai ngang da bóng 2 màu đen, kem đế PU cao 8cm SD145K",0.0,3921727732971,319000,319000,0,0,0,giay-dep-nu
214000480,Giày Thể Thao Biti's Nữ DSW066800,4.0,2857148626626,540000,540000,0,0,3,giay-dep-nu
198431306,Dép Đế Xuồng Nữ BIGBEN Da Bò Thật Cao 5 Phân DX40,4.0,5075400708816,349000,400000,51000,13,2,giay-dep-nu
196342649,Dép Thái Lan nữ quai đúc siêu nhẹ Monobo moniga 10.5,3.0,4777120138072,90000,90000,0,0,1,giay-dep-nu
192196517,Giày sandal nữ da bò thật BIGGBEN cao cấp SDN81,2.0,5930643283537,339000,400000,61000,15,1,giay-dep-nu
190739763,Dép Nữ Da Bò Thật BIGGBEN Cao Cấp DNQN48,7.0,4326588346423,299000,350000,51000,15,2,giay-dep-nu
189318903,Giày Sandal Nữ The Bily 04W 3 Quai Ngang - Màu Xám BL04WX ,0.0,3776340903614,339000,339000,0,0,0,giay-dep-nu
187311516,Dép Sục Nữ Da Bò Thật BIGGBEN Cao 5 phân SBN42,13.0,5549998782612,329000,450000,121000,27,2,giay-dep-nu
186633861,Dép Nữ Da Bò Thật BIGGBEN Cao 3 Phân DNQN45,7.0,1092900847111,309000,400000,91000,23,0,giay-dep-nu
180364499,Dép nữ quai ngang siêu nhẹ Thái Lan ADDA 82M25,4.0,2768662697202,140000,140000,0,0,1,giay-dep-nu
177643992,Dép nữ da bò thật BIGGBEN cao cấp DNQN43,5.0,5233081909123,299000,350000,51000,15,1,giay-dep-nu
173563018,Giày Cao Gót Da Bò Thật BIGGBEN Gót 7 Phân SDCG73,22.0,4133324365236,369000,450000,81000,18,9,giay-dep-nu
172963321,Dép Đế Xuồng Nữ Da Bò Thật BIGGBEN Cao Cấp DX36,6.0,9876292312621,309000,350000,41000,12,0,giay-dep-nu
150733008,"Dép chiếu Hương Quế DCQ-12 là một sản phẩm thủ công đẹp, sang trọng và tốt cho sức khoẻ người mang",40.0,3112148625597,68000,68000,0,0,6,giay-dep-nu
133236075,Giày nhựa đúc 2 lớp Thái Lan đi mưa MONOBO - TAMMY,22.0,2705420823942,180000,180000,0,0,7,giay-dep-nu
115264279,Dép kẹp nữ xỏ ngón Thái Lan Nữ  Monobo Moniga 5.5,29.0,1935146526214,90000,90000,0,0,6,giay-dep-nu
114740965,GIÀY CƯỚI - GIÀY CÔ DÂU BEJO H92 3HOA CÀNH VÀNG - WEDDING SHOES,1.0,6689500137820,840000,840000,0,0,1,giay-dep-nu
110461293,Giày Nữ Búp Bê Đế Xuồng HÀ NAM Da Bò Thật Cao Cấp 4cm GBBN2039,0.0,1892497072842,268000,379000,111000,29,0,giay-dep-nu
106605092,Giày búp bê nữ BIGGBEN da bò cao cấp BB99,154.0,6191829381584,289000,400000,111000,28,50,giay-dep-nu
74307584,Dép Nữ Cao Gót BIGGBEN Cao Cấp DCG44,24.0,7177830931095,319000,450000,131000,29,5,giay-dep-nu
72039444,Giày Búp Bê Nữ Da Bò BIGGBEN Cao Cấp BB74,12.0,4282818029824,309000,400000,91000,23,4,giay-dep-nu
59206148,Dép Bít Đầu Nữ Da Bò Cao Cấp SBN30,20.0,5595944014275,359000,450000,91000,20,11,giay-dep-nu
55073373,Sandal Cao Gót Nữ Da Bò BIGGBEN Cao Cấp SDCG47,42.0,1184987341567,349000,450000,101000,22,19,giay-dep-nu
54384192,Giày Nữ Búp Bê Da Bò BIGGBEN BB67,27.0,1290426413662,319000,400000,81000,20,13,giay-dep-nu
53112821,Dép chiếu Hương Quế DCQ-50 làm từ lụa tơ tằm - vải cotton - lớp đế cao su xốp cho đôi chân thơm - mát và khô thoáng - Xanh,199.0,6067211711617,68000,68000,0,0,29,giay-dep-nu
48333238,Dép Xuồng Nữ Da Bò BIGGBEN DX17,43.0,6396401381140,339000,450000,111000,25,14,giay-dep-nu
36978561,Giày Sandal Nữ Đế Xuồng BIGGBEN Da Bò Thật SDN38,54.0,8737403962438,339000,420000,81000,19,17,giay-dep-nu
22968560,Giày Sandal Xuồng Nữ BIGGBEN Da Bò Thật SDX09,26.0,9071844704783,339000,400000,61000,15,3,giay-dep-nu
10037828,Dép Nữ BIGGBEN Da Bò Thật DNQN12,61.0,4440533912221,329000,350000,21000,6,15,giay-dep-nu
10037770,Dép Nữ Biggben Da Bò Thật DNQN10,92.0,8893190015693,329000,400000,71000,18,17,giay-dep-nu
24200491," Ống nhòm đêm cao cấp có quay phim, chụp ảnh kỹ thuật số Carson NV-250 Aura Plus - Hàng chính hãng",2.0,9397242692034,7150000,7150000,0,0,0,may-anh
74239208,Ống nhòm chống thấm nước Barska 10x42 Level HD - Hàng chính hãng  ,0.0,2648254501478,9845000,9845000,0,0,0,may-anh
53410215,Ống nhòm Barska Lucid View 10x42mm New - Hàng chính hãng,11.0,6149456168651,2430000,2430000,0,0,1,may-anh
57270254,Ống nhòm mini bỏ túi Carson JD-718 MiniScout - Hàng chính hãng,6.0,5795076581984,1060000,1060000,0,0,3,may-anh
193441075,Ống nhòm chống nước kèm bộ chuyển đổi điện thoại thông minh Carson MonoPix MP-842IS - Hàng Chính Hãng,10.0,6424355083383,3863840,3863840,0,0,1,may-anh
277417151,"Camera Yoosee Wifi Ngoài Trời 2 Mắt Xem Cùng Lúc, Góc rộng, Đàm Thoại, IP66 Chống Nước, Báo Động, Hàng Nhập Khẩu - Bảo Hành 12 Tháng",8.0,5796870394494,399000,550000,151000,27,3,may-anh
277343082,"Camera Yoosee 3 Mắt Máy Bay Độc Lập Siêu Sắc Nét, Đêm Có Màu, Đàm Thoại Hai Chiều, Chống Nước Nhựa IP66, Hàng Nhập Khẩu",38.0,1050464007594,549000,659000,110000,17,7,may-anh
276961523,Camera IP WiFi EZVIZ H6C Pro 3K 5MP - Hàng Chính Hãng,24.0,5159420112118,639000,950000,311000,33,3,may-anh
276862124,Camera hành trình VIETMAP TS-C9P - Hàng chính hãng,4.0,3208077286406,1480000,1890000,410000,22,2,may-anh
276857147,"Thẻ Vietmap Live Pro Chính Hãng 2025, cảnh báo tốc độ, camera phạt nguội dùng trên điện thoại, Android.box, Màn hình Ô Tô - Hàng chính hãng",0.0,2964857678442,475000,475000,0,0,0,may-anh
193442641,"Ống nhòm nhìn ngày, đêm BARSKA NVX-700 (Phóng đại 9x) - Hàng Chính Hãng",1.0,2511384102962,9900000,9900000,0,0,1,may-anh
97684079,Ống nhòm Fomei 10x32 DCF - Hàng chính hãng,1.0,4669832470955,3080000,3080000,0,0,0,may-anh
13593871,Ống nhòm Barska Lucid 12x25mm - Hàng chính hãng,32.0,7441512083694,1200000,1200000,0,0,5,may-anh
24210643,Ống nhòm ngày cao cấp Carson RD-826 (chống nước) - Hàng chính hãng,3.0,3627898717147,4390000,4390000,0,0,1,may-anh
7389203,Ống Nhòm Barska Lucid 8x21mm(AB13273) - Hàng chính hãng,148.0,4014871971242,850000,850000,0,0,28,may-anh
276566215,"  Hộp Kỹ Thuật Chứa Nguồn Camera chống nước, Độ bền cao -  Hàng nhập khẩu",104.0,3050800810862,19000,19000,0,0,1,may-anh
276565844,(Mẫu 2025) Camera yoosee 3 mắt 3 khung độ phân giải 18.0MPx có zoom dc 12x âm thanh hình ảnh rõ nét góc quay rộng - Hàng chính hãng,14.0,7831625664175,599000,599000,0,0,1,may-anh
276515838,"Tripod Yunteng VCT-5228 Đa Năng - Chân Đế Quay Phim Chụp Ảnh Chuyên Nghiệp, Cao Tối Đa 210cm - Hàng chính hãng",4.0,4357583749876,550000,800000,250000,31,0,may-anh
276376478,Camera IP Wifi EZVIZ C6N Pro 2K (3MP) - Phiên bản nâng cấp của C6N - Hàng chính hãng,219.0,4201739182125,432000,900000,468000,52,12,may-anh
275544310,"Nguồn Adapter 12V 2A; 3A; 5A; 6A Cho Đèn Led, Camera - Hàng Chính Hãng",51.0,6491677868025,49000,49000,0,0,4,may-anh
74238684,Ống nhòm chống nước BARSKA Blackhawk 12x42mm WP - Hàng chính hãng,2.0,2415048164870,5082000,5082000,0,0,1,may-anh
6476249,"Ống Nhòm Chống Nước, Chống Mờ Sương Fomei 10x42 DCF BEATER - Hàng chính hãng",0.0,3521952268319,5940000,5940000,0,0,0,may-anh
72722935,Ống nhòm hàng hiệu Swarovski CL Pocket 10x25 ( Màu xanh) - Hàng chính hãng,1.0,2711449738772,22550000,22550000,0,0,1,may-anh
272468579,Ống nhòm Carson JD-822 - Hàng chính hãng,3.0,7454258322146,1210000,1210000,0,0,0,may-anh
275399758,Ống nhòm tầm xa cỡ lớn Barska Gladiator 25-125x80 Zoom (Hàng chính hãng),0.0,8114422248575,19250000,19250000,0,0,0,may-anh
275271535,"Adapter camera nguồn 12V - 2A loại ngoài trời, trong nhà có móc treo, Nguồn camera chống nước - Hàng nhập khẩu",44.0,8971484922404,64000,64000,0,0,3,may-anh
275257961,"Camera Wifi Ngoài trời TP-Link Tapo C520WS - Độ phân giải 2K 4MP, Chống chịu thời tiết IP66, Có màu ban đêm - Hàng chính hãng",26.0,4328604371600,950000,1290000,340000,26,6,may-anh
274879959,Camera IP Wifi Trong Nhà EZVIZ C6N 1080p - Hàng Chính Hãng,96.0,2169110112953,390000,390000,0,0,9,may-anh
274393734,"Camera IP Wifi EZVIZ H7C Dual - 2 Camera 4MP + 4MP Quay quét 360 Độ, Gọi Điện Hai Chiều - Hàng Chính Hãng",5.0,7212941926222,900000,900000,0,0,1,may-anh
274065704,Camera IP WiFi Quay Quét Ngoài Trời EZVIZ H8c 4MP 2K+ - Hàng Chính Hãng,35.0,3953920427365,990000,1500000,510000,34,7,may-anh
261813954,Thẻ nhớ SDXC SanDisk Ultra 140MB/s 64GB - Hàng Nhập Khẩu,85.0,2479445543407,175000,175000,0,0,7,may-anh
252006029,"Camera Giám Sát Chống Trộm, Camera Wifi Mini Không Dây A9, Độ Phân Giải 720P, App Xem Từ Xa - HÀNG CHÍNH HÃNG MINIIN",90.0,3634175107523,129000,129000,0,0,5,may-anh
247421211,Camera IP WIFI IMOU RANGER 2 IPC - A22EP Full HD 1080P - Hàng Chính Hãng,106.0,1872897052714,395000,395000,0,0,12,may-anh
212935818,"Chân Đế Camera Xoay 360 Phù Hợp Với Camera C6N Chân Đế L Camera A22 Chân Đế Dome Camera Imou Vitacam,  - Hàng nhập khẩu",29.0,3869819887349,13500,13500,0,0,3,may-anh
212934661,"Camera IP Wifi trong nhà EZVIZ C6N 4M 2K, xoay 360 độ ezviz C6N Full HD, đàm thoại 2 chiều - Hàng chính hãng",72.0,8913857482942,390000,390000,0,0,7,may-anh
205985107,Camera IP WiFi Ngoài Trời EZVIZ H8 2K (2304 × 1296p) - Hàng chính hãng,448.0,3763312312999,1200000,2244000,1044000,47,66,may-anh
194140778,Thẻ nhớ SDXC SanDisk Extreme Pro SDSDXXD-256G U3 V30 256GB 200MB/s New 2022 - Hàng Nhập Khẩu,98.0,9472565296302,845000,845000,0,0,12,may-anh
194140440,Thẻ nhớ SDXC SanDisk Extreme Pro SDSDXXD-128G U3 V30 128GB 200MB/s New 2022 - Hàng Nhập Khẩu,607.0,5428393067079,455000,455000,0,0,83,may-anh
193887385,Nguồn cho Camera 12V-1A Hikvision - Hàng Chính Hãng,101.0,9021102216815,78200,78200,0,0,7,may-anh
187642259,Camera WiFi Ngoài Trời TP-Link Tapo C320WS 4MP - Hàng Chính Hãng,9.0,6479399419061,790000,1888000,1098000,58,1,may-anh
159482551,"Pin sạc Kingma Ver 2 cho Sony NP-FZ100, Hàng chính hãng",26.0,6408351012816,269999,269999,0,0,1,may-anh
158477449,Chân Đế Dome cho camera IMOU - Hàng Chính Hãng,461.0,4703200121255,30000,30000,0,0,61,may-anh
148713428,"Camera Yoosee Trong Nhà Thế Hệ Mới Ban Đêm Có Màu, Đàm Thoại Hai Chiều Full HD 1080P-Hàng Nhập Khẩu",89.0,4492022478159,330000,330000,0,0,23,may-anh
142796515,Camera IP wifi trong nhà IMOU Ranger 2 2MP/4MP - Hàng Chính Hãng,42.0,4486370289309,389000,389000,0,0,9,may-anh
131416196,Camera IP 360 độ 1080P TP-Link Tapo C200 Trắng - Hàng chính hãng,31.0,6908264427373,335000,335000,0,0,3,may-anh
129078637,Combo Camera Wi-fi Trong Nhà EZVIZ C1C-B 2MP Kèm Thẻ Nhớ  32GB/64G - Hàng Chính Hãng,79.0,7359100477498,485000,485000,0,0,15,may-anh
106661426,"Camera wifi gia đình IMOU Ranger 2 A42P 4MP chính hãng xoay 360 độ , đàm thoại hai chiều , nhận thông báo khi phát hiện chuyển động và tiếng động lạ - Hàng Chính Hãng",527.0,9140740338885,720000,720000,0,0,76,may-anh
105888600,Thẻ nhớ 64GB HikvisionHS-TF-C1 - Hàng chính hãng,0.0,9837115021208,120000,120000,0,0,0,may-anh
104070115,Đầu đọc thẻ nhớ SSK cho máy ảnh - Hàng chính hãng,40.0,9274047669347,139000,139000,0,0,5,may-anh
82983828,"Filter Kính lọc UV Marumi 37-82cm, Chính hãng",58.0,2151144672183,239999,239999,0,0,17,may-anh
74500335,Camera IP Wifi TP-Link Tapo C200 Full HD 1080P Giám sát An Ninh - Hàng Chính Hãng,283.0,3915735137426,335000,335000,0,0,42,may-anh
56021195,Pin CR2 Panasonic Lithium Photo Power 3V chính hãng vỉ 1 viên,37.0,5766073315971,120000,120000,0,0,3,may-anh
54023404,Camera IP Wifi Ezviz C6N CS-CV246 + Thẻ nhớ Ezviz 32GB - Hàng Chính Hãng,100.0,2729121430364,487000,487000,0,0,8,may-anh
47868431,Camera Wi-Fi TP-Link Tapo C200 1080P (2MP) An Ninh Gia Đình Có Thể Điều Chỉnh Hướng - Hàng Chính Hãng,204.0,7892901299866,349000,459000,110000,24,70,may-anh
32923633,Vỉ 5 Viên Pin CR2032 Panasonic ( CR-2032/5BE x 1 Vỉ ) Lithium 3 V,181.0,1208304588111,72000,72000,0,0,33,may-anh
274184675,"Camera Wifi Ezviz 2 Mắt Ngoài Trời H9C 3K 6MP/10MP, quay 360 độ, đàm thoại 2 chiều - Hàng chính hãng",73.0,8238136231670,1270000,1270000,0,0,14,may-anh
277411816,"Camera Yoosee 2 MẮT KÉP Trong Nhà 10MPX Xoay 360 Độ, Xem Đêm Có Màu, Có Đàm Thoại, Bảo Hành 12 Tháng, Hàng Nhập Khẩu",14.0,9127034031019,350000,350000,0,0,3,may-anh
277531483,[Bảo hành 24 tháng] Camera YOOSEE WIFI ngoài trời 4 mắt 3 màn hình 20MPX tích hợp  LED siêu nét - Hàng nhập khẩu,7.0,7267745246931,599000,599000,0,0,0,may-anh
277355111,"Camera 360° Xiaomi - Hàng chính hãng - Camera quan sát Mi 360° 1080P Mi Home Security có đèn hồng ngoại, kết nối wifi",15.0,2386205396581,659000,659000,0,0,0,may-anh
276841105,"Ulanzi MT-63 - Tripod Mini 2 In 1 Di Động Dành Cho Máy Ảnh, Điện Thoại, Trọng Tải 4kg- Hàng chính hãng",1.0,7347643945245,1403000,1403000,0,0,1,may-anh
275240403,ROGTZ - Camera Nội Soi Công Nghiệp Camera Kép AN112  Chống Nước IP68 Tương Thích Android/IOS Cáp Mềm 1m Phụ Kiện Đa Dạng  Độ Phân Giải 1080P | Góc Nhìn 70° - Hàng Chính Hãng,6.0,9013240093777,515000,515000,0,0,0,may-anh
270824793,Ống nhòm đêm kỹ thuật số BARSKA NVX-600 - Hàng chính hãng,0.0,3976334454695,13300000,13300000,0,0,0,may-anh
274852482,"Chân Đế Dome cho các dòng camera,Chân Đế Camera Xoay 360 - Hàng Chính Hãng",1.0,6893335797048,9700,9700,0,0,0,may-anh
274754859,"(Mẫu mới 2024) Camera WIFI YooSee 4 mắt 3 màn hình PTZ 12.0MPx - tích hợp 54 đèn LED siêu sáng hỗ trợ đàm thoại 2 chiều, cảnh báo chuyển động - Hàng chính hãng",43.0,8743418640038,398000,398000,0,0,5,may-anh
274370285,(Lỗi 1 đổi 1) CAMERA YOOSEE NĂNG LƯỢNG MẶT TRỜI DÙNG SIM 4G FHD - XOAY 350 ĐỘ - ĐÀM THOẠI 2 CHIỀU - CẢNH BÁO CHUYỂN ĐỘNG - CHỐNG NƯỚC - PIN SẠC NLMT - CHƯA CÓ SIM - Hàng nhập khẩu,5.0,3281502269509,590000,590000,0,0,1,may-anh
274184112,"Camera Wifi IMOU 2 Mắt S2XP Ranger Dual 6MP/10MP, quay 360 độ, có màu ban đêm, đàm thoại 2 chiều - Hàng chính hãng",4.0,6936494695724,750000,750000,0,0,1,may-anh
50014370,Ống nhòm một mắt zoom 7x - 21x Carson ZM-721 - Hàng chính hãng,55.0,1703719570213,1749640,1749640,0,0,16,may-anh
24442797, Ống nhòm cao cấp Carson Tracker TZ-821 - Hàng chính hãng,43.0,3776175139148,1510000,1510000,0,0,9,may-anh
7388523,Ống Nhòm Barska Lucid 10x42mm - Hàng chính hãng,41.0,4372171995017,2013000,2013000,0,0,9,may-anh
274160255,"Camera Wifi TP-Link Tapo C120 Trong Nhà/ Ngoài Trời Chống Nước, Đế Nam Châm, Độ Phân Giải 2K QHD - Hàng Chính Hãng",5.0,5699652068308,741000,1499000,758000,51,1,may-anh
273976417,"Thẻ nhớ Camera Ezviz 64Gb Class 10 Tốc Độ Cao, Cho Camera, Điện Thoại - Hàng Chính Hãng",6.0,5645961832395,139000,139000,0,0,0,may-anh
272268455,"Camera Wifi EZVIZ H3C 2MP Có Màu Ban Đêm, H3C 1080P Mic thu âm - Hàng Chính Hãng",28.0,2727295692818,567000,567000,0,0,2,may-anh
270964237,Camera Wifi Ezviz CS-H1C (2.0MP) - Hàng chính hãng,2.0,4304538791838,419000,419000,0,0,0,may-anh
263440988,Camera Yoosee 2305D Ngoài Trời 2 Mắt 5.0Mpx Siêu Nét Góc Nhìn Rộng - Hàng Chính Hãng,4.0,7863393406117,410000,410000,0,0,1,may-anh
261813781,Thẻ nhớ SDHC SanDisk Ultra 120MB/s 32GB - Hàng Nhập Khẩu,108.0,5855575357381,155000,155000,0,0,10,may-anh
257574302,"CAMERA 2 MẮT TRONG NHÀ YOOSEE YS2304 - 4.0MPX KẾT NỐI WIFI, XOAY 360 ĐỘ, ĐÀM THOẠI 2 CHIỀU - Hàng Chính Hãng",41.0,1819739899397,499000,499000,0,0,5,may-anh
252676966,Thẻ nhớ Acer MicroSD Card MSC300 4K UHS-I tốc độ đọc/ghi lên đến 160/120MB/s - Hàng chính hãng bảo hành 5 năm | Thẻ nhớ camera chuyên nghiệp 64GB |128GB | 256GB,18.0,8317285063701,125000,175000,50000,29,3,may-anh
248585546,"Hohem Isteady XE / XE Kit - Gimbal Chống Rung Cho Smartphone, Tải Trọng 280g, Sử Dụng 8 Giờ- Hàng chính hãng",2.0,2706623265085,1375000,1375000,0,0,0,may-anh
241781605,"500gr gói hút ẩm loại lớn 50gr (10 gói), 100gr (5 gói), 200gr (2 gói) nhãn hiệu MAX DESI hàng chính hãng",3.0,7582726731017,69000,69000,0,0,0,may-anh
214672890,Camera IP Wifi quay quét EZVIZ C8W 4MP - Đàm thoại 2 chiều - Hàng chính hãng,1.0,5787548005085,1348900,1348900,0,0,0,may-anh
208120654,"Chân đế gắn camera Akia cho camera Ezviz, Imou,... - Gắn camera vào bất cứ đâu, tiện lợi, dễ dàng - Hàng chính hãng",140.0,8952184181041,35000,35000,0,0,14,may-anh
197346754,"Camera Wifi EZVIZ C6N 1080P, Camera wifi EZVIZ C6N 2mp,CAMERA WI-FI QUAN SÁT HỒNG NGOẠI EZVIZ C6N Full HD 1080p ,CAMERA WIFI EZVIZ  C6N thích hợp lắp đặt TRONG NHÀ,HÀNG CHÍNH HÃNG",5.0,8838560038537,667000,667000,0,0,0,may-anh
195881741,Thẻ nhớ SDXC SanDisk Extreme U3 V30 256GB 180MB/s SDSDXVV-256G (New 2022) - Hàng Nhập Khẩu,69.0,3005623654654,660000,660000,0,0,10,may-anh
170400691,Camera wifi Ezviz C6N không dây xoay 360 độ đàm thoại 2 chiều - Hàng chính hãng,0.0,4871665237906,560000,560000,0,0,0,may-anh
133436638,Ống kính Sigma 18-50mm F/2.8 DC DN (C) Sony E- mount Hàng chính hãng	,10.0,9810990350062,13750000,13750000,0,0,4,may-anh
116987925,"Camera ip Yoosee Wifi 3 Râu 8 Led Có Màu Ban Đêm, xoay 360 độ, Bản Chuẩn 1080Pixel - Hàng Nhập Khẩu",77.0,9138707779275,210000,210000,0,0,11,may-anh
113427448,"bộ chuyển nguồn poe 48v-12v dùng cho camera, Hàng Chính Hãng.",44.0,2187355793612,49000,49000,0,0,8,may-anh
108216240,Pin Kingma for Olympus BLN-1 - Hàng chính hãng,4.0,8586625927727,299999,299999,0,0,0,may-anh
107356974,Camera Wifi TP-Link Tapo C210 Độ Phân Giải 3MP Lưu trữ 256GB Giám Sát An Ninh - Hàng Chính Hãng,12.0,4230588822708,590000,1399000,809000,58,1,may-anh
106598819,"Camera IP Wifi Ngoài Trời Imou F22FP Bullet 2E Full HD 1080P CÓ MÀU BAN ĐÊM ,KÈM PHÍCH CẮM ÂM- Hàng Chính Hãng",1.0,7694979604525,678900,678900,0,0,0,may-anh
85764360,Camera Wifi TP-Link Tapo C310 3MP An Ninh Ngoài Trời - Hàng Chính Hãng,72.0,3958790916683,655000,655000,0,0,19,may-anh
84866683,Camera IP Wifi Trong Nhà Ezviz Mini CS-C1C-B 1080p - Hàng Chính Hãng,4040.0,2786575340597,370000,990000,620000,63,593,may-anh
56020795,Pin CR123A Panasonic Lithium Photo Power 3V chính hãng vỉ 1 viên,22.0,7379038487453,105000,105000,0,0,0,may-anh
54478250,Camera Wifi thông minh EZVIZ C6N 1080P (CS-C6N-A0-1C2WFR) - TẶNG KÈM THẺ 32GB - HÀNG CHÍNH HÃNG,46.0,3447124360363,490000,490000,0,0,10,may-anh
49227944,Bộ Sạc PIN ENELOOP AA/AAA Kèm 4 Pin Sạc Made In Japan ( Kèm Hộp Đựng Pin Sạc ) - Hàng Chính Hãng,10.0,1354064883628,669000,669000,0,0,2,may-anh
28326998,Bộ Sạc Nhanh Panasonic  BQ CC55 (Smart Quick Charger ) Kèm 4 Pin Eneloop AA BK3MCCE 2000 mah Hàng Chính Hãng,6.0,2414342044772,785000,785000,0,0,0,may-anh
26062659,Camera IP Wifi Imou IPC-C22EP-Imou 2Mpx 1080P Full HD - Hàng Chính Hãng,69.0,1976151308649,440000,440000,0,0,9,may-anh
5849307,Chân Máy Ảnh Monopod Weifeng WT-1003 - Hàng Nhập Khẩu,39.0,7302667132746,271999,271999,0,0,5,may-anh
277601288,"Camera wifi Yoosee Ngoài Trời 20MPX 4 Mắt 3 Màn Hình Kép Q10-28 Phiên Bản Mới 2025,Đêm Có Màu, Đàm Thoại Hai Chiều, Chống Nước Nhựa IP66, Hàng Nhập Khẩu ",3.0,2035615839936,599000,650000,51000,8,1,may-anh
277381589,Camera WiFi quay quét EZVIZ H6C Pro 3K 5MP - hàng chính hãng,7.0,1251624696284,600000,600000,0,0,0,may-anh
277343396,"Camera Yoosee Ngoài Trời F50 3 MẮT MÁY BAY ĐỘC LẬP, Xoay 3 Mắt Cùng Lúc Đa Chiều, Đầy Đủ Tính Năng, Hàng Nhập Khẩu",6.0,5935130330241,549000,650000,101000,16,0,may-anh
276565906,"(Lỗi 1 đổi 1) Camera YOOSEE ngoài trời 4 mắt (3 mắt đều xoay được), 3 màn hình 24MPX siêu nét có Tiếng Việt- Hàng chính hãng",18.0,4271534113744,630000,630000,0,0,0,may-anh
276154375,"(Lỗi 1 đổi 1) Camera YOOSEE ngoài trời 4 mắt (xoay được 3 mắt), 3 màn hình độ phân giải 18MPX tích hợp 46 LED siêu nét - Hàng nhập khẩu",45.0,4971217623643,559000,559000,0,0,11,may-anh
276154338,(Lỗi 1 đổi 1) Camera YOOSEE WIFI ngoài trời 4 mắt 3 màn hình 12MPX tích hợp 46 LED - Hàng chính hãng,5.0,6739779951606,449000,449000,0,0,0,may-anh
274728425,Thẻ nhớ SD Sandisk Ultra GN3 32GB 100MB/s UHS-I (cho máy ảnh) - Hàng Chính Hãng,18.0,2030041995500,150000,255000,105000,41,3,may-anh
274724794,"Camera Năng Lượng Mặt Trời 4G Không Dây NetCAM STL4G, Chất lượng video HD 4MP, Dùng Sim 4G, Dung lượng pin 8000mAh - Hàng Chính Hãng",10.0,6712378114771,1079000,1079000,0,0,3,may-anh
274249648,Camera WiFi Ezviz H6C PRO 2K+4MP (2560 × 1440) [Chưa có thẻ nhớ] Đàm thoại 2 chiều Quan sát ngày đêm Xoay 360° - Hàng chính hãng Anh Ngọc phân phối,105.0,9589825679211,591000,900000,309000,34,13,may-anh
273951675,"Godox SL100D / SL100Bi - Đèn Led Hỗ Trợ Cho Quay Phim, Chụp Hình, Điều Khiển APP, Công Suất Tối Đa 100W - Hàng chính hãng",5.0,4018253264374,199000,199000,0,0,0,may-anh
273717272,"Camera Yoosee 2 Mắt Kép 4G Dùng Sim Full HD 1080P, Xem 2 Khung Hình Cùng Lúc, Xoay 350 Độ - Hàng Chính Hãng",8.0,5733506345793,649000,649000,0,0,2,may-anh
273708149,"Camera Wifi Ezviz C8C 3K 5MP-4MP mẫu mới, báo động đèn còi, phát hiện người và xe - Hàng chính hãng",4.0,2672274808961,877000,877000,0,0,0,may-anh
273452090,Camera hành trình SJCAM C100 Plus - Máy quay hành động nhỏ gọn bỏ túi phiên bản nâng cấp độ phân giải Zoom 2X - Hàng nhập khẩu,16.0,4907123358741,1249000,2000000,751000,38,6,may-anh
273083166,"(Lỗi 1 đổi 1) Camera Yoosee BÓNG ĐÈN 2 MẮT (1 CỐ ĐỊNH, 1 XOAY) thế hệ mới 5.0MP - xoay 360 độ, xem đêm có màu - Hàng nhập khẩu",30.0,3371326076976,350000,350000,0,0,4,may-anh
272967613,"Camera WiFi TP-Link Tapo C510W / C520WS An Ninh Quay/Quét 360 Độ, Chống Nước - Hàng Chính Hãng",2.0,4394998292697,760000,760000,0,0,1,may-anh
272267524,"Camera Wifi EZVIZ H3C 4MP 3K - H3C 3M, Có Màu Ban Đêm, Đèn Cảnh Báo - Hàng Chính Hãng",21.0,1875473088533,820000,820000,0,0,2,may-anh
271128394,"Hộp hút ẩm đọng nước ở đáy hộp dùng cho phòng ngủ, phòng ăn, tủ quần áo, tủ đồ, sách vở - hàng nhập khẩu",12.0,2146143246893,39000,39000,0,0,0,may-anh
270977170,"Camera Yoosee Wifi 2 Mắt Ngoài Trời 2 Màn Hình 5MP Xem Đêm Có Màu, Hỗ Trợ Đàm Thoại 2 Chiều Xoay 360 Độ - Hàng Nhập Khẩu",102.0,8224378990733,380000,380000,0,0,22,may-anh
270546039,"Tripod/ Chân bạch tuộc Yunteng 3286, phụ kiện cố định điện thoại, máy ảnh để quay chụp - Hàng chính hãng",13.0,4944243754313,179000,300000,121000,40,0,may-anh
270545009,Camera Yoosee WiFi 2 Mắt Ngoài Trời QPT36 Xem 2 Màn Hình Cùng Lúc 5.0Mpx Giám Sát Ngoài Trời Chống Nước IP66 - Hàng Chính Hãng,68.0,8485583959194,580000,580000,0,0,4,may-anh
263972675,Camera Yoosee WiFi 2 Mắt Siêu Nét - Xem 2 Màn Hình Cùng Lúc - Hàng Chính Hãng,80.0,2353048935295,449000,449000,0,0,16,may-anh
263347839,"Camera Wifi Ngoài Trời EZVIZ H8 Pro 2K 3K Siêu Nét, Màu Ban Đêm - Hàng chính hãng",6.0,7640740072349,1150000,1150000,0,0,0,may-anh
262792654,Camera Wifi Yoosee 2 Mắt Xem 2 Màn Hình Cùng Lúc Ngoài Trời - Hàng Nhập Khẩu,673.0,2711995466078,380000,380000,0,0,126,may-anh
261814053,Thẻ nhớ SDXC SanDisk Ultra 140MB/s 128GB - Hàng Nhập Khẩu,21.0,5952901349505,310000,310000,0,0,3,may-anh
261800393,"Tripod, chân đế điện thoại, máy ảnh 3 chân TTX-6218 kiêm giá đỡ có remote bluetooth điều khiển từ xa - Hàng chính hãng",62.0,6237593590136,285000,285000,0,0,3,may-anh
253183398,"Camera wifi imou Cue 2 - Cue 2E Full HD 1080P, ĐÀM THOẠI 2 CHIỀU - Hàng Chính Hãng",10.0,1916903087773,377000,377000,0,0,0,may-anh
205985292,Camera IP WiFi Ngoài Trời EZVIZ H8 3K 5MP - Hàng Chính Hãng,92.0,9704792417067,1670000,2691000,1021000,38,22,may-anh
205224085,"Camera Yoosee bóng đèn thế hệ mới 3.0MP - xoay 360 độ, xem đêm có màu, mẫu mới 2022 - Hàng Nhập Khẩu",44.0,3468816357272,190000,190000,0,0,11,may-anh
203991816,"CAMERA WIFI IMOU NGOÀI TRỜI F22FEP 1080P, CÓ MÀU BAN ĐÊM, ĐÀM THOẠI CHIỀU - HÀNG CHÍNH HÃNG",7.0,4601407130819,817000,817000,0,0,0,may-anh
193717163,Thẻ nhớ SDXC SanDisk Extreme Pro SDSDXXU-064G U3 V30 64GB 200MB/s New 2022 - Hàng Nhập Khẩu,1108.0,9897994923144,290000,290000,0,0,121,may-anh
187053003,Thẻ nhớ SDXC Sandisk Ultra 64GB upto 100MB/s UHS-I (cho máy ảnh) - Hàng chính hãng,10.0,5574726063688,197000,220000,23000,10,1,may-anh
157849488,Camera IP Ốp trần mini X8700 xoay 360 độ siêu nét 2.0Mp chuẩn FullHD tích hợp đèn LED có màu ban đêm - Hàng nhập khẩu,41.0,1094048075730,190000,190000,0,0,10,may-anh
145180531,"Camera IMOU Bullet 2/2C/2E 2MP ( IPC-F22P), Camera Ngoài Trời, Chống nước IP67, Chuẩn nén H265, Theo dõi chuyển động, Quay Màu ban đêm - Hãng Chính Hãng",209.0,8781342770372,550000,550000,0,0,37,may-anh
140901324,"Tay cầm chống rung Gimbal 3 Axis Handheld - Gậy gimbal đa năng cho điện thoại adroid, IOS - 3 trục xoay, kết nối bluetooth, zoom xa gần ngay trên gậy - Tích hợp cổng USB sạc pin cho điện thoại - Hàng nhập khẩu",9.0,5179399872174,1290000,1290000,0,0,1,may-anh
114789403,"Tripod - Chân đế điện thoại, chân đế máy ảnh Yunteng VCT 5208 kiêm giá đỡ có remote Bluetooth điều khiển chụp từ xa",193.0,8608089515472,339000,399000,60000,15,30,may-anh
103996506,"CAMERA EZVIZ IP WIFI C6N 2.0 MPX ,KÈM THẺ NHỚ 64G HÀNG CHÍNH HÃNG.",10.0,2892500263887,520000,520000,0,0,1,may-anh
96804322,Camera IP Wifi Tenda CP3 Full HD 1080P 360° - Hàng Chính Hãng,54.0,4727032305991,378900,378900,0,0,12,may-anh
58002233,"Tripod Ulanzi MT-08 cho máy ảnh, điện thoại hàng chính hãng.",87.0,1136492844484,241500,241500,0,0,16,may-anh
56451960,Pin D Carbon Panasonic R20UT/2S chính hãng,341.0,4605082191866,39000,39000,0,0,37,may-anh
847472,Tấm Hắt Sáng 2 Trong 1 Cho Studio Reflector Disc 110 - Hàng nhập khẩu,11.0,2137861378967,198000,198000,0,0,2,may-anh
276986482,Camera Hành Trình Xe Ô Tô WDR X600 FULL HD 1080P - Hàng Nhập Khẩu,2.0,8339566190915,489000,489000,0,0,1,may-anh
276545435,"Camera Imou Cruiser Dual 10MP - Camera 2 mắt kép, Phát hiện xe cộ, Có loa và đèn báo động, Đàm thoại 2 chiều - Hàng chính hãng",34.0,7418172361885,1590000,1590000,0,0,11,may-anh
275774617,Camera Wifi IMOU Ranger Dual 6MP IPC-S2XP-6M0WED 2 Mắt-hàng chính hãng,3.0,2154358658314,990000,990000,0,0,0,may-anh
275255835,"Camera WiFi Ngoài trời TP-Link Tapo C510W - Độ phân giải 2K 3MP, Đầy đủ màu ban đêm, Quay quét 360, Đàm thoại 2 chiều - HÀNG CHÍNH HÃNG",13.0,9352920302241,790000,1050000,260000,25,2,may-anh
275255482,"Camera wifi trong nhà TP-Link Tapo C220 - Độ phân giải 4K 2MP, Đàm thoại 2 chiều, Quay quét 360 độ - HÀNG CHÍNH HÃNG",13.0,7084871548945,518000,1290000,772000,60,2,may-anh
275222580,"Camera Imou Cruiser Z 3K 5MP - Thu phóng 12x, Chống chịu thời tiết IP66, Phát hiện xe cộ, Đàm thoại 2 chiều - HÀNG CHÍNH HÃNG",4.0,3944599291888,2790000,2790000,0,0,1,may-anh
274847176,"Camera Ngoài Trời NetCAM STD33, Quay Quét 360 độ, có Ống Kính Kép với Độ phân giải Siêu Nét 6MP - Hàng Chính Hãng",3.0,7946954548526,759000,759000,0,0,0,may-anh
274215232,"Camera WiFi EZVIZ  2 Mắt  Trong Nhà/ Ngoài Trời H7C/H9C  phát hiện con người, phát hiện hình dạng xe, phát hiện chuyển động - Hàng chính hãng",2.0,9857990857685,950000,950000,0,0,2,may-anh
274179036,"Camera IP WiFi Yoosee R3 Có 3 Mắt Ngoài Trời Xem 3 Màn Hình Cùng Lúc, Độ Phân Giải 8.0Mpx - Hàng Chính Hãng",9.0,5545362339754,669000,669000,0,0,1,may-anh
273932705,"(MẪU MỚI) CAMERA YOOSEE BÓNG ĐÈN 2 MẮT QS211 FHD XEM 2 KHUNG HÌNH, HÌNH ẢNH SẮC NÉT, QUAY ĐÊM CÓ MÀU - HÀNG CHÍNH HÃNG",29.0,6214589958474,399000,399000,0,0,2,may-anh
273644429,"Camera Wifi IMOU 2 Mắt Ngoài Trời S7XP Cruiser Dual 6MP/10MP, quay 360 độ, đàm thoại 2 chiều - Hàng chính hãng",26.0,2839925753240,1197000,1197000,0,0,9,may-anh
273474193,"Camera IP Wifi VITACAM C600C - Độ phân giải 2M đàm thoại 2 chiều, Có màu đêm - Hàng chính hãng",3.0,4885024235216,350000,350000,0,0,0,may-anh
273026293,Camera Hành Trình Ô Tô 3 Mắt S10 Plus Có WiFi Full HD 1080p Hỗ Trợ Kết Nối Điện Thoại Xem Qua App - Hàng Chính Hãng,4.0,7051525726083,790000,790000,0,0,0,may-anh
271705499,Camera Wifi TP-Link Tapo C212 Độ Phân Giải 2K QHD Quay/Quét 360 Độ Hỗ Trợ Cổng LAN - Hàng Chính Hãng,44.0,1256807832790,465000,465000,0,0,5,may-anh
263752818,Máy ảnh chụp lấy liền Fujifilm Instax Mini 12 - Hàng chính hãng,45.0,1125717647531,3120000,3120000,0,0,7,may-anh
263113508,"Camera Wifi Ezviz Ngoài Trời AI thông minh, màu ban đêm, H3C 4MP 2K - Hàng chính hãng",1.0,4272988614377,904000,904000,0,0,0,may-anh
261995940,Camera IMOU Wifi A22EP 1080P(2M) xoay 360 độ đàm thoại 2 chiều trong nhà - Hàng chính hãng,7.0,6216941264685,389000,389000,0,0,2,may-anh
213710314,Camera WiFi TP-Link Tapo C500 An Ninh Quay/Quét Ngoài Trời - Hàng Chính Hãng,12.0,4601853883540,809000,809000,0,0,3,may-anh
213587156,Film Instax Mini FUJIFILM - Viền màu - Giấy in ảnh cho máy chụp ảnh lấy liền Instax Mini - Hàng Chính Hãng,32.0,7394543961636,350000,350000,0,0,0,may-anh
212935753,"Camera Wifi Ezviz H8C 1080P Quay 360 độ, đàm thoại 2 chiều, nhận diện AI - Hàng chính hãng",39.0,8201836797731,830000,830000,0,0,7,may-anh
200004710,Camera Yoosee Bóng Đèn Thế Hệ Mới 8 Led 5.0Mp Góc Rộng Siêu Nét Full Hd Hồng Ngoại Quay Đêm Hàng Chính Hãng,78.0,5357987822121,229000,229000,0,0,12,may-anh
197554833,"Weifeng WT-3111, WT-3130, WT-3520, WT-3730, WT-3560 - Chân Đế Chuyên Nghiệp Cho Điện Thoại Và Máy Ảnh Chất Lượng Cao- Hàng chính hãng",3.0,1254798055841,125000,125000,0,0,0,may-anh
194121937,Camera IP Wifi Ngoài Trời EZVIZ C3TN 3MP 2K Color Night Vision Tích Hợp Ai - Có Màu Ban Đêm - Đàm Thoại 2 Chiều - Hàng Chính Hãng,25.0,7718353076887,808000,808000,0,0,6,may-anh
174896487,Camera WiFi Ngoài Trời TP-Link Tapo C320WS Độ Phân Giải 2K QHD - Hàng Chính Hãng,14.0,2208103904759,795000,795000,0,0,2,may-anh
170490830,Camera IP Wifi Trong Nhà EZVIZ TY1 1080p - Hàng chính hãng,5.0,3018473667541,410000,410000,0,0,0,may-anh
163792408,Camera IP Wifi quay quét ngoài trời 4MP EZVIZ C8W hàng chính hãng,14.0,4360065412107,1290000,1290000,0,0,2,may-anh
162531138,Camera Wifi EZVIZ C8W 4MP (2K+) - Hàng chính hãng,7.0,5117192986738,1350000,1350000,0,0,1,may-anh
160621655,"Gimbal chống rung CYKE Q09 tích hợp chế độ xoay quay 360º, có bluetooth chụp selfie, tripod chụp hình siêu tiện lợi, hàng chính hãng",210.0,7285983988609,720000,720000,0,0,47,may-anh
159501797,"Pin sạc Kingma Ver 2 cho Fujifilm NP-W235, Hàng chính hãng",16.0,3851418364890,449999,449999,0,0,5,may-anh
153998709,Thẻ nhớ IMOU chuyên dụng cho Camera 95 MB/s Class 10 32GB/64GB - Hàng Chính Hãng,850.0,8001115215830,105000,190000,85000,45,124,may-anh
133876927,Camera Imou Range 2C - New 2021 - Chip Hình Ảnh Thế Hệ Mới - Wifi Cực Mạnh Siêu Khỏe - Hàng Chính Hãng,31.0,3525301515847,510000,510000,0,0,4,may-anh
110367842,Camera IP WIFI IMOU 4.0 MPX XOAY 355 ĐỘ TRONG NHÀ - Hàng Chính Hãng,65.0,3346375593779,575000,575000,0,0,9,may-anh
100050235,"Filter Kính lọc Hoya UV UX, Hàng Chính hãng",10.0,7338839979007,249999,249999,0,0,3,may-anh
52355000,"Mount gắn phụ kiện đa năng PT-3 Ulanzi cho máy ảnh, máy quay hàng chính hãng",22.0,4420017510815,149999,149999,0,0,7,may-anh
49557174,Bộ Sạc Nhanh Panasonic BQ CC55 Kèm 8 Pin Eneloop ( 4 Pin AA 2000 mAH + 4 Pin AAA 800 mAh ) Made In Japan - Hàng Chính Hãng,8.0,8748865695932,1210000,1210000,0,0,1,may-anh
41819516,Bộ Sản Phẩm Camera IP Dahua Imou A22EP 2.0mp và Thẻ Nhớ Sandisk 32Gb - Hàng Chính Hãng,8.0,3503280168677,560000,560000,0,0,0,may-anh
25764693,Camera IP Wifi Ngoài trời Yoosee GW-216S 2 Râu FullHD 1080P 6 LED trợ sáng đàm thoại 2 chiều (Trắng) Hàng Nhập Khẩu,8.0,1568436011193,499789,499789,0,0,0,may-anh
23839834, Kính hiển vi  bỏ túi đa năng MICROBRITE PLUS MM-300 (Phóng đại 60-120x) - Hàng chính hãng,88.0,6139140140728,544000,544000,0,0,18,may-anh
15396824,Đèn Flash Godox TT600 for Canon - Hàng chính hãng,8.0,6952147921578,1499999,1499999,0,0,3,may-anh
2343087,Bộ pin sạc PanaSonic Eneloop 2550 Mah (Made in Japan) - Hàng chính hãng,9.0,4038240240869,440000,440000,0,0,0,may-anh
276932880,Kính Hiển Vi Kỹ Thuật Số 500X - Hàng Nhập Khẩu,2.0,4641795095424,265000,265000,0,0,1,may-anh
276797769,"[HÀNG CHÍNH HÃNG-PHIÊN BẢN QUỐC TẾ] Camera hành trình gương 70mai S500 3K HDR, ghi hình 2 mắt trước sau siêu nét, giám sát đỗ xe 24h.",1.0,9527249023802,360000,360000,0,0,0,may-anh
276630827,Camera ngoài trời Xiaomi Outdoor Camera CW300 - GiaPhucStore | Hàng Chính Hãng,3.0,9655236226036,1150000,1150000,0,0,1,may-anh
276566384,"Camera Yoosee IP 2 Mắt Trong Nhà Xem 2 Màn Hình Cùng Lúc Độ Phân Giải 2K, Xoay 360 Độ, Xem Đêm Có Màu, Hỗ Trợ Đàm Thoại 2 Chiều Hàng Chính Hãng",6.0,2677008259909,345000,345000,0,0,2,may-anh
276154364,(Lỗi 1 đổi 1) Camera YOOSEE ngoài trời 4 mắt 3 màn hình 12MPX tích hợp 39 LED zoom 12x - Hàng chính hãng,3.0,8475835565008,499000,499000,0,0,0,may-anh
275959921,"Chân Đế Camera, Giá Đỡ Camera Dán Tường Trong Suốt - Hàng Chính Hãng",42.0,4399447340777,25000,25000,0,0,3,may-anh
275938579,"Camera trong nhà TP-Link Tapo TC60 - Full HD, Đàm thoại 2 chiều, Phát hiện chuyển động - HÀNG CHÍNH HÃNG",6.0,4833095964387,399000,590000,191000,32,0,may-anh
275856061,"Bộ dây đeo ngực 5 chi tiết cho máy quay hành động, smartphone 077, hàng chính hãng",7.0,3950373755540,139000,149000,10000,7,1,may-anh
275339503,"(Lỗi 1 đổi 1) Camera yoosee 4 mắt 3 khung hình độc lập ZOOM 12X độ phân giải 12mpx siêu nét, giám sát ngoài trời chống nước, xem ban đêm có màu - Hàng nhập khẩu",12.0,2585841208269,549000,549000,0,0,0,may-anh
275315682,Kính hiển vi bỏ túi cao cấp MicroFlip MP-250 (Phóng đại 100x -250x) có đèn tia cực tím UV. MicroFlip 100x-250x LED UV Pocket Microscope with Smartphone Clip - Hàng chính hãng,1.0,6202025003079,899000,899000,0,0,0,may-anh
275062186,"Camera Wifi Ezviz C6C 8M - 4K Siêu Rõ Nét, Quay Quét 360 độ , Đàm thoại 2 chiều, Có màu ban đêm, Phát hiện người AI - hàng chính hãng",6.0,5862448193622,1230000,1230000,0,0,2,may-anh
274567496,"Camera IP Trong nhà Tapo C212 - Quay quét 360, Độ phân giải 2K 3MP, Đàm thoại 2 chiều, Có hồng ngoại ban đêm - HÀNG CHÍNH HÃNG",11.0,3673306830040,475000,690000,215000,31,2,may-anh
274545673,Camera Wi-Fi TP-Link Tapo TC60 Độ Phân Giải FullHD 1080P - Hỗ Trợ Hệ Thống Báo Động - Tích Hợp Micro Đàm Thoại - Hàng Chính Hãng,6.0,4345862539341,365000,365000,0,0,0,may-anh
273474185,Camera Wifi Yoosee PTZ 2 Mắt Xoay 360 Độ - Đàm Thoại 2 Chiều - Báo Động Chống Trộm - Ban Đêm Có Màu - hàng nhập khẩu,116.0,3872136722180,400000,400000,0,0,30,may-anh
272397121,"Thẻ nhớ Micro SD Kioxia EXCERIA G2 UHS-I C10 U3 V30, Ghi hình 4K chuẩn A1, tốc độ đọc 100mb/s - Hàng chính hãng",13.0,1786554124677,299000,299000,0,0,1,may-anh
272374093,"Camera WIFI Bóng Đèn IMOU S6DP 3MP/5MP Xoay 360, Đàm Thoại - Hàng chính hãng",1.0,1332181467589,890000,890000,0,0,0,may-anh
272366633,Camera Wifi TP-Link Tapo C211 Độ Phân Giải 2K UHD Quay Quét 360 Độ - Hàng Chính Hãng,7.0,8085779879361,456000,1128000,672000,60,2,may-anh
270977118,"Camera Wifi Yoosee trong nhà 2 Mắt Xem 2 Màn Hình Cùng Lúc Xoay 360 Độ, Đêm Có Màu, Đàm Thoại 2 Chiều - hàng nhập khẩu",8.0,3182197087941,310000,310000,0,0,1,may-anh
270906792,Camera Wifi TP-Link Tapo C220 Độ Phân Giải 2K QHD Quay/Quét 360 Độ Giám Sát An Ninh - Hàng Chính Hãng,4.0,6929543931844,479000,479000,0,0,1,may-anh
253183156,"Camera Wifi imou A42P 4MP 2K, Ranger 2 A22 Xoay 360 độ - Imou C22 đàm thoại 2 chiều - hàng chính hãng",33.0,9310676519838,377000,377000,0,0,6,may-anh
242644479,"Camera WIFI ngoài trời IMOU S21FP, S41FP có màu ban đêm, xoay 360 độ - Hàng chính hãng",15.0,8557239568949,760000,760000,0,0,4,may-anh
212117226,Camera IP WiFi quay quét ngoài trời EZVIZ H8c bản 2MP hàng chính hãng,2.0,2519674913369,900000,900000,0,0,0,may-anh
203897822,CAMERA WIFI IMOU TRONG NHÀ C22EP 1080P ĐÀM THOẠI 2 CHIỀU - HÀNG CHÍNH HÃNG,20.0,4572085071240,377000,377000,0,0,3,may-anh
201796596,Bộ Pin LP-E17 1040mAh + Sạc Beston Dùng Cho Máy Ảnh Canon EOS M3 EOS M5 EOS M5 EOS 750D EOS 760D EOS 800D EOS 77D EOS RP - Hàng nhập khẩu,30.0,4844975208298,155000,155000,0,0,2,may-anh
198197469,"Thẻ Nhớ Micro SD HIKVISION 32GB / 64GB, Tốc Độ Đọc 92Mb/s, Dùng Cho Tất Cả Các Thiết Bị Hỗ Trợ Thẻ Nhớ Gắn Ngoài - Hàng chính hãng",12.0,1138570908593,80000,80000,0,0,1,may-anh
194122868,Camera IP Wifi Ngoài Trời EZVIZ C3TN 2MP Full HD 1080P Tích Hợp Mic Thu Âm - Chống Ngược Sáng - Hàng Chính Hãng,17.0,2283238197924,578000,578000,0,0,1,may-anh
188698192,Đèn flash Godox V860III cho SONY - Hàng chính hãng,1.0,4821980271956,3549999,3549999,0,0,0,may-anh
186709933,"Camera IP Wifi DAHUA DH-IPC-HFW1230DT-STW 2M 1080P, Đàm thoại 2 chiều, hỗ trợ thẻ nhớ 128Gb - hàng chính hãng",5.0,8331615906168,615000,615000,0,0,2,may-anh
159515133,"Pin sạc Kingma Ver 3 cho Fujifilm NP-W235 (Sạc Type C siêu nhanh), Hàng chính hãng",9.0,1893211431630,299999,299999,0,0,3,may-anh
118103897,Camera hành trình ô tô 70MAI Pro Plus A500S tích hợp sẵn GPS - Hàng Chính Hãng,4.0,6389906448605,1884000,1884000,0,0,0,may-anh
116882227,CAMERA WiFi Yoosee 360 Siêu Nét 3.0Mpx Cao Cấp FullHD 1920 x 1080 Sắc Nét Hỗ Trợ Wifi IP Từ Xa Hàng Nhập Khẩu,76.0,9773149994733,460000,460000,0,0,14,may-anh
108991652,"Pin Kingma cho Sony BP-U60, Hàng chính hãng",6.0,8133875805793,1499999,1499999,0,0,0,may-anh
68446044,BỘ VỆ SINH VSGO DKL-6-Hàng Nhập Khẩu,13.0,3518156747092,319999,319999,0,0,4,may-anh
51296638,Túi đeo máy ảnh Peak Design Everyday Sling v2 10L - màu ASH - Hàng nhập khẩu,5.0,8176287701595,4249999,4249999,0,0,2,may-anh
49882606,Ống nhòm hai mắt nhỏ gọn thích hợp cho du lịch ngắm cảnh National Geographic 8x21 - sản phẩm nhập khẩu đến từ thương hiệu Bresser,11.0,1716980800804,770000,770000,0,0,3,may-anh
25309442,2 Pin + 1 Đốc sạc đôi Sony NP-FW50 - Chính hãng KingMa,18.0,3926076851834,147999,147999,0,0,3,may-anh
12362456,Pin Panasonic CR  2025 - Hàng chính hãng,168.0,3087420322377,15000,15000,0,0,11,may-anh
11245618,Bộ 2 pin sạc và Đốc sạc đôi KingMa NP-FW50 cho Sony A6000 A6300 A6500 - Hàng Chính Hãng,61.0,7482331200039,514999,514999,0,0,16,may-anh
4707433,Đèn LED Yongnuo 600 Air Bicolor - Hàng Nhập Khẩu,3.0,3025115513099,1524999,1524999,0,0,0,may-anh
4688897,Chân Máy Ảnh Tripod Weifeng 3520 - Hàng Nhập Khẩu,133.0,2487130691915,279999,279999,0,0,42,may-anh
277356246,Camera Nội Soi Công Nghiệp Chống Nước Kết Nối Điện Thoại AN112 - Hàng Nhập Khẩu,1.0,1731321703150,315000,315000,0,0,0,may-anh
277253292,Chân Đế Gimbal Bạch Tuộc Cho Điện Thoại Và Máy Ảnh YT-138A - Hàng Nhập Khẩu,1.0,6257141061045,215000,215000,0,0,0,may-anh
276005819,"Ulanzi MT-44 - Tripod Mini Cho Máy Ảnh, Điện Thoại, Tải Trọng 1.5 Kg, Chiều Cao Tối Đa 109cm - Hàng chính hãng",2.0,5786754567899,363000,363000,0,0,0,may-anh
274573444,"Camera Wifi iMOU trong nhà 2 mắt Ranger Dual 10MP IPC-S2XP-10M0WED, 6MP IPC-S2XP-6M0WED-Hàng chính hãng",7.0,3683982390401,848000,848000,0,0,2,may-anh
274568782,"Camera IP dùng trong nhà Tapo C211 - Quay quét 360, Độ phân giải 2K 3MP, Đàm thoại 2 chiều, Hỗ trợ hồng ngoại ban đêm - HÀNG CHÍNH HÃNG",9.0,1198764330163,790000,790000,0,0,1,may-anh
273083320,"(Lỗi 1 đổi 1) Camera Yoosee 3 râu 5.0 11LED quay quét 360 độ, điều khiển xoay trên điện thoại, full phụ kiện - Hàng chính hãng",1.0,6503657548493,249000,249000,0,0,0,may-anh
272468700,Ống nhòm hai mắt Carson MK-042 (10x42mm) - Hàng chính hãng,1.0,4686734776436,2750000,2750000,0,0,0,may-anh
272419480,Camera Xiaomi Outdoor Ngoài Trời AW300 2K - GiaPhucStore | Hàng Chính Hãng,8.0,7468232338560,990000,990000,0,0,0,may-anh
272178556,"Camera wifi AI thông minh Ezviz H6 5MP 3K siêu nét, xoay 360 Độ, Đàm thoại 2 chiều - hàng chính hãng",4.0,4286803345478,820000,820000,0,0,1,may-anh
271075099,Camera Ngoài Trời Tenda CT3 2MB có màu ban đêm- hàng chính hãng bảo hành 2 năm,2.0,8167626211452,650000,650000,0,0,0,may-anh
263352017,"Camera Wifi IMOU VERSA C22FP 2MP Đế Nam Châm, Đàm Thoại 2 Chiều - Hàng chính hãng",4.0,6191133586768,793000,793000,0,0,2,may-anh
261811289,Camera WiFi Tp-link Tapo C200 An Ninh Gia Đình  - Hàng Chính Hãng,12.0,5796051753039,375000,375000,0,0,3,may-anh
253390992,"Pin sạc RCR123A 16340 BESTON Dung lượng cao 650mAh dùng cho máy ảnh, camera, thiết bị đo, đèn pin, ống nhòm - Hàng chính hãng",11.0,9575487514169,85000,85000,0,0,0,may-anh
253390985,"Pin sạc CR2 BESTON 300mAh dùng cho máy ảnh, camera, thiết bị đo, đèn pin, ống nhòm - Hàng chính hãng",24.0,1552387299178,80000,80000,0,0,2,may-anh
247975395,"Camera ip Wifi Yoosee Ngoài Trời 26 Led Chuẩn 1080P, Mẫu mới 2021- Hàng Nhập Khẩu",9.0,2967360471045,275000,275000,0,0,2,may-anh
242618602,Camera wifi Ezviz C6N không dây xoay 360 độ đàm thoại 2 chiều - Hàng chính hãng,16.0,5326890970610,390000,390000,0,0,1,may-anh
204038146,"CAMERA WIFI IMOU CRUISER SE S21FP 1080P XOAY 360 ĐỘ, CÓ MÀU BAN ĐÊM - HÀNG CHÍNH HÃNG",0.0,1312855160248,751000,751000,0,0,0,may-anh
200844138,Bộ Pin NP-W126 1260mAh + Sạc Beston Dùng Cho Máy Ảnh Fujifilm X-T20 X-T10 X-T100 X100F X-H1 X-T3 X-T2 X-T1 X-A5 X-A3 - Hàng nhập khẩu,7.0,1091439377968,165000,165000,0,0,0,may-anh
198254218,Camera Wifi Imou Ranger 2C (2MP)/ Ranger SE (2MP) I Phát hiện con người I Đàm thoại hai chiều I Xoay 360 I Hàng chính hãng,130.0,1388397773550,1050000,1050000,0,0,31,may-anh
173570812,Camera WiFi Thông Minh TP-Link Tapo C100 An Ninh Cho Gia Đình - Hàng Chính Hãng,11.0,1966186824564,355000,355000,0,0,1,may-anh
166010735,"Gậy 3 Chân Máy Ảnh Chụp Hình Selfie Tự Sướng Tripod Floveme - 3366 cao 150cm Kèm Giá Đở Điện Thoại - 3. cách xoay, 360 độ -  Hàng chính hãng",1.0,4905283103689,193900,193900,0,0,0,may-anh
159444424,"Pin sạc Kingma Ver 2 cho Sony NP-FW50, Hàng chính hãng",4.0,2027553996151,219999,219999,0,0,1,may-anh
159049975,"Pin ảo/ giả pin/ Pin Dummy Kingma for Sony NP-FZ100, Hàng nhập khẩu",15.0,1461679881918,349999,349999,0,0,1,may-anh
142217257,Camera IP Imou C22SP 1080p - Hàng Chính Hãng,147.0,1831174224982,505000,505000,0,0,12,may-anh
120444794,Gậy Chống Rung Gimbal Stabilizer L08 - Có 3 Chân Đỡ - Nút Bấm Bluetooh Hàng Cao Cấp - Hàng Nhập Khẩu,6.0,1332902751641,489999,650000,160001,25,0,may-anh
116970061,Camera IP Dome hồng ngoại 2.0 Megapixel HIKVISION DS-2CD1323G0E-I(L) - HÀNG CHÍNH HÃNG,2.0,8164260005249,790000,790000,0,0,1,may-anh
110691369,Camera wifi ngoài trời DAHUA IMOU Bullet 2 2MP IPC-F22FEP MÀU 24/7 Hàng chính hãng,1.0,5202831606377,890000,890000,0,0,0,may-anh
108586916,Cáp đồng trục kèm dây nguồn RG59+2C Superlink cuộn 305m- Hàng chính hãng,2.0,7105761552825,1650000,1650000,0,0,1,may-anh
108079641,"Combo Pin sạc Kingma for Nikon EN-EL15, Hàng chính hãng",2.0,4954822362178,169999,169999,0,0,0,may-anh
107182831,"Camera IP WIFI IMOU RANGER 2 IPC - A22EP Full HD 1080P ,KÈM THẺ NHỚ 64G - Hàng Chính Hãng",46.0,6997180295165,519900,519900,0,0,10,may-anh
95064446,Camera EZVIZ C1C-B 1080P – Camera IP Wifi trong nhà thông minh Chính hãng Nhà An Toàn,13.0,3652901354045,410000,410000,0,0,4,may-anh
91056288,"Thẻ nhớ SanDisk Ultra SDHC, SDUNR 32GB, C10, UHS-I, 100MB/s_SDSDUNR-032G-GN3IN - Hàng Chính Hãng",18.0,9095927967578,141000,159000,18000,11,1,may-anh
88482985,Camera Wifi - Camera Ip Trong Nhà EZVIZ C6N 1080P - Đàm Thoại 2 Chiều - Xoay 360 Độ Theo Chuyển Động - Hàng nhập khẩu,37.0,3130310382407,390000,390000,0,0,3,may-anh
86797095,Bộ Ghi Hình Camera Từ Máy Nội Soi EZcap 285 - Hàng chính hãng,1.0,3203875188408,2450000,2450000,0,0,0,may-anh
62323951,Softbox Godox P90L 16 cạnh 90cm hàng chính hãng.,4.0,1224745124886,1450000,1450000,0,0,0,may-anh
12318323,Pin Kingma LP-E17 - Hàng Chính Hãng,20.0,6962411019634,294999,294999,0,0,3,may-anh
10806848,Sạc pin đôi nhanh KingMa cho Sony NP-FW50 A6000 A6300 A6500 - Hàng chính hãng,21.0,5220487350756,155999,155999,0,0,1,may-anh
5876305,Kính lọc Filter Hoya HMC UV 82mm - Hàng nhập khẩu,5.0,1176104987567,699999,699999,0,0,0,may-anh
4713289,Pin Máy Ảnh Nikon EN-EL3e - Hàng Nhập Khẩu,192.0,6187744153798,205999,205999,0,0,42,may-anh
613908,Kính Lọc Filter Hoya HMC Ultra UV Haze 77mm - Hàng Chính Hãng,7.0,3110963639517,499999,499999,0,0,1,may-anh
276797703,"[HÀNG CHÍNH HÃNG-PHIÊN BẢN QUỐC TẾ] Camera hành trình 70mai A510 4G, 3K HDR Ghi hình đồng thời 2 mắt trước sau sắc nét.",0.0,2661614003621,360000,360000,0,0,0,may-anh
275910965,"Camera trong nhà TP-Link Tapo C202 - Full HD 1080p, Quay quét 360, Đàm thoại 2 chiều - Hàng chính hãng",1.0,3926254667653,590000,590000,0,0,0,may-anh
275748757,Camera WiFi Yoosee Q54D 4 Mắt xem được 3 khung hình cùng lúc 8.0Mpx Giám sát ngoài trời Chống nước - Hàng chính hãng,7.0,3541853535199,650000,650000,0,0,1,may-anh
275588953,"Camera Ngoài trời TP-Link Tapo TC40 - Quay quét 360, Đàm thoại 2 chiều, Phát hiện người và theo dõi chuyển động - HÀNG CHÍNH HÃNG",8.0,7549519795379,651000,990000,339000,34,2,may-anh
275579046,"Camera Ngoài Trời IMOU Cruiser SE S31FEP 3mpx 2K / S51FEP 5mpx 3K Siêu Nét, Đàm Thoại 2 Chiều, Chống Nước IP66, Đèn Màu Ban Đêm - Hàng Chính Hãng",0.0,3128256352378,780000,780000,0,0,0,may-anh
273234333,"(Lỗi 1 đổi 1) Camera IP Wifi YooSee 3 Mắt PTZ  6.0MPx, Siêu Nét, Đàm Thoại 2 Chiều, Zoom 8X, Ban Đêm Màu - Hàng nhập khẩu",15.0,9627050506504,590000,590000,0,0,0,may-anh
272428093,"Camera Wifi Yoosee Hai Mắt Xem 2 Màn Hình Cùng Lúc Xoay 360°, Đàm Thoại Hai Chiều, Báo Động Chống Trộm, Chuyên Dụng Ngoài Trời - Hàng Chính Hãng",35.0,5099429557993,419000,419000,0,0,5,may-anh
271517962,"Camera Wi-fi Trong Nhà EZVIZ H1C FHD 1080P, Góc Rộng Cố Định, Đàm Thoại Hai Chiều - Hàng Chính Hãng",4.0,9684838669981,370000,370000,0,0,2,may-anh
271381019,"Ulanzi MT-44 - Tripod Mini Cho Máy Ảnh, Điện Thoại, Tải Trọng 1.5 Kg, Chiều Cao Tối Đa 109cm- Hàng chính hãng",66.0,3315291303442,363000,363000,0,0,9,may-anh
271234773,"[[MẪU NÂNG CẤP] Camera Wi-fi EZVIZ H1C/C1HC Trong Nhà, FHD 1080P, Góc Rộng Cố Định, Đàm Thoại Hai Chiều, Nén Video H265 - Hàng Chính Hãng",0.0,4819036105011,369000,369000,0,0,0,may-anh
270976543,Đầu kẹp điện thoại Yunteng VCT-358 gắn tripod ren 1/4 và xoay 360 độ - Hàng chính hãng,20.0,9916892667351,80000,160000,80000,50,0,may-anh
247419129,Camera IMOU wifi A22EP 1080P 2M xoay 360 độ đàm thoại 2 chiều - Hàng chính hãng,45.0,4113094511527,425000,425000,0,0,10,may-anh
230087118,"200 gram túi hút ẩm loại vừa 5/10/20/50 gr dùng để bảo quản tủ quần áo, tủ giày, gia dụng, thiết bị điện tử, bảo quản thực phẩm nhãn hiệu MAX DESI hàng chính hãng",19.0,3714663108768,30450,30450,0,0,1,may-anh
212934832,"Camera Wifi Ngoài Trời EZVIZ C3TN 3M 2K Color Night Vision, Có màu ban đêm, đàm thoại 2 chiều - Hàng chính hãng",3.0,8366135811434,808000,808000,0,0,2,may-anh
210298065,Camera WiFi AI TP-Link Tapo C225 An Ninh Gia Đình Quay/Quét - Hàng Chính Hãng,2.0,3226486676275,885000,885000,0,0,1,may-anh
205893133,Camera IP Wifi IMOU IPC C22EP FullHD 1080P - Hàng Chính Hãng,3.0,3911206351171,526000,526000,0,0,1,may-anh
204626931,Camera IP Wifi Ngoài Trời Imou F22P Bullet 2C Full HD 1080P Tặng Phíc Cắm Âm - Hàng Chính Hãng,16.0,9301250524523,535000,535000,0,0,1,may-anh
203991603,"CAMERA WIFI IMOU NGOÀI TRỜI F22P 2M, TÍCH HỢP MIC THU ÂM - HÀNG CHÍNH HÃNG",23.0,4813705335584,598000,598000,0,0,3,may-anh
199268497,Camera Baby Trông Trẻ EZVIZ BM1 1080P - Hàng Chính Hãng,2.0,4595231568834,1600000,1600000,0,0,0,may-anh
195863820,Thẻ nhớ SDXC SanDisk Extreme U3 V30 64GB 170MB/s SDSDXV2-064G (New 2022) - Hàng Nhập Khẩu,405.0,8786969988802,235000,235000,0,0,42,may-anh
194139957,Thẻ nhớ SDHC SanDisk Extreme Pro SDSDXXO-032G U3 V30 32GB 100MB/s New 2022 - Hàng Nhập Khẩu,144.0,7391071269849,219000,219000,0,0,7,may-anh
194075173,Camera Wifi Trong Nhà EZVIZ TY1 Full HD 1080P Quay Quét 355 độ - Đàm Thoại 2 Chiều - Hàng Chính Hãng,25.0,6076712121244,410000,410000,0,0,6,may-anh
193516638,"Kính hiển vi 3 mắt công nghiệp Terino SMD-11HT (Phóng đại 7x-45X, hỗ trợ đèn cực tím UV/Led trắng) - Hàng Chính Hãng",0.0,7019449309824,9350000,9350000,0,0,0,may-anh
181502411,Camera WIFI ngoài trời IMOU IPC-S41FP 4MP - HÀNG CHÍNH HÃNG,1.0,8213855323121,890000,890000,0,0,0,may-anh
159434173,"Pin sạc Kingma Ver 3 cho Nikon EN-EL25 (Sạc Type C siêu nhanh), Hàng chính hãng",9.0,9990683351828,1249999,1249999,0,0,1,may-anh
137938921,Ulanzi Giá Đỡ Ba Chân Ulanzi MT-34 Di Động Xoay 360 Độ Với Ốc Vít 1 / 4 Inch Cho Máy Ảnh - Hàng nhập khẩu,20.0,1309763912901,276000,276000,0,0,4,may-anh
114078550,"Túi Đựng Máy Ảnh Chống Trộm, An Toàn, Phong Cách Mới GN2006 – TẶNG Bút Lau Lens",20.0,9604350594317,249999,249999,0,0,3,may-anh
110750429,Camera Wi-Fi TP-Link Tapo C200 1080P (2MP) An Ninh Gia Đình Có Thể Điều Chỉnh Hướng - Hàng Chính Hãng,30.0,3811653978357,335000,335000,0,0,2,may-anh
68472907,Túi máy ảnh Herringbone Tiny Mellow Canvas - Khaki color,0.0,2625283630652,600000,600000,0,0,0,may-anh
56939825,Máy Ảnh Sony ZV-1 - Chính Hãng,2.0,3022984734662,16990000,16990000,0,0,1,may-anh
54023400,Camera Ezviz C6N (CV246 1080P) + Tặng thẻ nhớ Hikvision 64GB và chân đế - Hàng Chính Hãng,16.0,9734064328527,580000,580000,0,0,3,may-anh
34723316,Bộ 2 Pin Và Sạc Kép RAVPower Cho Sony FW50 A6000 A6300 A6400 A6500 A6600 A7II A7SII A7RII A7 Nex - Hàng Nhập Khẩu,137.0,9480093340879,624999,624999,0,0,43,may-anh
32454377,Chân Máy Ảnh Tripod Yunteng VCT-5208 - Hàng Nhập Khẩu,1.0,6096560678692,255000,255000,0,0,0,may-anh
26434415,Camera IP WIFI IMOU RANGER 2 IPC - A22EP Full HD 1080P - Hàng Chính Hãng,618.0,8448026795869,450000,450000,0,0,96,may-anh
24727831,Pin máy ảnh Canon LP-E8 - KingMa chính hãng,5.0,7866366027036,204999,204999,0,0,2,may-anh
23413669, Kính thiên văn cao cấp Carson AIM MTEL-50 - Hàng chính hãng,16.0,9898740375547,3100000,3100000,0,0,2,may-anh
15851211,Bàn Xoay Chụp Sản Phẩm 360 Độ Đường Kính 35cm - Hàng Chính Hãng,10.0,8655043395556,1590000,1590000,0,0,2,may-anh
14941580,Kẹp Đa Dụng Ulanzi Cho Osmo Pocket Và Smartphone - Hàng Nhập Khẩu,1.0,8038575002497,310000,310000,0,0,0,may-anh
10772578,Đầu Ghi Hình Camera IP Wifi Không Dây 8 Kênh NVR - Hikvision DS-7108NI-Q1/M - Hàng Chính Hãng,1.0,7954134842070,1279789,1279789,0,0,0,may-anh
6921775,Micro Lavalier cài áo Boya BY-M1 - Hàng nhập khẩu,42.0,7948923457255,260000,260000,0,0,3,may-anh
277374091,Combo Livestream Quay Chụp Nhiều Thiết Bị - Tripod Yunteng VCT 668 gắn Thanh Ngang và Kẹp 358 - Hàng chính hãng,1.0,6698477714893,849000,1300000,451000,35,0,may-anh
276797832,[HÀNG CHÍNH HÃNG-PHIÊN BẢN QUỐC TẾ] Camera Hành Trình 70mai Omni X200 Giám Sát Xe Từ Xa Siêu Hot,0.0,3939635132389,360000,360000,0,0,0,may-anh
276797604,"[HÀNG CHÍNH HÃNG-PHIÊN BẢN QUỐC TẾ] Camera Hành Trình 70mai A810 Ghi hình Đồng Thời 2 Mắt Trước Sau, Video Chất Lượng 4K UHD.",0.0,3733156835268,360000,360000,0,0,0,may-anh
276021394,Camera quan sát Xiaomi C400 Smart 2.5K - Hàng Nhập Khẩu ,8.0,6863451539635,839000,839000,0,0,1,may-anh
275089056,"Camera IMOU Trong Nhà Ranger A52P 5mpx / A32ep 3mpx Quay Quét, Đàm Thoại 2 Chiều - Hàng Chính Hãng",1.0,9562903379595,390000,390000,0,0,1,may-anh
274567842,"EZVIZ H9c 3K 10MP , 2K 6MP, Camera 2 Mắt WiFi Ngoài Trời Xoay 360 ống kính kép có màu ban đêm-Hàng chính hãng",0.0,1977327792141,1410000,1410000,0,0,0,may-anh
274191318,Máy ảnh Fujifilm Instax Mini Evo - Hàng chính hãng,7.0,1601077894166,5790000,5790000,0,0,3,may-anh
273635379,Camera Wifi IMOU Ranger Dual 6MP IPC-S2XP-6M0WED 2 Mắt - HÀNG CHÍNH HÃNG,0.0,6240961992080,878900,878900,0,0,0,may-anh
270977143,"Camera WiFi Yoosee 2 Mắt Ngoài Trời, Xem 2 Màn Hình Cùng Lúc, Giám Sát Ngoài Trời Chống Nước IP66 - Hàng nhập Khẩu",98.0,6611243529914,380000,380000,0,0,13,may-anh
270977103,"CAMERA Yoosee 2 MẮT TRONG NHÀ 4MP KẾT NỐI WIFI, XOAY 360 ĐỘ, ĐÀM THOẠI 2 CHIỀU - Hàng Chính Hãng",27.0,5514584342860,310000,310000,0,0,3,may-anh
263596152,Camera wifi trong nhà quay quét 3MP IMOU IPC-A32EP-L - Hàng chính hãng,4.0,5055786712804,385000,385000,0,0,0,may-anh
253542476,"Flycam ZLRC SG108 Max / SG108 Pro, Động cơ không chổi than, Gimbal chống rung 2 trục - Hàng nhập khẩu",26.0,5706929665263,2030000,2500000,470000,19,8,may-anh
253195897,Camera IP Wifi Yoosee Full HD 1080P - Hàng Nhập Khẩu,91.0,1307863702988,200000,200000,0,0,7,may-anh
247719507,"Camera Wifi ngoài trời Imou Cruiser 2 IPC-GS7EP-5M0WE - 3MP/5MP, độ phân giải cao 2K / 3K, phát hiện người và xe cộ, có màu ban đêm - Hàng chính hãng",11.0,3854775396559,992000,992000,0,0,3,may-anh
212935773,Nguồn Tổng Camera 8 KÊNH 60W HIKVISION DS-2FA1205-C8 - Hàng Chính Hãng,14.0,2087171149761,255000,255000,0,0,0,may-anh
205602172,Flycam ZLL SG107 Pro - Thiết bị bay trang bị động cơ không chổi than kết hợp con quay hồi chuyển 6 trục cùng camera HD 4K sắc nét - Hàng nhập khẩu,7.0,2757235956071,1649000,1925000,276000,14,3,may-anh
205299197,Máy ảnh Sony ZV-1F đen - Hàng chính hãng,1.0,4901893263024,15290000,15290000,0,0,0,may-anh
201807568,Gimbal DJI OsMo 6 (Osmo mobile 6) /  Osmo Se- Tay cầm chống rung cho điện thoại - Hàng Nhập Khẩu,78.0,9922132106904,1899000,2500000,601000,24,18,may-anh
197598293,Bộ Pin NP-FW50 2000mAh + Sạc Beston Dùng Cho Máy Ảnh Sony a6100 a6300 a6500 a7m2 r2 s2 a5100 NEX-C3 NEX-C7 a33 a37 a55 - Hàng nhập khẩu,43.0,8012728347974,175000,175000,0,0,12,may-anh
194070191,CAMERA WIFI TRONG NHÀ EZVIZ TY1 4MP 2K QUAY QUÉT 360 ĐỘ - ĐÀM THOẠI 2 CHIỀU - HÀNG CHÍNH HÃNG,20.0,2279111889332,636000,636000,0,0,5,may-anh
184649752,"CAMERA PTZ YOOSEE 5.0 MPX 14 LED SIÊU SẮC NÉT, ĐÀM THOẠI 2 CHIỀU, ĐÊM CÓ MÀU, XEM ĐÊM NÉT - HÀNG NHẬP KHẨU",0.0,4273111964458,639000,639000,0,0,0,may-anh
177196776,Gimbal chống rung cho điện thoại Vimble 3 - Hàng Chính Hãng,1.0,5603172391177,2090000,2090000,0,0,0,may-anh
161978478,"Camera IP Wifi Ngoài trời Full HD 1080P IMOU F22FP Bullet 2E, Có màu ban đêm - Hàng chính hãng",0.0,3647262198937,1050000,1050000,0,0,0,may-anh
149502749,Camera YOOSEE 3.0 Megapixel IP wifi ngoài trời PTZ  FHD1080P  siêu nét - Soi đêm có màu xoay 360 độ - Hàng nhập khẩu,11.0,8913784713473,705000,705000,0,0,0,may-anh
114964724,Bộ dụng cụ khám phá kính hiển vi Barska AY12938 (dành cho trẻ em) - Hàng chính hãng,24.0,2889691479174,1800000,1800000,0,0,6,may-anh
114447618,Camera IP Wifi Ezviz C6N 1080p-Hàng Chính Hãng,81.0,9725742292724,460000,460000,0,0,16,may-anh
114174053,CAMERA Yoosee Ngoài Trời Trong Nhà 3.0Mpx Cao Cấp FullHD 1920 x 1080 Sắc Nét Hỗ Trợ Wifi IP Từ Xa Hàng Nhập Khẩu,40.0,3486681552423,370000,370000,0,0,6,may-anh
109885923,"Túi máy ảnh Safrotto SF003, Hàng chính hãng",2.0,6077787221337,1099999,1099999,0,0,0,may-anh
109879080,"Túi máy ảnh Safrotto SF002, Hàng chính hãng",2.0,5427327179241,1049999,1049999,0,0,1,may-anh
97650599,Chân đế cao cấp Carson The Rock Monopod TR-500 - Hàng chính hãng,3.0,8477463895806,2280000,2280000,0,0,1,may-anh
55617977,Pin Máy Ảnh Sony Np Fz100 Ravpower - Chính hãng,14.0,9376965577491,599999,599999,0,0,4,may-anh
41319582,Camera IP Wifi Trong Nhà EZVIZ C6N 1080p - Hàng Chính Hãng,663.0,6953422443341,580000,580000,0,0,96,may-anh
32528851, Kính thiên văn cao cấp kiểu cổ điển Barska Anchormaster 6x30mm - Hàng chính hãng,3.0,6693165744830,4257000,4257000,0,0,1,may-anh
29254537,Bảng clapper board quay phim - Loại nhỏ,12.0,7101442155242,115000,115000,0,0,2,may-anh
25648528,Camera Dahua IP Wifi  Imou IPC-C22EP-imou - Hàng chính hãng,101.0,4418623893637,410000,410000,0,0,12,may-anh
24343930,Camera IP Wifi IPC-A22EP-IMOU Chuẩn 1080P- Chính Hãng,4.0,3248352095320,389000,389000,0,0,0,may-anh
7521387,Ống Nhòm Barska Escape 7x50 - Hàng chính hãng,15.0,2740286072343,2020000,2020000,0,0,3,may-anh
921244,"Đèn Flash Godox TT600 Cho Canon, Nikon, Sony, Pentax (Tặng Kèm Tản Sáng Bounce) - Hàng nhập khẩu",4.0,3167891451193,1499999,1499999,0,0,3,may-anh
277586471,Thẻ nhớ BIWIN MS100 MicroSDXC V30 UHS-I 32GB | 64GB | 128GB tương thích mọi thiết bị Hàng chính hãng BH 3 năm,2.0,9446285239600,85000,111000,26000,23,0,may-anh
277543697,"[ HÀNG CHÍNH HÃNG ] Camera hành trình ô tô độ phân giải 2K, Wifi, UHD - Thương hiệu Mỹ cao cấp HP-F965S",0.0,1480500778988,215000,215000,0,0,0,may-anh
276882425,"Camera thông minh Wifi trong nhà 365 Selection C1, quan sát toàn cảnh 360°, độ phân giải 3MP 2K, đàm thoại 2 chiều - Hàng chính hãng",3.0,7150387310897,433000,590000,157000,27,0,may-anh
276797475,"[HÀNG CHÍNH HÃNG-PHIÊN BẢN QUỐC TẾ] Camera hành trình 70mai Pro Plus+ A500S ghi hình 2.7K, 2 mắt quay trước sau.",0.0,6593920833925,690000,690000,0,0,0,may-anh
276707347,"Camera Hành Trình Ô Tô 70mai A500S - 1944P, GPS, Cảnh Báo Va Chạm - Hàng chính hãng",2.0,9440407268142,1884000,1884000,0,0,1,may-anh
276370850,"Boya By-M1 mic thu âm cao cấp cho điện thoại, camera, máy tính DRU hàng chính hãng ",6.0,9949020494925,148800,248000,99200,40,1,may-anh
275587098,Camera Wifi TP-Link Tapo C310 3MP An Ninh Ngoài Trời - Hàng Chính Hãng,0.0,1879403397629,740000,890000,150000,17,0,may-anh
273687680,"(Lỗi 1 đổi 1) Camera Wifi Yoosee 2 mắt 2 khung hình Bluetooth độ phân giải 8MP, Siêu Nét, Đàm Thoại 2 Chiều chuyên dụng cho ngoài trời - Hàng nhập khẩu",12.0,6316546858104,499000,499000,0,0,0,may-anh
273400118,Camera IP Speed Dome HIKVISION DS-2DE4xx5IW-DE (T5) Zoom quang học 25x  nhận diện AI - Hàng chính hãng ,0.0,9741423998016,7150000,7150000,0,0,0,may-anh
272013293,(New 2024) Camera Ngoài trời PTZ YooSee 6.0Mpx 1 mắt cố định và 1 mắt quay 360 độ - Góc Rộng - Siêu Nét có Tiếng Việt - Hàng chính hãng,65.0,4442759540076,469000,469000,0,0,9,may-anh
271118612,Máy quay phim Sony FDR-AX43A - Hàng chính hãng,0.0,4165564462488,19990000,19990000,0,0,0,may-anh
261979531,Camera Quay quét Wi-Fi pin sạc EZVIZ CB8 2K kèm tấm pin sạc năng lượng mặt trời - Hàng Chính Hãng,0.0,5103236291999,2790000,2790000,0,0,0,may-anh
259535517,"Camera ngoài trời Imou Cruiser 4G - Hỗ trợ sim 4G, không cần wifi, có màu ban đêm, còi hú và đèn báo động, theo dõi AI - Hàng chính hãng",0.0,5829897467645,1218900,1218900,0,0,0,may-anh
253489396,Flycam ZLL SG108 Max tích hợp cảm biến laser tránh vật cản thông minh - Thiết bị bay có sóng wifi 5G thế hệ mới - Hàng nhập khẩu,5.0,2040539686920,2030000,2500000,470000,19,2,may-anh
247867635,"Camera Wifi EZVIZ H8C 4MP 2K, Quay Quét 360 Độ, Đàm Thoại 2 Chiều, Ghi Hình Màu Ban Đêm- Hàng Chính Hãng",9.0,9538635640779,927000,927000,0,0,0,may-anh
229766303,"Camera WiFi EZVIZ H8 3K - Độ Phân Giải 5MP, Bao Phủ Toàn Cảnh 360 Độ, Phát Hiện Con Người, Đàm Thoại 2 Chiều - HÀNG CHÍNH HÃNG",14.0,3692651565434,1179900,1179900,0,0,2,may-anh
208525075,Máy ảnh film Kodak Ektar H35 Hàng nhập khẩu,1.0,1196569793045,1900000,1900000,0,0,0,may-anh
205615562,"Camera không dây Wifi trông trẻ, camera dùng PIN Ezviz BM1 Đàm thoại/ Phát nhạc/ AI- Hàng chính hãng",3.0,6356588506883,1600000,1600000,0,0,3,may-anh
203991471,"CAMERA WIFI IMOU IPC A42P IMOU 4M 2K SIÊU NÉT, ĐÀM THOẠI 2 CHIỀU, XOAY 360 ĐỘ - HÀNG CHÍNH HÃNG",60.0,9810458321875,589000,589000,0,0,11,may-anh
203898270,CAMERA WIFI IMOU A22EP 1080P XOAY 360 ĐỘ - ĐÀM THOẠI 2 CHIỀU - HÀNG CHÍNH HÃNG,72.0,4072877147767,389000,389000,0,0,17,may-anh
196265020,Máy ảnh chụp lấy liền dùng thẻ nhớ Fujifilm Instax Mini Evo - Hàng chính hãng,27.0,3938011001129,7500000,7500000,0,0,3,may-anh
195740667,Máy Ảnh Sony Alpha 6400 - Cảm biến APS-C | Hàng Chính Hãng,0.0,7588898250308,21990000,21990000,0,0,0,may-anh
194067352,Camera Wifi Trong Nhà EZVIZ C6N 2M FHD 1080P Quay 355 độ - Đàm thoại 2 chiều - Hàng Chính Hãng,32.0,4218744453329,380000,380000,0,0,3,may-anh
193762947,Đầu ghi IP 8 kênh KBVISION KX-A8128N2 - Hàng Chính Hãng,2.0,7140075591476,940000,940000,0,0,0,may-anh
183567880,"Trọn bộ 3 camera DH-HAC-B1A21P Đầu thu 4 cổng XVR1B04 đầy đủ phụ kiện, Hàng chính hãng",1.0,3659761111743,2490000,2490000,0,0,0,may-anh
175988079,Thẻ nhớ MicroSD Samsung Evo Plus tốc độ tối đa 130MB/s dung lượng 32GB/64GB/128GB/ 256GB/512GB chính hãng,12.0,2466779344556,1180000,1400000,220000,16,0,may-anh
159970328,"Camera Wifi Ip IMOU  A22EP 1080P(2M), Xoay 360 Trong Nhà Còi Hú Báo Động,Hàng chính hãng",0.0,6389707081378,585000,585000,0,0,0,may-anh
159496924,"Pin sạc Kingma Ver 2 cho Fujifilm NP-W126, Hàng chính hãng",10.0,1190359358896,199999,199999,0,0,1,may-anh
154259057,"Camera IP WIFI IMOU RANGER A2 Full HD 1080P, phiên bản 2022 - Hàng Chính Hãng",31.0,8004739824595,389000,389000,0,0,9,may-anh
152297469,Camera Dahua Dòng LITE 2MP FULL COLOR DH-HAC-HFW1239TLMP-LED Hàng chính hãng ,1.0,8273248600320,690000,690000,0,0,0,may-anh
135839773,Thẻ nhớ 32/64/128/256gb MIXIE  MicroSD  Class10 U3. Hàng Chính Hãng.,10.0,6981429578398,84000,95000,11000,12,2,may-anh
117076592,Camera IP Wifi Trong Nhà EZVIZ C6N 4MP 2K - Hàng Chính Hãng,76.0,2528257105031,590000,590000,0,0,10,may-anh
108916678,"Pin Kingma cho Nikon EN-EL18, Hàng chính hãng",14.0,8127036029005,949999,949999,0,0,3,may-anh
97599424,Ống Kính Sony FE 50mm F1.2 GM - Hàng Chính Hãng,0.0,1068114436551,47990000,47990000,0,0,0,may-anh
46462092,Camera IP Wifi Trong Nhà EZVIZ C6N 1080p (CS-C6N) - Hàng Chính Hãng,91.0,2933386732563,419000,419000,0,0,17,may-anh
36024549,Camera IP Wifi IMOU IPC C22EP FullHD 1080P - Hàng Chính Hãng,3.0,9317840470094,449789,449789,0,0,0,may-anh
23478407,Camera hành trình SJCAM A10 - Hàng Nhập Khẩu,41.0,2772171420335,2479000,2479000,0,0,15,may-anh
16317237,Camera HIKVISION DS-2CE16D0T-IRP 2.0 Megapixel - Hàng Nhập Khẩu,8.0,5479453748671,350000,350000,0,0,1,may-anh
12889334,Đế kim loại gắn chân máy ảnh tripod quick plate PU-50 - Hàng nhập khẩu,25.0,9689061426366,164999,164999,0,0,9,may-anh
6933381,Balo Máy Ảnh Vanguard Alta Sky 51D (56.51 x 37.14 cm) - Hàng Chính Hãng,0.0,2630798657797,5399999,5399999,0,0,0,may-anh
132829040,"Thắt lưng nam, dây nịt nam da bò thật nguyên tấm Bụi Leather L110 - Khóa tự động, nhiều mặt khóa tùy chọn - Bảo hành 12 tháng",1012.0,2434764084830,258000,258000,0,0,334,phu-kien-thoi-trang
183513090,"Mũ Lưỡi Trai Nam Lính Mỹ Cao Cấp US ARMY U789 Chóp Vuông, Nón Kết Nam Thiết Kế Đơn Giản, Màu Sắc Đa Dạng, Kiểu Dáng Năng Động Trẻ Trung - HÀNG CHÍNH HÃNG",64.0,9813092475158,89000,178000,89000,50,28,phu-kien-thoi-trang
183685137,"Thắt Lưng Dây Nịt Nam Vải Dù US ARMY, Phong Cách Sang Trọng Cổ Điển Mặt Khóa Hợp Kim Thép Chống Ghỉ Cao Cấp -HÀNG CHÍNH HÃNG",193.0,7948867290521,79000,158000,79000,50,52,phu-kien-thoi-trang
183689033,"Thắt Lưng Nam Vải Bố Phong Cách Lính US ARMY, Dây Nịt Nam Vải Dù Khóa ZHANBEIKU Chống Ghỉ Siêu Bền Cao Cấp - HÀNG CHÍNH HÃNG",55.0,1111950999616,89000,178000,89000,50,24,phu-kien-thoi-trang
52726625,"Combo 5 Đôi Tất Nam Vớ Nam Cổ Ngắn Sợi Cotton Cao Cấp Chống Hôi Chân, Không Xù, Không Bai Dão (Cùng Màu)",1576.0,8100152846463,95000,175000,80000,46,395,phu-kien-thoi-trang
277485933,Kẹp Khăn Choàng Bằng Kim Loại Khóa Cố Định Cổ Áo Cardigan Áo Len Kẹp Lưng Áo Thắt Eo Đầm Váy Cho Nữ,6.0,3482076682525,24000,24000,0,0,0,phu-kien-thoi-trang
276190568,Kính lão nam nữ nửa viền cước chống ánh sáng xanh tặng hộp da cao cấp A04,15.0,7483629126288,152000,249000,97000,39,1,phu-kien-thoi-trang
276189274,"Kính lão đọc sách gập gọn xịn from kính đẹp tròng thủy tinh tặng hộp da cao cấp độ từ 0,5-4,0 độ",22.0,8216126482466,139000,199000,60000,30,2,phu-kien-thoi-trang
276156019,Nón unnisex kaki cotton hàn quốc,129.0,9690629423994,135000,150000,15000,10,10,phu-kien-thoi-trang
272447164,"Khóa Cài, Khuy Gài Nới Rộng Eo Quần Không Cần May Điều Chỉnh Thắt Lưng Jean Váy Jean Cho Nam Nữ Tiện Lợi Legaxi",22.0,1627416158273,6500,6500,0,0,1,phu-kien-thoi-trang
183726169,"Thắt Lưng Nam Vải Dù US ARMY, Dây Nịt Vải Dù Bền Chắc, Khóa Hợp Kim Siêu Bền Cao Cấp- HÀNG CHÍNH HÃNG",70.0,6957214722904,89000,178000,89000,50,25,phu-kien-thoi-trang
34159013,"Combo 5 Đôi Tất Nam Vớ Nam Cổ Ngắn Lịch Lãm, Sang Trọng, Chất Liệu Sợi Cotton Co Giãn 4 Chiều Cao Cấp, Chống Hôi Chân  MRM FASHION (Cùng Màu)",5315.0,4570583412355,119000,175000,56000,32,1084,phu-kien-thoi-trang
52758433,"Combo 5 Đôi Tất Nam Vớ Nam Cổ Dài Sợi Cotton Cao Cấp Chống Hôi Chân, Không Xù, Không Bai Dão (Mix Màu)",3727.0,5022354617562,95000,175000,80000,46,997,phu-kien-thoi-trang
52758100,"Combo 5 Đôi Tất Nam Vớ Nam Cổ Dài Sợi Cotton Cao Cấp Chống Hôi Chân, Không Xù, Không Bai Dão (Cùng Màu)",4148.0,2079372401416,95000,175000,80000,46,849,phu-kien-thoi-trang
34159016,"Combo 5 Đôi Tất Hài Lười Nam Lịch Lãm, Sang Trọng, Chất Liệu Sợi Cotton Cao Cấp Co Giãn 4 Chiều Chống Hôi Chân, Silicon Chống Tụt Gót Chân  MRM FASHION (cùng màu)",1549.0,5057919149981,125000,175000,50000,29,340,phu-kien-thoi-trang
261821847,Combo 3 đôi tất (vớ) nam cổ dài sợi modal thoáng khí khử mùi - CB1M001,25.0,1262033576112,83070,117000,33930,29,2,phu-kien-thoi-trang
206995378,Sét 100 Dây Cột Tóc Trơn GroFa - Chính Hãng ( Màu ngẫu nhiên),24.0,9682732686482,19000,19000,0,0,2,phu-kien-thoi-trang
193702569,Băng đô cài tóc vương miện nhiều màu,32.0,9220371127682,39000,39000,0,0,3,phu-kien-thoi-trang
188381543,Dây Buộc Tóc Nữ In Hoa 3D Khăn Choàng Cổ Khăn lụa Thời Trang Phụ Kiện Mặc Đi Chơi Quà Tặng Cao Cấp-New Design PK0011,2.0,2909609816424,25000,25000,0,0,0,phu-kien-thoi-trang
184468806,"Tất Vớ  Trắng Đen Thể Thao Cổ Ngắn, Cổ Trung, Cổ Cao Nam Nữ Vải Dệt Kim HBH ",360.0,9961667671642,9000,9000,0,0,16,phu-kien-thoi-trang
34159085,"Combo 5 Đôi Tất Nam Vớ Nam Cổ Dài Lịch Lãm, Sang Trọng, Chất Liệu Sợi Cotton Mềm Mịn, Cao Cấp, Co Giãn 4 Chiều Chống Hôi Chân MRM FASHION (Cùng Màu)",4527.0,7576286917552,135000,175000,40000,23,884,phu-kien-thoi-trang
58199874,"Combo 5 Đôi Tất Vớ Thể Thao, Vớ Đá Banh, Vớ Chạy Bộ Cổ Dài, Sợi Cotton Cao Cấp Chống Hôi Chân, Chống Phồng Rộp Chân, Chống Trượt Co Giãn 4 Chiều Mrm Manlywear - MM",416.0,8086164314742,175000,250000,75000,30,99,phu-kien-thoi-trang
276156602,Thắt Lưng Nam - Dây Lưng Nam cao cấp khóa kim loại kiểu tự động chất liệu bền bỉ phong cách nam tính,82.0,5623420357921,171000,190000,19000,10,10,phu-kien-thoi-trang
56452217,"Combo 3 Đôi Tất Vớ Thể Thao, Vớ Đá Banh, Vớ Chạy Bộ Cổ Dài, Sợi Cotton Cao Cấp Chống Hôi Chân, Chống Phồng Rộp, Chống Trơn Trượt, Co Giãn 4 Chiều Mrm Manlywear - MM",1052.0,5829983535539,115000,150000,35000,23,229,phu-kien-thoi-trang
184333867,"Găng Tay Thể Thao , Găng Tay Phượt Nhiều Mẫu - Hàng Chính Hãng ",10.0,8850893909553,59000,118000,59000,50,1,phu-kien-thoi-trang
179980666,Gọng kính hợp kim thời trang nam nữ siêu nhẹ siêu bền OURESS 8074,20.0,5254749968583,183200,229000,45800,20,0,phu-kien-thoi-trang
177559018,"Khăn choàng cổ lụa cao cấp cho nữ 70x70cm, nhiều mẫu- CHỌN MẪU- Khăn lụa Turban- Qùa tặng ý nghĩa",120.0,9683375599528,69000,69000,0,0,14,phu-kien-thoi-trang
169641436,"MÓC GÀI TAI SILICON CHỐNG TRƯỢT KÍNH, VẬN ĐỘNG MẠNH",379.0,5706895940382,10000,14000,4000,29,28,phu-kien-thoi-trang
164021768,Hộp kính Aoron hộp đựng kính khóa kéo chọn ngẫu nhiên HV01 - AORON,316.0,3906813057539,70000,70000,0,0,4,phu-kien-thoi-trang
164021724,"Kính Mát Nam Nữ, Mắt Kính Phân Cực Thời Trang, Gọng Kính Vuông Magie AK010 - AORON",166.0,6635098671354,320000,320000,0,0,56,phu-kien-thoi-trang
164021689,"Mắt Kính Phân Cực Thể Thao Đổi Màu Chống Chói Đi Nắng Đi Đêm, Kính Mát Nam Nữ Thời Trang AK041 AORON",315.0,8251990925034,420000,420000,0,0,93,phu-kien-thoi-trang
135001760,"Khăn quàng cổ len cho nữ tông màu pastel thời trang, dày và ấm",41.0,3899372190635,165000,165000,0,0,11,phu-kien-thoi-trang
132016620,"Thắt lưng nam, dây nịt nam da bò 3 lớp Bụi Leather L104 - Khóa tự động, nhiều mặt khóa tùy chọn",129.0,7963129470558,295000,412000,117000,28,55,phu-kien-thoi-trang
105211556,Khăn mùi xoa nam / khăn tay nam cao cấp Hàn Quốc,94.0,6853511617935,69000,69000,0,0,17,phu-kien-thoi-trang
92911325,"Mắt kính mát nữ ốc 7K6833 màu nâu, xám khói râm mát, dịu mắt. Tròng kính chống nắng, chống tia UV. Form kính ôm mặt",272.0,5954710398386,99000,99000,0,0,99,phu-kien-thoi-trang
86406730,"Set 2 kẹp tóc phong cách Hàn Quốc- Kẹp tóc đuôi ngựa- Bộ 2 kẹp tóc nơ xoắn, giao 2 màu khác nhau+ Tặng kèm dây cột tóc, màu ngẫu nhiên",205.0,5377908706632,49000,49000,0,0,34,phu-kien-thoi-trang
76829144,Khăn bandana Khăn turban cotton hiphop size 53*53cm,64.0,1133480437413,40000,40000,0,0,14,phu-kien-thoi-trang
67073870,"Combo 5 Đôi Tất Vớ Lười Nam, Sợi Cotton Cao Cấp Kháng Khuẩn, Chống Hôi, Silicon Chống Tụt Gót Chân - JM - MM",805.0,8653438523904,95000,175000,80000,46,198,phu-kien-thoi-trang
59013211,"GĂNG TAY NỮ ĐA NĂNG , BAO TAY NỮ GIỮ ẤM DN20080502",64.0,6441891476965,59000,59000,0,0,18,phu-kien-thoi-trang
56262919,"Thắt Lưng Nữ Nhỏ Xinh TL005 MayHomes, Dây Lưng Nữ, Dây Nịt Nữ Chất Liệu Da PU Khóa Kim Loại Bền Đẹp",2060.0,1940367868396,32550,35000,2450,7,480,phu-kien-thoi-trang
48757147,Kẹp tóc 3 răng màu đen - Combo 2 sp,173.0,6133226796908,19000,19000,0,0,12,phu-kien-thoi-trang
42731328,"Set 8 kẹp tăm cầu vồng cực dễ thương, màu chọn ngẫu nhiên",141.0,8398036404773,22000,22000,0,0,18,phu-kien-thoi-trang
26612260,Combo 30 tờ hình xăm dán tatoo thời trang nhiều mẫu,5371.0,7762733019706,21000,21000,0,0,463,phu-kien-thoi-trang
23158198,Combo 6 Kẹp Tóc Càng Cua 5 Răng Siêu Bền,16.0,2989508417177,27000,27000,0,0,1,phu-kien-thoi-trang
17603781,Gói dây thun 100 gam màu đen cột tóc,301.0,7330397091682,24499,24499,0,0,57,phu-kien-thoi-trang
16880194,Sét 6 kẹp tóc nhiều kiểu Hàn Quốc chất lượng cao- (1 bảng 6 kẹp đủ màu ),34.0,8815578098661,35000,35000,0,0,4,phu-kien-thoi-trang
12727575,Bộ Năm Cặp Kính Áp Tròng Trong Suốt Dùng 1 ngày Eye Secret,920.0,6506485625751,180000,199000,19000,10,69,phu-kien-thoi-trang
5516513,Khăn Choàng Dạ Cashmere Thu Đông Cao Cấp HN18,96.0,8652317990844,251000,251000,0,0,11,phu-kien-thoi-trang
276178154,Combo 200 Khăn Lau Mắt Kính Nano Chống Mờ Sương Công Nghệ Nhật Bản Mẫu Mới - Hàng Chính Hãng ,13.0,2147314373329,69000,138000,69000,50,3,phu-kien-thoi-trang
276178066,"Combo 100 Khăn Lau Mắt Kính Nano- Miếng Giấy Lau Kính Chống Bám Hơi Nước, Lau Sạch Vân Tay Bụi Bẩn Công Nghệ Nhật Bản - Hàng Chính Hãng ",19.0,5167202964615,39000,78000,39000,50,2,phu-kien-thoi-trang
275536368,Set 6 Lô Cuốn Tóc Nhiều Màu Tiện Dụng Cho Nữ SIZE 16,10.0,6992796058788,34900,34900,0,0,0,phu-kien-thoi-trang
275067642,"Bịt mắt ngủ lụa 2 mặt EMA, miếng che mắt ngủ cao cấp 2 mặt ấm mát có có quai đeo điều chỉnh",26.0,3379602639880,90000,90000,0,0,1,phu-kien-thoi-trang
273211269,Nước xịt rửa mắt kính chuyên dụng KAMI NACHI 50ml,173.0,7333875078208,25000,25000,0,0,13,phu-kien-thoi-trang
205712835,Khẩu trang ninja vải nỉ dán gáy che kín mặt tai chống nắng chạy xe phượt nam nữ hè - khau trang ni,50.0,5965187138449,28000,28000,0,0,3,phu-kien-thoi-trang
205712070,Khẩu trang ninja vải nỉ che kín mặt che tai dán gáy chống nắng chống gió lạnh - khau trang ninja ni,33.0,2920848523840,28000,28000,0,0,4,phu-kien-thoi-trang
196017060,Hình Xăm To Miếng Dán Tạm Thời Tattoo Chống Nước Lâu Trôi Quyến Rũ,18.0,6563300951569,11000,11000,0,0,5,phu-kien-thoi-trang
195514892,"Combo 100 Khăn Lau Mắt Kính Nano- Miếng Giấy Lau Kính Chống Bám Hơi Nước, Lau Sạch Vân Tay Bụi Bẩn- Chính Hãng ",158.0,8080749668675,49000,98000,49000,50,12,phu-kien-thoi-trang
194819426,Kẹp tóc nữ hàn quốc Rhinestone NASI cao cấp màu ngọc xinh xắn dễ thương kẹp tóc mái phụ kiện tóc,42.0,4867069120208,20000,20000,0,0,10,phu-kien-thoi-trang
183498218,"Nón Kết Nam Lính Mỹ U558 Thêu AIR FORCE Chóp Tròn , Nón Lưỡi Trai Nam Vải Kaki Cao Cấp Thời Trang US ARMY Phong Cách Lính Mỹ - HÀNG CHÍNH HÃNG",259.0,2325683652599,94500,189000,94500,50,76,phu-kien-thoi-trang
191747807,Thắt lưng nam da bò nguyên chất mặt khóa tự động hợp kim cao cấp phong cách cá tính,24.0,6915850883873,332500,350000,17500,5,6,phu-kien-thoi-trang
276232449,Thắt lưng da bò sáp nam khóa đồng nguyên khối chất da cao cấp bền bỉ dẻo dai ARES SHOP,96.0,8492788745774,333000,370000,37000,10,5,phu-kien-thoi-trang
87298108,Kẹp tóc sau - kẹp tóc đính đá thiên nga,28.0,8351947853515,89000,89000,0,0,3,phu-kien-thoi-trang
194807589,Kẹp tóc nữ hàn quốc NASI hoa hồng nhỏ xinh dễ thương cute kẹp tóc mái kẹp tóc càng cua,82.0,6181233132563,9000,9000,0,0,2,phu-kien-thoi-trang
191647079,Cà vạt nam trung niên 8cm màu tím Giangpkc Tp HCM,2.0,6493348726271,45000,45000,0,0,1,phu-kien-thoi-trang
191640485,Nơ cổ Nam chú rể MC Tháng 3-2022 Giangpkc Phụ kiện cưới Giang,3.0,5815685256979,44000,44000,0,0,0,phu-kien-thoi-trang
188848409,"Găng Tay Cảm Ứng, Bao Tay Phượt Du Lịch Dã Ngoại Cao Cấp Dành Cho Cả Nam Và Nữ",664.0,6450610486213,75000,75000,0,0,81,phu-kien-thoi-trang
184135793,Quần Tất Nữ 80D Thon Chân Che Khuyết Điểm Thon Gọn Thật Chân Siêu Dai Giữ Nhiệt Dày,400.0,8939594002242,179000,185000,6000,3,43,phu-kien-thoi-trang
183726216,[MẪU MỚI]- Khăn choàng cổ họa tiết thổ cẩm Vintage 180x90cm- CHỌN MẪU- Khăn choàng đi biển Boho,66.0,5452447833614,99000,99000,0,0,15,phu-kien-thoi-trang
181264838,"Dây đeo khẩu trang, Dây đeo kính thời trang chống rơi rớt 2 trong 1, dây khẩu trang xích nhựa",53.0,3415419212069,30000,30000,0,0,7,phu-kien-thoi-trang
179570579,Dây đeo kính chuỗi hạt thời trang cá tính unisex,14.0,3694933302084,75000,75000,0,0,2,phu-kien-thoi-trang
164021654,"Kính Mát Nam, Mắt Kính Nam, Kính Mát Nam Phi Công Tròng Phân Cực Chống Chói, Chống Lóa Đi Xe Ngày Đêm AK037 - Aoron",27.0,1758050454624,360000,360000,0,0,12,phu-kien-thoi-trang
148678512,Mũ bucket nam nữ nón tai bèo họa tiết chữ NY 2 mặt vành tròn Nhiều Màu Phong Cách Ulzzang Unisex,47.0,7465376436514,34003,34003,0,0,5,phu-kien-thoi-trang
146589320,Cài tóc pha lê kim cương sang trọng - bờm tóc pha lê - quà tặng cho bạn gái,130.0,2600027085104,68000,68000,0,0,18,phu-kien-thoi-trang
146368996,[VIDEO]- Khăn lụa choàng cổ dáng dài cao cấp 180x90cm- Quà tặng ý nghĩa cho phái đẹp- CHỌN MẪU,229.0,4429656500609,129000,129000,0,0,33,phu-kien-thoi-trang
143022333,"Găng tay giữ ấm mùa đông chống gió, kháng nước mưa Rhino G101 Bao tay thể thao cảm ứng điện thoại đi xe máy, xe đạp lót nỉ cho nam nữ,  bảo hộ đi phượt",449.0,3040269778288,165000,165000,0,0,95,phu-kien-thoi-trang
122210902,GOTI - Trâm Cài Áo Hình Thiên Nga  Sang Trọng Nữ Tính Kiểu Phụ Kiện Trang Trí Trâm Cài Váy Đầm Dành Cho Nữ Cài Vest Nữ GOTI 02,45.0,7147015341626,15000,15000,0,0,6,phu-kien-thoi-trang
114739740,Cột tóc srunchies mẫu mới màu hồng phấn đẹp,210.0,1493160590798,19900,19900,0,0,27,phu-kien-thoi-trang
95066047,Mũ nón bucket nam nữ trơn tròn vành nhiều màu siêu đẹp MN20,36.0,5132769021471,36000,36000,0,0,7,phu-kien-thoi-trang
83618489,Khẩu trang ninja che kín mặt kín tai vải nỉ dán gáy chống nắng chống gió lạnh mùa đông - khau trang,315.0,8059597397203,35000,35000,0,0,43,phu-kien-thoi-trang
80959586,"dây đeo khẩu trang, Dây đeo kính thời trang chống rơi rớt, 2 trong 1, dây hạt nhựa trắng sang trọng",222.0,5072343966367,30000,30000,0,0,55,phu-kien-thoi-trang
72463477,"Nón bucket trơn đơn giản dễ phối đồ, chất liệu vải mềm mại, vành rộng chống nắng tốt",386.0,3802601984980,29900,29900,0,0,117,phu-kien-thoi-trang
48055328,Bờm cài tóc nam nữ lò xo xoán hot trend,226.0,4202493713856,20000,20000,0,0,29,phu-kien-thoi-trang
28324202,Cặp Kính Áp Tròng Dùng 1 Ngày Eye Secret KM1N - Okinawa Brown,569.0,3646610926858,60000,70000,10000,14,57,phu-kien-thoi-trang
26749168,Khăn len quảng cổ nam lịch lãm sang trọng SK108,105.0,9889082628026,109000,109000,0,0,28,phu-kien-thoi-trang
19843976,Combo 10 Đôi Tất Nam Chống Hôi Chân Thời Trang,31.0,4944649834144,78000,78000,0,0,4,phu-kien-thoi-trang
13771535,Mũ Bucket It's so nice,16.0,1251053944080,33000,33000,0,0,4,phu-kien-thoi-trang
13569901,Set 10 đôi tất nam chống thối chân cổ ngắn xuất Nhật,452.0,6450342032599,74000,74000,0,0,114,phu-kien-thoi-trang
7047875,"Combo 10 đôi tất lười, vớ lười nam dấu gót Hàn Quốc",385.0,2122581090718,71998,71998,0,0,62,phu-kien-thoi-trang
4296945,Bờm cài tóc nữ bọc lụa trơn nhiều màu BN42,173.0,8410331569794,25000,25000,0,0,18,phu-kien-thoi-trang
4213901,Bờm cài tóc nam - nữ màu đen lượn sóng bằng sắt siêu bền BN39,473.0,7126542461994,14499,14499,0,0,69,phu-kien-thoi-trang
2583377,Đai kẹp giữ áo sơ mi (1 cặp),437.0,9289138764805,49000,49000,0,0,73,phu-kien-thoi-trang
276320052,Kính lão hai tròng cao cấp nửa viền  phù hợp đi đường và đọc sách,9.0,4072024258822,252000,349000,97000,28,1,phu-kien-thoi-trang
276181618,"Tất Gấu Cổ Cao Nữ Họa Tiết Hình Gấu,{TP} Vớ Cổ Cao Nữ Hàn Quốc họa tiết",13.0,6345620861374,5900,5900,0,0,1,phu-kien-thoi-trang
276178169,"Khăn Lau Kính Nano Hộp 100 Miếng Giấy Lau Kính Chống Bám Hơi Nước, Lau Sạch Vân Tay Bụi Bẩn - Chính hãng",14.0,8872309611655,39000,39000,0,0,3,phu-kien-thoi-trang
274757286,"Mũ Chống Nắng Vành Siêu Rộng Che Kín 99% Tránh Tia UV, Vành Rộng Che Phủ Đến Cổ Chống Nắng An Toàn",3.0,3689121790659,85000,85000,0,0,2,phu-kien-thoi-trang
274399843,Bộ Nón và khăn cổ len cho Nam cho mùa đông - A162,8.0,4766295545037,140000,140000,0,0,1,phu-kien-thoi-trang
272428347,"Nút Mở Rộng Thắt Lưng, Nới rộng Eo Quần, Khóa Điều Chỉnh Chân Váy Cổ Áo Sơ Mi Lò Xo Hoa Cúc Jeans Denim Legaxi",57.0,6739782761004,6500,6500,0,0,0,phu-kien-thoi-trang
271303348,Set 5 đôi vớ nam cổ ngắn (màu ngẫu nhiên),53.0,2475173669002,45000,45000,0,0,3,phu-kien-thoi-trang
263563873,"Tóc mái thưa làm từ tóc thật FREESHIP tóc mái giả, mái tóc giả, tóc giả nữ",9.0,8541447462889,55000,55000,0,0,1,phu-kien-thoi-trang
253306636,"Khăn vi sợi đa năng chuyên dụng KAMI NACHI - Lau mắt kính cận, mặt kính điện thoại",153.0,6761575678780,30000,30000,0,0,21,phu-kien-thoi-trang
253137246,"Set 10 cúc cài áo mini chống hở, ghim cài trang trí khuy áo thời trang Hàn Quốc (Giao mẫu ngẫu nhiên)",115.0,4949989722290,39000,39000,0,0,9,phu-kien-thoi-trang
198918912,"Khăn lau kính Nano chống bám hơi nước, chống mờ sương, sạch bụi bẩn và dấu vân tay, Công nghệ Nhật Bản - Hộp 100 Miếng",402.0,6039646526317,70000,70000,0,0,38,phu-kien-thoi-trang
197571480,"SET 13 KIM BĂNG GHIM CÀI QUẦN ÁO, THU NHỎ EO, CÀI KHĂN MŨ SANG CHẢNH",124.0,9737611795195,28000,28000,0,0,14,phu-kien-thoi-trang
197568538,Set 5 tờ Hình Xăm Dán Phát Sáng Cá Bạch Tuột Cua Sao Biển Người Cá Sứa Unicorn Khủng Long ,20.0,5752193464874,18000,18000,0,0,0,phu-kien-thoi-trang
194818550,Kẹp tóc nữ hàn quốc NASI màu ngọc cao cấp xinh xắn dễ thương kẹp tóc mái phụ kiện tóc,11.0,3921418092295,22000,22000,0,0,2,phu-kien-thoi-trang
189552242,"KHẨU TRANG chống tia UV, KHẨU TRANG chống nắng UPF 50+, Unisex nam nữ đều thích hợp",31.0,2358716880282,20000,20000,0,0,0,phu-kien-thoi-trang
181692373,Lens nâu tự nhiên có độ Mochi thương hiệu Angel Eyes đường kính 14.2 có độ từ 0 đến 6,20.0,4262753116328,150000,150000,0,0,5,phu-kien-thoi-trang
171893618,Nón phớt mũ cao bồi nam nữ vành nhỏ cói đai đen da nâu dona22031902,3.0,2215010372091,99000,99000,0,0,0,phu-kien-thoi-trang
171464598,Set 10 Khuy Cài Áo Mini Trang Trí,23.0,8324227500461,39000,55000,16000,29,1,phu-kien-thoi-trang
160299898,"Nón bucket vải nhung tăm - mũ tai bèo Ulzzang Unisex nam nữ phong cách thời trang, cá tính ",50.0,6051732886574,38800,38800,0,0,10,phu-kien-thoi-trang
149534368,"Găng tay giữ ấm mùa đông chống gió, kháng nước mưa Rhino G102 Bao tay thể thao cảm ứng điện thoại, găng tay đi xe máy, xe đạp lót nỉ cho nam nữ, bảo hộ đi phượt",105.0,8684011713512,165000,165000,0,0,25,phu-kien-thoi-trang
147420444,"Mũ tai bèo nam nữ vành tròn 2 lớp TIKTOK, nón bucket unisex hottrend",23.0,1145597111311,33000,33000,0,0,7,phu-kien-thoi-trang
145243741,"Băng đô cài tóc, Bờm cài tóc bản 1cm nhiều màu xinh xắn cho nữ - Culi accessories",200.0,5117570067691,24000,24000,0,0,22,phu-kien-thoi-trang
124273189,Hộp Đựng Kính Nhiều Hình,5.0,3490891018856,29000,29000,0,0,0,phu-kien-thoi-trang
108900072,"Ghim cài áo vest, Phụ kiện cài áo chú rể nhiều mẫu - Tien Nguyen",2.0,9611032832791,99000,99000,0,0,1,phu-kien-thoi-trang
105211527,Khăn mùi xoa nữ / khăn tay nữ cao cấp Christian Hàn quốc - nhập khẩu chính hãng Hàn Quốc,87.0,7861367091416,69000,69000,0,0,14,phu-kien-thoi-trang
90945767,Thắt lưng nam TLWG79 khóa tự động dây da cao cấp - Dây lưng nam mặt cá tính khóa hợp kim cao cấp phong cách lịch lãm,164.0,7403794339426,45000,90000,45000,50,66,phu-kien-thoi-trang
76206668,"Mũ chùm tóc khi tắm in họa tiết xinh xắn, đáng yêu - Nội địa Nhật Bản",39.0,5571186391176,38500,38500,0,0,8,phu-kien-thoi-trang
75523702,Mũ Len Nữ Lót Lông Phong Cách Hàn Quốc Phong Cách Dễ Thương,14.0,5546973221264,89000,89000,0,0,1,phu-kien-thoi-trang
74743103, Kẹp Tóc Càng Cua Hàn Quốc Dễ Thương Với Thiết Kế Tinh Tế KT18,740.0,2254794540657,20000,24000,4000,17,83,phu-kien-thoi-trang
59387963,Bờm cài tóc nam nữ unisex nhựa mẫu mới bền đẹp dễ sử dụng,204.0,1404667594268,12000,12000,0,0,26,phu-kien-thoi-trang
57084839,Hộp đựng kính bằng da Pu tặng móc dán PKS,76.0,1191809847114,29000,29000,0,0,14,phu-kien-thoi-trang
56730470,"Combo 5 Đôi Tất Vớ Thể Thao Nam Cổ Dài, Sợi Cotton Cao Cấp Chống Hôi Chân, Chống Phồng Rộp Chân, Chống Trơn Trượt Co Giãn 4 Chiều Thương Hiệu MRM FASHION - CM",170.0,1297344954291,175000,185000,10000,5,32,phu-kien-thoi-trang
50329467,Cài tóc nam nữ viền tròn,171.0,8027465967756,13800,13800,0,0,19,phu-kien-thoi-trang
48933940,Quần tất da chân Hàn Quốc,29.0,4214027263904,69000,80000,11000,14,3,phu-kien-thoi-trang
42238139,Set kẹp tăm đen cao cấp ,95.0,2758170498100,18500,18500,0,0,1,phu-kien-thoi-trang
21308472,Set 3 Cột Tóc Dây Chun Buộc Tóc Đính Ngọc Trai Xinh Xắn,90.0,1926581347633,21999,21999,0,0,17,phu-kien-thoi-trang
15387324,Sét 40 dây buộc tóc tròn cao cấp xuất Nhật HD12 hộp giấy sang trọng,425.0,1309088605848,85000,85000,0,0,90,phu-kien-thoi-trang
5928727,Combo 10 Tất Nam Chống Hôi Chân,268.0,7494604363204,85000,105000,20000,19,63,phu-kien-thoi-trang
4343231,Combo 2 Quần Tất Cao Cấp Format FL-0780W 2,321.0,2435432413087,230000,240000,10000,4,28,phu-kien-thoi-trang
2385201,Găng tay nữ chống nắng UPF50+ kem Zigzag GLV00307,50.0,5981348786199,199000,199000,0,0,6,phu-kien-thoi-trang
276235451,Combo 5 đôi Tất vớ cổ cao nữ chất len bông tất lông cừu siêu dày màu xinh,7.0,2055271621774,85000,85000,0,0,2,phu-kien-thoi-trang
276235447,Set 5 đôi tất vớ Cotton lót lông giữ nhiệt cao cổ siêu ấm màu Pastel cho nữ,2.0,7095449277702,85000,85000,0,0,0,phu-kien-thoi-trang
276191019,Kính lão đọc sách cao cấp dành cho nam và nữ TQ4,18.0,8084994913399,152000,249000,97000,39,3,phu-kien-thoi-trang
276190525,Kính lão nam nữ cao cấp chống ánh sáng xanh from kính vuông tặng hộp da và khăn lau A03,17.0,1241030844557,152000,249000,97000,39,2,phu-kien-thoi-trang
276188078,Kính đọc sách gọng nhựa dẻo tròng kính chống ánh sáng xanh phù hợp cho nam và nữ,18.0,2456898629249,109000,199000,90000,45,2,phu-kien-thoi-trang
276178248,"Hộp 100 miếng khăn lau nano dùng 1 lần - Chống bám hơi nước,hơi thở, chống mờ sương cho kính - Hàng Chính Hãng",9.0,2905864777959,42000,65000,23000,35,0,phu-kien-thoi-trang
252533129,"Găng Tay Hở 2 Ngón Unisex Chống Nắng, Có Thể Sử Dụng Cảm Ứng Điện Thoại",0.0,9390708137742,198000,198000,0,0,19,phu-kien-thoi-trang
197529037,"Găng tay nữ giữ ấm mùa đông eXtreme GT1201 vải nhung chống gió, chống mài mòn, cảm ứng điện thoại",165.0,9945921176184,129000,179000,50000,28,11,phu-kien-thoi-trang
196598525,Dây buộc tóc scrunchies NASI gấp sọc loại cao cấp chất liệu vải bền đẹp phong cách hàn quốc thun cột tóc nữ co giãn tốt phụ kiện tóc,50.0,8564117419078,9000,9000,0,0,3,phu-kien-thoi-trang
196531663,Dây buộc tóc nữ hoa văn chìm 3D [Set 4 dây] NASI dễ thương phong cách hàn quốc thun cột tóc nữ co giãn tốt phụ kiện tóc,21.0,3476891380759,19000,19000,0,0,3,phu-kien-thoi-trang
196487204,"Bộ combo dụng cụ cơ bản KAMI NACHI sửa chữa kính tại nhà gồm ốc, đệm mũi, tua vít, nhíp",15.0,4336390266054,150000,150000,0,0,1,phu-kien-thoi-trang
193717387,"Kính Mát Nam Aoron, Kính Râm Nam Thời Trang, Mắt Kính Phân Cực Cao Cấp Chống Tia UV, Chống Chói Đi Xe Cực Tốt - AK061 - Aoron",24.0,7025393552035,420000,420000,0,0,7,phu-kien-thoi-trang
192909481,NHIỀU MẪU Ghim cài áo vest chữ cái - phụ kiện cài áo - Full box,10.0,7795604217070,149000,149000,0,0,3,phu-kien-thoi-trang
191494175,"[VIDEO]- Khăn lụa choàng cổ cao cấp 180x90cm, phong cách cổ điển sang trọng- Khăn choàng cổ đi du lịch, làm văn phòng...- Quà tặng ý nghĩa cho phái đẹp",10.0,7623329216210,99000,99000,0,0,0,phu-kien-thoi-trang
187422725,Kẹp càng cua ghim cặp tóc cặp tóc Hàn Quốc nơ nàng thơ,6.0,1655963173267,54000,54000,0,0,1,phu-kien-thoi-trang
177637940,Sét 5 Kẹp Tóc Hàn Quốc Cực Xinh Nhiều Mẫu - Hàng Chính Hãng ,26.0,1117996724784,49000,98000,49000,50,3,phu-kien-thoi-trang
169776958,TRÂM CÀI TÓC HỒ LY VÀNG ĐỒNG CÓ HỘP NHUNG ĐỰNG,11.0,9692527214564,90000,90000,0,0,1,phu-kien-thoi-trang
164075726,"Kính Lão, Kính Viễn 2 Tròng Gọng Khoan Sang Trọng Vừa Dùng Đi Đường Vừa Dùng Đọc Sách, Chống tia Uv400, Chống Lóa - BLUE LIGHT",129.0,6104065899690,185000,185000,0,0,34,phu-kien-thoi-trang
140949115,"Kẹp búi tóc, kẹp quấn tóc dẻo củ tỏi đa năng, kẹp tóc đính hoa - ngọc hot trend style Hàn Quốc cho nữ - Culi.accessories",18.0,9521611397237,31900,31900,0,0,2,phu-kien-thoi-trang
136019521,Khăn Choàng Lụa Hàng Châu Cao Cấp Sang Trọng 180x90 cm,80.0,1973284366293,189000,378000,189000,50,18,phu-kien-thoi-trang
110914038,Lô cuốn tóc mái bay Hàn Quốc lõi nhôm siêu to dài tự dính uốn mái dài,68.0,1270374039471,24900,24900,0,0,1,phu-kien-thoi-trang
106992067,Mũ nón Miki kiểu thủy thủ không vành không mỏ kết thêu chữ See You There  phong cách thời trang mới - Hạnh Dương,16.0,8398283788469,58000,58000,0,0,4,phu-kien-thoi-trang
95864964,"Khẩu trang băng lụa chống nắng cao cấp Rhino S251, khẩu trang nam nữ, chống tia UV, chống bụi, UPF50+, Hàng chính hãng",102.0,6408098385934,99000,99000,0,0,22,phu-kien-thoi-trang
83617592,Mũ len kèm khăn choàng cổ giữ ấm thời trang mùa đông cho nam nữ,33.0,4277752301576,79000,79000,0,0,7,phu-kien-thoi-trang
83423370,"Bộ dụng cụ tua vít đa năng sửa kính, mắt kính",82.0,3142542629588,9500,9500,0,0,15,phu-kien-thoi-trang
82948881,"Mũ lưỡi trai trơn không thêu họa tiết, chất liệu vải kaki dầy bền đẹp, có khóa điều chỉnh size đầu - Hạnh Dương",35.0,3163007325979,28600,28600,0,0,9,phu-kien-thoi-trang
74237788,Khăn lụa vuông trơn mầu basic dễ thương AKL85,30.0,6290128130640,47000,47000,0,0,4,phu-kien-thoi-trang
59264335,"Kính mắt chống tia UV, ánh sáng xanh Xiaomi Mijia HMJ01TS - Hàng Nhập Khẩu",81.0,2869284406834,348000,348000,0,0,28,phu-kien-thoi-trang
59230590,Set 5 Kẹp tóc style Hàn Quốc siêu xinh ,29.0,2379634213567,49000,49000,0,0,4,phu-kien-thoi-trang
58059656,Dây xích đeo quần cá tính nam nữ độc lạ,39.0,2001309300806,149000,149000,0,0,14,phu-kien-thoi-trang
56881206,Dây xích đeo quần mix lông vũ cực cool,14.0,6863345657544,129000,129000,0,0,6,phu-kien-thoi-trang
53312074,Combo 3 Kẹp Tóc Càng Cua Mini Nhiều Màu Hàn Quốc 6 Chấu Cứng Cáp Chất Lượng Cao - Giao Màu Ngẫu Nhiên - MP131.3,251.0,7641476387368,18000,18000,0,0,39,phu-kien-thoi-trang
52580065,Găng tay/ bao tay hở ngón chuyên phượt sport có gù - giao màu ngẫu nhiên ,58.0,2542783014020,59000,59000,0,0,22,phu-kien-thoi-trang
51371677,"COMBO 2 Mũ Tắm Trùm Đầu CUTE Tránh Ướt Tóc Khi Tắm , Ủ Dưỡng Tóc Đa Năng - Giao Màu Ngẫu Nhiên - GD010-2",71.0,6657681519181,27805,27805,0,0,14,phu-kien-thoi-trang
50560171,nón ket trơn vải kaki thời trang,2.0,7661664272481,19900,19900,0,0,0,phu-kien-thoi-trang
45469497,Tất len dài qua gối Hàn Quốc - tất giả Boot,78.0,9932792800609,45000,45000,0,0,6,phu-kien-thoi-trang
44638595,"Mũ tai bèo mùa hè xanh tình nguyện, vành rộng 26cm chống nắng tốt, vải kaki thoáng mát",18.0,1437721257717,31000,31000,0,0,3,phu-kien-thoi-trang
20347849,Combo 3 Khăn đa năng nam nữ thể thao dành cho phượt thủ,25.0,2484110013637,79000,99000,20000,20,4,phu-kien-thoi-trang
20238754,"Combo 05 Đôi Vớ Da Nữ Xỏ Ngón Mỏng, Dai VD0502 ",113.0,3870290402832,49000,49000,0,0,22,phu-kien-thoi-trang
276922971,"Dây nịt nam, thắt lưng nam da cao cấp bền đẹp khóa tự động - Style nam tính và lịch lãm WY79",51.0,4613803731547,45000,90000,45000,50,20,phu-kien-thoi-trang
275842566,"Combo 5 đôi tất thể thao chất coton đẹp, phong cách thời trang",2.0,8152850892259,111300,159000,47700,30,0,phu-kien-thoi-trang
275546519,Nón lưỡi trai fom vuông Sâu Đầu logo chữ F cách điệu thêu nổi vải đen thêu trắng hoạ tiết chất lượng cao vành xám brand One Hat,1.0,9985516598853,280000,280000,0,0,0,phu-kien-thoi-trang
273380272,Nón len mũ nồi nón beret nữ lông thỏ 2lớp mẫu mới thời trang Hàn Quốc dona23112001,3.0,5127968875074,149000,149000,0,0,0,phu-kien-thoi-trang
271621440,Khăn bandana họa tiết thổ cẩm - Khăn đội đầu cao cấp Song An Eco,6.0,4434589520111,59400,59400,0,0,0,phu-kien-thoi-trang
263510082,"Băng đô tóc giả mái phủ hói 3D FREESHIP phủ hói tóc giả, tóc giả phủ bạc",14.0,9954721973213,70000,70000,0,0,4,phu-kien-thoi-trang
249005277,Set 100 dây chun buộc tóc Hàn Quốc trơn nhiều màu cao cấp chính hãng dododios,19.0,1173732136073,26000,26000,0,0,2,phu-kien-thoi-trang
207272101,Mũ bucket vành nhỏ thêu lá cờ Việt Nam nón bo vành tròn thời trang phù hợp cả nam và nữ,8.0,9138466345813,25000,25000,0,0,1,phu-kien-thoi-trang
205224896,Tất đùi cao cổ đi boot - Vớ nữ sinh cotton Hàn Quốc,29.0,8188458801099,45000,45000,0,0,3,phu-kien-thoi-trang
196597140,Dây buộc tóc nữ chữ M [Set 5 dây] NASI dễ thương phong cách hàn quốc thun cột tóc nữ co giãn tốt phụ kiện tóc,7.0,3189462088942,12000,12000,0,0,2,phu-kien-thoi-trang
196023341,12 Hình Xăm Tattoo Dán Ngón Tay Chân Chống Nước Lâu Trôi Kiểu Hàn Quốc Mắc Xích Nơ Trái Tim ,4.0,7072094315740,6000,6000,0,0,0,phu-kien-thoi-trang
190180964,Khuy măng sét Anlimen Gentle Cuff Shirt - AGC003,1.0,9881338317613,590000,590000,0,0,2,phu-kien-thoi-trang
184694700,Ghim cài áo vest - ghim ( kèm ảnh minh họa ) - Full box,4.0,3957366007372,159000,159000,0,0,0,phu-kien-thoi-trang
181133399,"Dây xích đeo mắt kính xích titan thời trang cá tính nổi bật ấn tượng, dây đeo khẩu trang chống lạc đa năng",2.0,6941647802146,98000,98000,0,0,0,phu-kien-thoi-trang
170924528,Gọng kính unisex nhựa Acetate cao cấp 3818 size 52-54-58-60,1.0,3363389008202,295200,349000,53800,15,0,phu-kien-thoi-trang
165759345,"Quần tất, vớ quần hở ngón, xỏ ngón Thái Lan Cherilon Open Toes",1.0,7393743291324,89000,129000,40000,31,0,phu-kien-thoi-trang
165243589,Mũ phớt cao bồi Fedora MP06 đẹp cho nam và nữ,19.0,4987965668202,125000,197000,72000,37,0,phu-kien-thoi-trang
162153554,QUẦN TẤT XỎ NGÓN Karebo Nhật Bản,1.0,3207783412175,89000,129000,40000,31,0,phu-kien-thoi-trang
160941208,Mũ bucket trơn ️ Nón tai bèo vành tròn trơn 2 mặt Ulzzang form unisex nam nữ - BK02,7.0,4358097254551,44560,44560,0,0,0,phu-kien-thoi-trang
148842173,"Nón kết jean nam bụi, mũ lưỡi trai jean thiết kế độc đáo, sáng tạo dành cho cả nam và nữ",3.0,5663662840868,98000,98000,0,0,0,phu-kien-thoi-trang
148841792,"Nón kết nam thời trang cao cấp, chất liệu vải xịn oát mềm mại, gắn mặt da chữ Z đẹp",1.0,2587432969577,175000,175000,0,0,1,phu-kien-thoi-trang
138887313,Đôi vớ lưới dài buộc dây quyến rũ thời trang nữ,6.0,8536043505407,35000,35000,0,0,0,phu-kien-thoi-trang
131172562,Khẩu trang 2 lớp kháng khuẩn Khánh An chuyên dùng đi ngoài mưa hộp 50 cái,19.0,8438158214851,37400,44000,6600,15,3,phu-kien-thoi-trang
131172511,50 Khẩu trang y tế kháng khuẩn Khánh An 4 lớp tiệt trùng vô bịch từng cái riêng,114.0,1257871636860,53550,63000,9450,15,12,phu-kien-thoi-trang
110187588,Mũ nón bucket tròn vành thêu siêu đẹp Nam Nữ nhiều mẫu phong cách Ulzzang Unisex - ÁO KHOÁC THIÊN HÀ,2.0,7073121704877,31000,31000,0,0,0,phu-kien-thoi-trang
108900244,"Ghim cài áo - Phụ kiện cài áo vest Lapel pin, ghim đại bàng đính đá - tặng kèm hộp Full box - Tiennguyen",1.0,3748465804003,129000,129000,0,0,0,phu-kien-thoi-trang
101219682,GỌNG KÍNH 5201314 TITAN (Titanium) CHẤT LIỆU VƯỢT TRỘI SIÊU NHẸ SIÊU BỀN – OURESS,1.0,9412054047778,404100,449000,44900,10,0,phu-kien-thoi-trang
95802750,Khăn bandana turban kích thước 54x54cm nhiều mầu sắc - BND07 Xanh đen,3.0,6763974027991,22000,22000,0,0,0,phu-kien-thoi-trang
75797477,Kẹp tóc sau - Kẹp tóc hoa hồng phấn,1.0,5405123784380,55000,55000,0,0,0,phu-kien-thoi-trang
75380791,"Mũ lưỡi trai vải lưới thêu hình con gà thời trang, khóa nhựa xịn - Hạnh Dương - Đen & Nâu",31.0,2710979223925,69000,69000,0,0,1,phu-kien-thoi-trang
73330139,Kẹp tóc sau - hoa hồng cẩn ngọc - loại lớn,441.0,6524828508752,49000,54000,5000,9,71,phu-kien-thoi-trang
72565517,"Mũ bucket tai bèo thêu chữ Tiền nhiều để làm gì, vành rộng chống nắng tốt, chất vải kaki 2 lớp bền đẹp",57.0,8259882946810,32900,32900,0,0,19,phu-kien-thoi-trang
59567031,Combo 2 Mắt Kính Bảo Hộ Mắt,12.0,9273433134876,25000,25000,0,0,1,phu-kien-thoi-trang
49966410,"Combo 5 khẩu trang nam và nữ chất liệu vải Su cao cấp , chóng bụi , màu ngẫu nhiên",11.0,1045036960453,19000,19000,0,0,1,phu-kien-thoi-trang
49210060,Vỉ 3 Kẹp Tóc Càng Cua PASTEL 3 Chấu Loại Xịn MP120.3,529.0,8631786865020,34900,34900,0,0,75,phu-kien-thoi-trang
48751482,Kẹp tóc hoa đại,23.0,4355451464618,85000,85000,0,0,6,phu-kien-thoi-trang
21976327,NÓN RỘNG VÀNH ĐI BIỂN MŨ RỘNG VÀNH ĐI BIỂN DN19RV07026,8.0,8080189121316,175000,175000,0,0,0,phu-kien-thoi-trang
16212451,Combo 6 Quần tất da nữ siêu dai và mịn,1.0,7674422459802,143997,143997,0,0,0,phu-kien-thoi-trang
14251699,Kẹp tóc hoa khô,30.0,6413336884796,54000,54000,0,0,0,phu-kien-thoi-trang
9436934,Cà Vạt Nam Thắt Sẵn Rút Dây Titishop CA55 - Đỏ,51.0,3441941940371,60000,60000,0,0,5,phu-kien-thoi-trang
276823373,"Set  10 đôi tất gấu  , hoa cúc nữ ,cổ ngắn nhiều màu dễ thương vải cotton , khử mùi , kháng khuẩn  kèm túi dây rút xinh xắn cute cho phái nữ",4.0,2302901019441,84550,89000,4450,5,0,phu-kien-thoi-trang
276823349,"Combo 10 đôi tất  hoa cúc , gấu nữ ,cổ ngắn nhiều màu dễ thương vải cotton , khử mùi , kháng khuẩn kèm túi dây rút xinh xắn cute cho phái nữ",3.0,3962354787402,84550,89000,4450,5,0,phu-kien-thoi-trang
276313023,5 đôi tất nam cổ trung 100% cotton,1.0,9376615314832,85000,85000,0,0,0,phu-kien-thoi-trang
276250399,"Vớ Thể Thao In Chữ P , Phong Cách Hàn Quốc Độc Đáo Thời Trang Thu Đông Mới Cho Nữ",21.0,7959169006749,6490,6490,0,0,0,phu-kien-thoi-trang
276190583,Kính lão đọc sách gọng dẻo titan có độ 0.5-4 độ cho người già kính viễn thị gọng titan,26.0,7285285759368,139000,219000,80000,37,4,phu-kien-thoi-trang
274891095,"Cài khăn, Khăn trùm đầu voan phối ren, phụ kiện tóc xuân hè, phụ kiện rùm đầu màu sắc bông hoa ngọt ngào thời trang",1.0,9503130465927,55000,55000,0,0,0,phu-kien-thoi-trang
274659210,"Khẩu Trang Chống Nắng Chống Bụi, Kháng Khuẩn Thế Hệ Mới Thời Trang",0.0,9097314254760,150000,150000,0,0,0,phu-kien-thoi-trang
274027853,"Thắt Lưng Da Nam, Dây Nịt Da Bò Cao Cấp Dành Cho Nam 3.8cm , 1 Lớp, Khóa Đồng ",2.0,4074995517869,199000,199000,0,0,0,phu-kien-thoi-trang
272886862,"Máy rửa làm sạch kính mắt , đồng hồ , đồ trang sức bằng sóng siêu âm chất lượng cao",8.0,7494706085705,186000,186000,0,0,0,phu-kien-thoi-trang
271322185,Mũ nón đi biển rộng vành chống nắng đội 2 mặt gấp gọn chống tia UV dona23080801,4.0,2852131785295,169000,169000,0,0,1,phu-kien-thoi-trang
270991142,"GỌNG KÍNH KIM LOẠI, PHOM TRÒNG NHỎ, DÀNH CHO NỮ",2.0,9271937655477,300000,300000,0,0,0,phu-kien-thoi-trang
270226630,"Kẹp tóc giả càng cua nhỏ ️FREESHIP️ tóc giả kẹp càng cua, tóc giả nữ, kẹp tóc nữ",7.0,2058740271496,40000,40000,0,0,1,phu-kien-thoi-trang
262522796,Bờm cài tóc nữ vitagecao cấp,10.0,5182631101900,48000,48000,0,0,1,phu-kien-thoi-trang
252713761,"Đệm Phồng Mái Tạo Phồng Chân Tóc Tiện Lợi, Kẹp Cài Phồng Mái Siêu Dễ Dàng - 1 miếng",9.0,3936034516691,5900,5900,0,0,0,phu-kien-thoi-trang
206198821,"Mũ phớt, Nón Fedora MP02 thắt da cao cấp cho nam và nữ",14.0,9550895358287,145000,220000,75000,34,4,phu-kien-thoi-trang
204650194,Kính râm màu sành điệu cho nam,1.0,4226318576911,160000,160000,0,0,0,phu-kien-thoi-trang
191644190,Cà vạt nam  phụ kiện nam cao cấp thanh niên công sở coton dầy 3 lớp nhuộm màu thủ công dệt nổi thời trang ấn tượng Giang,15.0,1483673933490,99000,99000,0,0,0,phu-kien-thoi-trang
187253718,Kính thời trang mắt tròn nhỏ - form siêu bé mini,1.0,1946240269811,169000,169000,0,0,0,phu-kien-thoi-trang
184650894,"Kính Mát Thể Thao Nam Phân Cực AORON Dáng Ôm Chống Tia UV Phù Hợp Đạp Xe, Câu Cá, Hoạt Động Ngoài Trời - AK054",16.0,8653245374075,390000,390000,0,0,2,phu-kien-thoi-trang
176583871,Túi Giữ Nhiệt Làm Ấm An Toàn Không Mùi Giữ Nhiệt Đến 14 Giờ Uncle Bills AG1991 ,2.0,4406994705743,59000,59000,0,0,0,phu-kien-thoi-trang
167395588,"Thắt Lưng Nữ Bản Nhỏ Thời Trang Hàn Quốc Mặt Khóa Kim Loại Hình Tam Giác Trẻ Trung Chất Liệu Da PU TL017 MayHomes Dây Lưng Nữ, Dây Nịt Nữ Đa Năng Bền Chắc Dùng Cho Đầm, Jeans, Quần Âu Và Shorts",82.0,4627806450146,54280,59000,4720,8,16,phu-kien-thoi-trang
163023727,"Tất Cao Cổ Giả Boot, Tất Bắp Chân Cotton Len Thu Đông Chất Dày Mềm Mịn PK227",21.0,6764845984833,49000,49000,0,0,0,phu-kien-thoi-trang
160705731,Dung dịch vệ sinh tròng kính Glassone ,51.0,3928097691405,19000,25000,6000,24,7,phu-kien-thoi-trang
150623036,Gọng kính 8089 nhựa cao cấp siêu bền thời trang nam nữ OURESS,4.0,2804594187367,119200,149000,29800,20,1,phu-kien-thoi-trang
130307935,Set 3 Đôi Vớ Thể Thao Cổ Ngắn Dành Cho Nữ Thương Hiệu ELLE EBW SPR1508,18.0,2713881246718,54000,108000,54000,50,2,phu-kien-thoi-trang
110039343,Mũ bucket nam nữ nón tai bèo Trơn quốc dân vành tròn,6.0,4595534364820,33000,33000,0,0,0,phu-kien-thoi-trang
106518445,Kẹp tóc đính đá  - kẹp tóc đỉnh - kép tóc hình chiếc lá nhiều màu lựa chọn,8.0,7442891124068,79000,79000,0,0,2,phu-kien-thoi-trang
75950576,Mấn nhung cài tóc phong cách Âu Mỹ - Mã MA001,15.0,6677921840479,75000,75000,0,0,7,phu-kien-thoi-trang
75512410,Khăn quàng cổ thời trang size 70x70cm - Mã 7027,43.0,5386428970183,89000,89000,0,0,10,phu-kien-thoi-trang
75302829,Khẩu trang chống nắng UPF50+ Black Zigzag MAS00117,155.0,1917069924255,79000,79000,0,0,15,phu-kien-thoi-trang
74548356,Kẹp Tóc Càng Cua Đính Ngọc Trai Nhân Tạo Phong Cách Hồng Kông Thâp Niên 90s,364.0,8368389931615,29900,29900,0,0,63,phu-kien-thoi-trang
68066517,Dây buộc tóc Scrunchies lụa in hoa cúc HD98,88.0,5001733966279,15000,15000,0,0,19,phu-kien-thoi-trang
59099766,Khăn rằn campuchia caro lớn,48.0,6177272097398,78000,78000,0,0,18,phu-kien-thoi-trang
34710581,Cài áo hoa tulip BHC7,35.0,7085033005584,83000,83000,0,0,3,phu-kien-thoi-trang
34158959,"Combo 3 đôi tất lười nam, vớ lười nam Cao Cấp MRM FASHION",203.0,3502062369899,85000,105000,20000,19,21,phu-kien-thoi-trang
31134454,Vớ nam cổ trung Cotton M201 màu Trắng,472.0,1806501156432,36000,36000,0,0,31,phu-kien-thoi-trang
21036436,Gói dây thun 100 gam nhiều màu cột tóc,121.0,9670085670132,19000,19000,0,0,26,phu-kien-thoi-trang
20532197,Thắt lưng nam da bò AT Leather - P140,14.0,4859561524205,229000,295000,66000,22,3,phu-kien-thoi-trang
19989464,Kẹp tóc,28.0,1195078516085,23900,23900,0,0,2,phu-kien-thoi-trang
4562057,"Tất Vớ nam cổ trung trơn AS-PM201. 4 màu: Trắng, đen, xanh, xám. dày dặn, mềm mại, kháng khuẩn khử mùi, không hôi chân.",1078.0,7619422788231,25000,25000,0,0,74,phu-kien-thoi-trang
277521952,Kính Viễn Thị Lão Đọc Sách Lắp Sẵn Độ Gọng Khoan Không Viền Cho Người Trung Niên Già Lớn Tuổi Ông Bà Cha Mẹ Bạc Đen,1.0,1434558246505,230000,230000,0,0,1,phu-kien-thoi-trang
277316193,"Khóa Cài Áo Quần, Nút Cài Cổ Áo Hán Phục Cổ Trang Trung Quốc, Sườn Xám, Áo Choàng Hình Hoa Cúc, Thỏ",9.0,2783265980546,7000,7000,0,0,0,phu-kien-thoi-trang
276688004,Băng đô - Phụ kiện thể thao Hibi Sports A016,7.0,8675850373360,120000,120000,0,0,0,phu-kien-thoi-trang
276493011,Găng tay mùa đông giữ ấm cho nam cảm ứng điện thoại da cao cấp không bong nổ lót nỉ lông ấm áp BTD689,343.0,3650531128688,278000,278000,0,0,3,phu-kien-thoi-trang
276485135,"Găng tay nam mùa đông cảm ứng điện thoại lót nỉ lông cực ấm lòng bàn tay có vân chống trượt, cảm giác tay ga tốt GTN39",174.0,8883892262478,278000,278000,0,0,2,phu-kien-thoi-trang
276188288,kính lão nam nữ không viền phong cách trẻ trung phù hợp khuôn mặt to và vừa A07,16.0,8465037626636,119000,199000,80000,40,1,phu-kien-thoi-trang
276088716,Găng tay NHUNG ngắn màu đen,1.0,6673467410893,50000,50000,0,0,0,phu-kien-thoi-trang
276065818,Bộ 8 miếng đệm mũi chống trượt cho kính bằng mút xốp eva siêu mềm KAMI NACHI,69.0,7236997527654,30000,30000,0,0,7,phu-kien-thoi-trang
276042072,Thắt lưng nam dù chiến thuật đầu rồng Đồ Da Thành Long TLG 203924,1.0,9591799337638,74500,74500,0,0,0,phu-kien-thoi-trang
275910048,Miếng đệm làm êm tai cho kính bằng silicon siêu bền hình móc câu chống trượt KAMI NACHI,243.0,8243574882387,30000,30000,0,0,19,phu-kien-thoi-trang
275092072,"Nón mũ cao bồi nam nữ Fedora comboy chất liệu cói Hàng nhập Nón cao bồi nam nữ Panama, mũ phớt luôn cập nhật liên tục các mẫu mới. Các chủ để liên quan đến Nón mũ phót nam nữ, nón mũ cao bồi nam nữ hấp dẫn. Nón mũ phớt nam nữ, nón mũ ",1.0,6809446027319,99000,99000,0,0,0,phu-kien-thoi-trang
273880621,Chân váy chống nắng cột dây freesize-được chọn mẫu,23.0,7480074547249,111111,111111,0,0,3,phu-kien-thoi-trang
273867988,Dây Đai Nịt Thắt Lưng Giữ Áo Sơ Mi Thẳng Khi Đóng Thùng Loại Quấn Bụng LeGaXi,2670.0,6529588606019,36000,36000,0,0,278,phu-kien-thoi-trang
271219511,10 Hình Xăm Dán Lâu Trôi 15 Ngày Tạm Thời Hoa Hồng Hoa Sen Bướm Xăm Tay Chân Unisex Thời Trang Legaxi,18.0,9038247279838,18000,18000,0,0,2,phu-kien-thoi-trang
271169351,"Hộp Đựng Kính Mắt 3 Ngăn, 5 Ngăn Bằng Da Pu Treo Tường, Gấp Gọn, Tiện Lợi, Sang Trọng Bảo Vệ Kính Mắt An Toàn Hiệu Quả - Hàng Chính Hãng MINIIN",5.0,7244607438823,89000,89000,0,0,1,phu-kien-thoi-trang
270953581,Mũ kết lưỡi trai nam nữ NÓN SƠN chính hãng MC021-ĐN1,2.0,4954701063352,875000,1250000,375000,30,0,phu-kien-thoi-trang
249170637,"KHẨU TRANG chống tia UV, KHẨU TRANG chống nắng UPF 50+",15.0,9802438535340,18000,18000,0,0,0,phu-kien-thoi-trang
214818943,Vớ Cổ Cao Cotton Dày Dặn Miley Lingerie - VCP00,65.0,5381006027945,85000,85000,0,0,0,phu-kien-thoi-trang
210275652,Set 5-10 đôi tất vớ nữ cotton cổ thấp kẻ sọc thể thao năng động phong cách Vintage Hàn Quốc,2.0,8453122031212,49000,49000,0,0,0,phu-kien-thoi-trang
196398998,Dây buộc tóc nữ Classic [Set 10 dây] NASI dễ thương phong cách hàn quốc thun cột tóc nữ co giãn tốt phụ kiện tóc giao ngẫu nhiên,74.0,5146206916455,12000,12000,0,0,4,phu-kien-thoi-trang
194133734,Băng đô cài tóc tai thỏ vải mềm,15.0,5361694699971,55000,55000,0,0,0,phu-kien-thoi-trang
192475583,Kính mát Thời trang chống nắng UV bảo vệ mắt,1.0,2076028554889,169000,169000,0,0,0,phu-kien-thoi-trang
191643916,Tag cài áo ghim cài áo nữ Giangpkc TP HCM 2022,110.0,9193501571549,29000,29000,0,0,5,phu-kien-thoi-trang
185243735,Kính mát Nam Mắt Vuông Thời Trang Chống Nắng,3.0,2065493966533,169000,169000,0,0,0,phu-kien-thoi-trang
185089061,"[VIDEO]- Khăn lụa choàng cổ, chất liệu cao cấp 180cm- Khăn quàng cổ đi du lịch, đi làm, phụ kiện thời trang-Quà tặng cho phái đẹp",17.0,5666276028816,129000,129000,0,0,1,phu-kien-thoi-trang
183040760,"Kính Râm Nam Chống Tia UV, Kính Mát Nam Vuông Dáng Thể Thao, Kính Đổi Màu Đi Ngày Đêm AK048- Aoron",126.0,2848458537681,390000,390000,0,0,33,phu-kien-thoi-trang
172939030,GOTI - Set Ghim Cài Áo Hình Hoa Cao Cấp Sang Trọng Kiểu Charm Trang Trí Váy Đầm Dành Cho Nữ  - Ghim Cài Áo Cao Cấp SET05,119.0,2054662801220,9000,9000,0,0,32,phu-kien-thoi-trang
163572920,Thắt lưng da nam cao cấp- dây nịt da bò 2 lớp EMRENEW -Full hộp đựng cao cấp,230.0,2022782837236,220500,245000,24500,10,62,phu-kien-thoi-trang
107783759,"Khẩu trang vải Azumikichi màu đen, khẩu trang thời trang cao cấp sang trọng",523.0,9762607912374,35000,50000,15000,30,117,phu-kien-thoi-trang
102047282,NÓN PHỚT CAO BỒI NAM MIỀN VIỄN TÂY MŨ PHỚT MŨ CAO BỒI DN21052516,42.0,6111170989809,149000,149000,0,0,8,phu-kien-thoi-trang
94998994,Khẩu trang ninja vải nỉ có kính chống bụi dán gáy che kín tai chống nắng chồng gió bụi chạy xe phượt nam nữ - khau trang ni,148.0,4598772267687,30000,30000,0,0,17,phu-kien-thoi-trang
89597494,Tất Nữ Trơn Cổ Vừa Nhiều Màu Thấm Hút Mồ Hôi PK460,17.0,9069853381336,18000,18000,0,0,4,phu-kien-thoi-trang
77966737,Dây buộc tóc scrunchies size lớn dễ thương HD137,2.0,3038080899692,25000,25000,0,0,0,phu-kien-thoi-trang
77638555,"Nón kết chữ S dành cho nam và nữ, chất liệu vải dù trơn bóng, gắn sò to 2 bên hông nón - Hạnh Dương",184.0,8542356535698,45000,45000,0,0,47,phu-kien-thoi-trang
72120344,"Kính Giả Cận, Gọng Kính Cận Nam Nữ Mắt Vuông Gọng Kim Loại Cứng Cáp - BLUE LIGHT SHOP",65.0,3851181098945,159000,159000,0,0,20,phu-kien-thoi-trang
57350081,Dây Đai Half Belt Thắt Lưng Dây Nịt Quần Thun Co Giãn Không Khoá LeGaXi,255.0,7780321036270,33000,33000,0,0,42,phu-kien-thoi-trang
54365350,"Tóc giả nữ nguyên đầu dài (kèm lưới và lược ). Tóc giả nữ, tóc giả, tóc giả nguyên đầu, tóc giả nữ giá rẻ, tóc giả cao cấp, tóc giả cả đầu. Tóc giả nữ sợi tơ cao cấp, chịu nhiệt tốt, bấm uốn, duỗi, gội thoải mái",40.0,8492234834513,179000,179000,0,0,8,phu-kien-thoi-trang
35436068,Băng đô vải turban hoạ tiết chấm bi dễ thương,12.0,9324374239530,19000,19000,0,0,2,phu-kien-thoi-trang
13612188,Tất lưới đùi viền sọc cực sexy,34.0,2269392849651,29000,29000,0,0,6,phu-kien-thoi-trang
4261281,Băng đô turban giữ tóc bản to chất liệu cao cấp cho bạn gái TB03,38.0,2317300258825,29000,34900,5900,17,3,phu-kien-thoi-trang
277568552,"Mũ che nắng thoáng khí bằng lụa băng, có khăn choàng chống nắng - HÀNG CHÍNH HÃNG MINIIN",3.0,9963165786481,49000,49000,0,0,0,phu-kien-thoi-trang
277541813,"Găng Tay Chống Nắng Dài Vừa Phải, Chống Trượt Thời Trang Mùa Hè, Đàn Hồi - HÀNG CHÍNH HÃNG MINIIN",5.0,1274138466957,49000,49000,0,0,0,phu-kien-thoi-trang
276922983,Găng tay nam chống lạnh mùa đông cảm ứng điện thoại lót lông cực ấm thiết kế ôm tay GTN1,47.0,6259290718052,139000,278000,139000,50,11,phu-kien-thoi-trang
276824829,"Găng tay  unisex đi phươt , dã ngoại , thể thao  chống nắng UV và các tia tử ngoại ,co giãn 4 chiều thoáng mát dễ chịu",5.0,7779501194668,65550,69000,3450,5,1,phu-kien-thoi-trang
276545738,Kẹp tóc càng cua hình con bướm sắc màu đẹp thời trang - Kẹp tóc 2 lớp rất chắc chắn ( nhựa tốt ),5.0,2583572222760,29000,29000,0,0,0,phu-kien-thoi-trang
276152077,"Tất - Vớ Nam Cổ Ngắn Basic Cao Cấp Nhiều Màu Dệt Từ Sợi Tre - Kháng Khuẩn, Thấm Hút, Thoáng Mát, Ngăn Mùi gấp 4 lần tất thường",135.0,3685539248774,40500,45000,4500,10,8,phu-kien-thoi-trang
275737280,Dụng cụ che mắt ngủ,268.0,6470518772387,28000,28000,0,0,34,phu-kien-thoi-trang
275015861,"Bộ Kim Chỉ Khâu Gấp Gọn Cho Công Việc May Vá, Thêu Thùa",11.0,2086172311097,90000,90000,0,0,2,phu-kien-thoi-trang
273901400,Thắt Lưng Dây Nịt Khóa Nhôm Canvas Quân Đội Tháo Nhanh Vải Nylong Dù Thời Trang Nam Nữ Unisex Legaxi,19.0,3412018244838,53000,53000,0,0,4,phu-kien-thoi-trang
271140151,Găng Tay Bao Tay Ống Chống Nắng Cao Cấp Unisex Sport Chống Trượt Hở Ngón,85.0,6625739645556,149000,298000,149000,50,8,phu-kien-thoi-trang
270663546,Cuộn băng keo dán cổ áo Chống thấm mồ hôi Lâu bong tróc Chống bụi bẩn ố vàng 8 mét Dùng 1 lần Legaxi,61.0,3515533898404,18000,18000,0,0,0,phu-kien-thoi-trang
205715082,Găng tay chống nắng nữ cảm ứng chống trơn trượt lỗ thoáng khí họa tiết chấm bi ren thời trang 2021,6.0,1018206975341,50000,50000,0,0,1,phu-kien-thoi-trang
205711425,Mũ len kèm khăn choàng cổ giữ ấm thời trang mùa đông cho nam nữ,15.0,6036433136319,50000,50000,0,0,0,phu-kien-thoi-trang
192985737,"Móc Cài Tai Silicon Siêu Dẻo, Giúp Giữ Gọng Kính Không Bị Tuột Khi Chạy, Nhảy, Chơi Thể Thao, Màu Đen, Trong Suốt",122.0,5370284951879,10000,10000,0,0,8,phu-kien-thoi-trang
191652430,Mũ thể thao sport nửa đầu chơi thể thao nửa đầu KitAcoom hàng chính hãng cao cấp.,8.0,8479425394472,45000,45000,0,0,1,phu-kien-thoi-trang
191643222,TÚI TRÙM ÁO VEST - Túi đựng áo vecton túi treo véc chống bụi,43.0,5800723569673,45000,45000,0,0,3,phu-kien-thoi-trang
183727784,[MẪU MỚI]- Khăn choàng thổ cẩm phong cách Vintage kiểu dài 180x90cm - Khăn choàng cổ Boho đi biển- CHỌN MẪU,16.0,9416279528342,89000,89000,0,0,2,phu-kien-thoi-trang
181692405,Lens xám tây có độ Build a Barbie tự nhiên hiệu Angel Eyes - Độ cận 0-8 - Đường kính màu 13.3mm,16.0,3444897889402,133500,150000,16500,11,5,phu-kien-thoi-trang
171889389,Nón nữ đi biển đẹp mũ rộng vành chống nắng UV cho nữ chất liệu cói vải gấp gọn dona2203204,18.0,1577299184615,159000,159000,0,0,1,phu-kien-thoi-trang
168236756,Tóc line tóc giả kẹp light xoăn cao cấp chất tóc tơ nhật bản chịu nhiệt,51.0,8451532250227,26000,26000,0,0,3,phu-kien-thoi-trang
168236579,Tóc giả mái bay hất cao cấp,15.0,1604441921574,35000,35000,0,0,1,phu-kien-thoi-trang
164430659,"Găng Tay Chống Nắng Đi Phượt Siêu Co Giãn Cho Nam,Nữ -  Fullbox Ngăn Tia UV Bảo Vệ Da - Hàng Loại 1 - Chính Hãng MINIIN",103.0,9603055670122,25000,25000,0,0,13,phu-kien-thoi-trang
164021757,"Kính Mát, Kính Thời Trang, Mắt Kính Nam Nữ Gọng Tròn Tròng Phân Cực Chống Tia UV Cực Tốt AK001- Aoron",27.0,3775178552886,320000,320000,0,0,9,phu-kien-thoi-trang
164021725,"Kính Thể Thao Nam Nữ Đạp Xe, Chạy Bộ Thời Trang, Mắt Kính Phân Cực Polarized Chống Chói, Chống Lóa Đi Đêm AK042 - AORON",52.0,7709899464394,390000,390000,0,0,13,phu-kien-thoi-trang
133135926,"Thắt lưng nam, dây nịt nam da bò thật nguyên tấm Bụi Leather L112 - Khóa cài  - Bảo hành 12 tháng",110.0,2555918498723,241000,260000,19000,7,37,phu-kien-thoi-trang
115269812,Dây cột tóc srunchies mẫu mới màu đen huyền,114.0,3675972759641,20000,20000,0,0,15,phu-kien-thoi-trang
91534977,"Nón tai bèo vành rộng nam chống nắng tốt bảo vệ da, chất liệu vải kaki oát bền đẹp ,sử dụng khi làm việc ngoài trời - Hạnh Dương",124.0,8478238297692,49900,49900,0,0,22,phu-kien-thoi-trang
86658645, Mũ nón bucbet TRƠN 2 mặt- nón tai bèo vành,81.0,2269259775600,32400,32400,0,0,15,phu-kien-thoi-trang
86423621, Light tóc giả móc line cao cấp chịu nhiệt,131.0,7374404685236,18000,18000,0,0,9,phu-kien-thoi-trang
83616170,Khẩu trang ninja vải nỉ dán gáy che kín mặt tai chống nắng chạy xe phượt nam nữ hè - khau trang ni,257.0,5996556341425,35000,35000,0,0,27,phu-kien-thoi-trang
83616022,Mũ len nam nữ trùm đầu liền khăn cổ lót nỉ ấm áp mùa đông chống gió lạnh - mu len nam nu lot ni trum co,48.0,2589907385279,115000,115000,0,0,10,phu-kien-thoi-trang
77729708,Kẹp tóc kim loại phong cách Hàn Quốc cá tính nhiều mẫu lựa chọn,118.0,4261411478846,29000,29000,0,0,26,phu-kien-thoi-trang
70578741,Kẹp tóc ngọc trai - kẹp tóc sau - kẹp tóc đỉnh,192.0,7111181400824,45000,45000,0,0,27,phu-kien-thoi-trang
67992749,Dây buộc tóc Scrunchies lụa dáng dài dễ thương HD78,183.0,4428508934256,25500,25500,0,0,43,phu-kien-thoi-trang
64629151,Dây buộc tóc - Scrunchies hoa thêu mẫu mới hàng đẹp HD63,110.0,9690205825716,19000,19000,0,0,22,phu-kien-thoi-trang
52580540,"Tóc giả búi cột xoăn kiểu Hàn siêu xinh, Chất tơ Cao cấp có thể dùng nhiệt bấm, uốn, duỗi, gội thoải mái, cam kết y hình, giống tóc thật 100%. mẫu này rất tiện lợi và dễ sử dụng ạ",108.0,4317512342174,47367,47367,0,0,14,phu-kien-thoi-trang
50329193,Cài tóc nam nữ,142.0,2787374227964,18000,18000,0,0,27,phu-kien-thoi-trang
14486912,Cài tóc ngọc trai đính đá,278.0,6168394691182,21023,21023,0,0,59,phu-kien-thoi-trang
5476547,Set Tất 7 Ngày Cho Nữ (Kèm Túi),183.0,2439723836685,99000,99000,0,0,24,phu-kien-thoi-trang
1491673,[Một cặp] Kính Áp Tròng Trong Suốt Dùng 1 Tháng Eye Secret KT1T,1562.0,8360433155688,120000,135000,15000,11,103,phu-kien-thoi-trang
276440387,Găng Tay Bao Tay Ống Chống Nắng Cao Cấp Unisex,6.0,6708017335246,98000,98000,0,0,0,phu-kien-thoi-trang
276233025,"Combo 5 đôi Tất nữ lót lông cổ cao ấm áp giữ nhiệt, siêu giữ nhiệt tránh rét đại hàn",12.0,9479845264516,85000,85000,0,0,2,phu-kien-thoi-trang
276232990,Combo 5 đôi Tất len nam lót bông dày dặn dành cho mùa đông (vớ nam dày lót bông đi tuyết),7.0,9923939976170,85000,85000,0,0,1,phu-kien-thoi-trang
276191034,Kính lão gọng gập tiện lợi tròng thủy tinh,12.0,2948392572112,99000,149000,50000,34,1,phu-kien-thoi-trang
276190553,Kính lão cao cấp phong cách nửa viền cước phom to,4.0,4754492124278,152000,249000,97000,39,2,phu-kien-thoi-trang
276190503,Kính  đọc sách đổi màu khi nắng phom vuông phù hợp cho nam và nữ độ từ 1.0-4.0 độ,16.0,3010645457086,119000,199000,80000,40,5,phu-kien-thoi-trang
276066526,Bộ 2 miếng đệm mũi silicon hình bán nguyệt có mặt dán keo cho mắt kính KAMI NACHI,219.0,4755598678744,25000,25000,0,0,17,phu-kien-thoi-trang
275631855,Thắt lưng nam da bò nguyên chất mặt khóa tự động hợp kim cao cấp,15.0,1076271446070,142500,150000,7500,5,3,phu-kien-thoi-trang
275037133,"Hộp 5 đôi tất vớ đi giày tây nam công sở cổ cao MRM Manlywear, sợi cotton organic cao cấp thoáng khí, chống hôi chân",10.0,4939688821023,139000,250000,111000,44,1,phu-kien-thoi-trang
273737674,"Găng tay lót lông cừu giữ ấm mùa đông chống gió, kháng nước Rhino G904 Bao tay chống trượt đi xe máy, xe đạp cho nam nữ, bảo hộ đi phượt",13.0,7935262324238,169000,169000,0,0,1,phu-kien-thoi-trang
273211243,"Khăn lau kính đa năng chuyên dụng KAMI NACHI loại 1 - Lau mắt kính cận, mặt kính điện thoại",269.0,8100043920563,10000,10000,0,0,8,phu-kien-thoi-trang
270057301,Bộ 2 Kẹp Tóc Nơ Nhỏ Xinh Xắn Thời Trang Hàn Quốc,36.0,5909452122978,29000,29000,0,0,5,phu-kien-thoi-trang
255295073,Combo 5 10 cặp vớ da mặt đế dày bằng cotton chống trơn trượt bảo vệ làn da chân khỏi khô ráp - Doni - DOPK249,19.0,2635043645156,90000,90000,0,0,0,phu-kien-thoi-trang
253299439,Kẹp tóc kim loại dạng dài - kẹp tóc sau - Kẹp tóc hoa lưu ly - kẹp tóc sang trọng nữ tính cao cấp,62.0,2987539583728,75000,75000,0,0,12,phu-kien-thoi-trang
210276122,Set 10 đôi tất nữ vớ nữ cổ ngắn phong cách Hàn Quốc cute kèm họa tiết đáng yêu,7.0,7435737245677,79000,79000,0,0,0,phu-kien-thoi-trang
208913527,"Tất Ông Chân, Tất Đùi Giả Boot Len Dày Thu Đông Làm Thon Gọn Chân PK519",57.0,9303765144579,55000,55000,0,0,7,phu-kien-thoi-trang
198788062,Dụng Cụ Vệ Sinh - Lau Mắt Kính Tiện Lợi,196.0,3023955386026,15000,15000,0,0,27,phu-kien-thoi-trang
197848283,Khăn rằn Campuchia ,121.0,7247480244876,74000,74000,0,0,26,phu-kien-thoi-trang
195754874,"Hộp 100 khăn lau kính nano chống bám hơi nước, lau sạch nhờn vân tay bụi bẩn trên mắt kính, điện thoại, laptop, máy ảnh - HENRYSA",54.0,8478114666627,42900,78000,35100,45,1,phu-kien-thoi-trang
195514975,Combo 200 Khăn Lau Mắt Kính Nano Chống Mờ Sương Công Nghệ Nhật Bản - Chính Hãng ,57.0,2466529189362,75000,75000,0,0,8,phu-kien-thoi-trang
194792143,Kẹp càng cua hàn quốc NASI hình bướm dễ thương chất liệu cao cấp bền đẹp kẹp tóc cute nữ phụ kiện tóc,26.0,2405849044818,14000,14000,0,0,4,phu-kien-thoi-trang
174830739,"Tất nike nam nữ cổ cao thể thao, tất cao cổ cao cấp",26.0,8292042964455,17500,25000,7500,30,0,phu-kien-thoi-trang
164021778,"Kính Râm, Kính Mát Nam, Kính Thời Trang Nam Nữ Tròng Kính Palaroid Chống Chói Chất Liệu Magie AK005 - Aoron",22.0,4291927623014,180000,180000,0,0,7,phu-kien-thoi-trang
164021727,Kính Mát Nam Nhiều Màu Thời Trang Chống Lóa Aoron AK015 AORON,20.0,2344185522525,350000,350000,0,0,6,phu-kien-thoi-trang
157082944,Mũ cối chống nước chịu lực chịu va đập tốt tặng kèm sao,24.0,4914257936295,110000,110000,0,0,7,phu-kien-thoi-trang
155464688,Nón mũ len khăn choàng nam thời trang Hàn Quốc don22010402,43.0,4906357849510,169000,169000,0,0,9,phu-kien-thoi-trang
108900134,Khăn Cài Túi Áo Vest - Pocket Square - Phụ Kiện Cài Áo trơn màu,12.0,6431840624354,80000,80000,0,0,0,phu-kien-thoi-trang
103857606,Kẹp tóc vuông màu nhám trơn - set 2 màu bất kì,471.0,9056771032229,21000,24000,3000,13,62,phu-kien-thoi-trang
97073912,Hộp giấy lau kính ,217.0,5644047498616,70000,70000,0,0,17,phu-kien-thoi-trang
77094487,Găng tay ống chống nắng UPF50+ xám Zigzag GLV00202,24.0,9613789211128,179000,179000,0,0,3,phu-kien-thoi-trang
73386757,Kẹp tóc kim loại tam giác trang trí tóc phong cách Vintage,76.0,8652242360811,34900,34900,0,0,16,phu-kien-thoi-trang
58108287,Dây buộc tóc Scrunchies hologram blink blink HD38,91.0,5417118988055,17000,17000,0,0,15,phu-kien-thoi-trang
52317590,Bộ 2 mũ lưỡi trai cho nam ( đen - trắng),6.0,4326471199477,33000,33000,0,0,0,phu-kien-thoi-trang
50325245,mũ lưỡi trai kaki đen,265.0,8380078807582,19900,19900,0,0,46,phu-kien-thoi-trang
34511907,Cài Áo Bông Hoa Ngọc Trai ,106.0,7098341242053,89000,89000,0,0,20,phu-kien-thoi-trang
16621985,Bộ găng tay chống nắng xỏ ngón,621.0,2987833399427,28000,28000,0,0,49,phu-kien-thoi-trang
5476865,Set tất vớ 7 ngày cho nam - Kèm Túi,241.0,1497618859196,99000,99000,0,0,33,phu-kien-thoi-trang
4170711,Bờm cài tóc turban nữ BN23B bản to họa tiết hoa vàng nền xanh lá,40.0,2528627639505,25000,25000,0,0,8,phu-kien-thoi-trang
1479017,[Một cặp] Kính Áp Tròng Dùng 1 Ngày Eye Secret KM1N - Osaka Brown ,1070.0,4933908146821,50000,70000,20000,29,38,phu-kien-thoi-trang
275939019,Lava nghìn lớp trứng muối tan chảy Bánh ngọt nhân lòng đỏ trứng nhãn hiệu Aidebao (6 bánh),0.0,7709044267781,356000,356000,0,0,0,ngon
275940539,"Bánh trung thu HEALTHY hộp quà VIP 6 bánh nướng mini GU.CCI 80g 2D tặng đối tác, sếp, nhân viên cao cấp ",0.0,5077830075483,748000,748000,0,0,0,ngon
275627364,"Bánh trung thu HEALTHY hộp quà VIP 6 bánh nướng mini DI.OR 60g 2D tặng đối tác, sếp, nhân viên cao cấp",0.0,6944467835008,528000,528000,0,0,0,ngon
275940698,Lava nghìn lớp trứng muối tan chảy Bánh ngọt nhân lòng đỏ trứng nhãn hiệu Aidebao (6 bánh),0.0,9605164187133,208000,208000,0,0,0,ngon
275940305,"Bánh trung thu HEALTHY hộp quà VIP 6 bánh nướng mini DI.OR 60g 3D tặng đối tác, sếp, nhân viên cao cấp ",0.0,4123984639506,678000,678000,0,0,0,ngon
276643118,Patê Cột Đèn Hải Phòng - Halong Canfoco - 180g ,2.0,5029185460644,60000,60000,0,0,0,ngon
274943450,Ông Bầu - Cà Phê Muối Hộp 220g,14.0,7245449980532,55000,55000,0,0,0,ngon
274845013,Combo 05 Bánh mì que Patê,10.0,8415079872534,35000,35000,0,0,0,ngon
274834688,Bánh mì kẹp xúc xích Đức phô mai / Hot dog phô mai,24.0,6225687660733,45000,45000,0,0,0,ngon
274834555,Bánh mì Patê,10.0,8522959682776,35000,35000,0,0,0,ngon
275940637,"Bánh trung thu HEALTHY hộp quà VIP 6 bánh nướng mini GU.CCI 80g 3D tặng đối tác, sếp, nhân viên cao cấp",0.0,8840713596165,848000,848000,0,0,0,ngon
275841070,Bánh trung thu HEALTHY hộp quà VIP 6 bánh nướng mini NHŨ VÀNG 60g CÓ TRỨNG,0.0,3210104206090,448000,448000,0,0,0,ngon
273220372,"Gạo Tấm ST25 túi 2kg - Dẻo mềm, thơm nhẹ",1.0,5886046313632,49500,55000,5500,10,0,ngon
251545735,Nước Tương Yamasa Standard Grade (Xanh) chai 1 Lít - Nước tương Nhật KHÔNG CHẤT BẢO QUẢN,4.0,9279222638251,119000,119000,0,0,0,ngon
192211319,THANH LONG RUỘT ĐỎ HỮU CƠ 1KG,8.0,4603846778668,79000,79000,0,0,0,ngon
191986530,Ức Gà Vị Mù Tạc Mật Ong Hàn Quốc Ăn Liền Healthy Tăng Cơ Giảm Cân - Gói 130g,4.0,1119058194850,57000,57000,0,0,0,ngon
191413321,"Gạo Gia Đình - Túi 5kg - Dẻo Vừa, Tơi Cơm, Thơm Nhẹ",1.0,1591006366424,132800,160000,27200,17,0,ngon
190080841,Combo Heo tiết kiệm Thịt xay - Sườn non Meat Master ( 400 G ) - Giao nhanh,75.0,4172889141448,159375,159375,0,0,4,ngon
181456421,Thùng 6 chai nước mắm tôm biển Làng Chài Xưa 525ml Hồng Ngọc Đại Dương 300 năm truyền thống,11.0,2979426583429,540000,540000,0,0,1,ngon
181456354,Nước mắm nhỉ cá cơm than Làng Chài Xưa (Thùng 6 chai ) chai nhựa cao cấp 525ml/chai Đặc Biệt Thanh Dịu An toàn,2.0,5330536223571,360000,360000,0,0,2,ngon
181107654,Bắp giò heo cắt khoanh Meat Master ( 400G ) - Giao nhanh,96.0,9313552475008,49500,49500,0,0,9,ngon
181107578,Nạc dăm heo Meat Master ( 400 G )- Giao nhanh,156.0,1348612626293,79000,79000,0,0,7,ngon
181107570,Sườn heo non Meat Master ( 400 G ) - Giao nhanh,140.0,2338068642494,128700,128700,0,0,7,ngon
181107563,[GIÁ THẤP NHẤT THÁNG Thịt đùi heo Meat Master ( 400G ) - Giao nhanh,142.0,7610110822974,49000,49000,0,0,9,ngon
179968778,Gạo hữu cơ cao cấp/ECOBA Ngọc Mễ 1kg,3.0,1221155393157,99000,99000,0,0,0,ngon
174382567,BẮP BÒ ÚC CẮT LÁT 500G,18.0,9860739025796,140000,140000,0,0,0,ngon
174382539,HÁ CẢO TÔM THỊT 500G,5.0,5200904966190,124000,124000,0,0,1,ngon
171889442,Bình gas Saigon Petro 12Kg,25.0,4238107429031,500000,500000,0,0,4,ngon
163027478,Gia vị lẩu Haidilao thượng hạng đủ vị,10.0,8616843517594,65000,65000,0,0,0,ngon
145429800,Cơm Chiên Dương Châu SG Food 200G,574.0,9034148917061,29500,29500,0,0,24,ngon
130364466,Sữa Chua Hy Lạp 500g,22.0,3108380749545,139000,139000,0,0,5,ngon
91854475,[Chỉ Giao HCM] - CHANH VÀNG NAM PHI 500G,100.0,1871243266551,47500,47500,0,0,7,ngon
76150889,[Chỉ Giao HCM] - Rau lang hữu cơ 250g,79.0,9739823797545,24000,24000,0,0,6,ngon
64664869,[Chỉ Giao HCM] - Rau ngót hữu cơ 250g,47.0,9314413468441,24000,24000,0,0,3,ngon
64626359,[Chỉ Giao HCM] - KHOAI LANG MẬT HỮU CƠ 1 KG,99.0,5839812148595,62000,62000,0,0,5,ngon
62751455,[Chỉ Giao HCM] - KIWI VÀNG ZESPRI 500G,13.0,3306197752294,130000,130000,0,0,2,ngon
61866183,[Chỉ Giao HCM] - CÁNH GÀ TA GÒ CÔNG 550G,169.0,7010489231683,71500,71500,0,0,4,ngon
59306350,[Chỉ Giao HCM] - THỊT HEO XAY HỮU CƠ FAU 310G,69.0,5384800764863,103000,103000,0,0,0,ngon
58941320,[Chỉ Giao HCM] - Cà chua beef - 500g,129.0,6648241194160,34000,34000,0,0,12,ngon
58941301,[Chỉ Giao HCM] - Tôm sú hữu cơ Seaprodex - 0.5kg,16.0,2048713141373,228000,228000,0,0,3,ngon
58941279,[Chỉ Giao HCM] - Khoai lang Nhật vàng hữu cơ - 1kg,191.0,2661827763370,56000,56000,0,0,16,ngon
58941251,[Chỉ Giao HCM] - Bông cải xanh baby - 500g,200.0,6089806210480,47500,47500,0,0,15,ngon
58941237,[Chỉ Giao HCM] - Đậu bắp hữu cơ 300g,113.0,6300230586737,30500,30500,0,0,10,ngon
58941218,[Chỉ Giao HCM] - Rau mồng tơi hữu cơ 250g,122.0,4325718225429,24000,24000,0,0,7,ngon
58941214,[Chỉ Giao HCM] - Bắp cải trái tim - 700g,72.0,5003587665919,38500,38500,0,0,7,ngon
58941210,[Chỉ Giao HCM] - Cải ngọt hữu cơ - 250g,59.0,4065615437951,24000,24000,0,0,7,ngon
56424817,[Chỉ Giao HCM] - Lê Hàn Quốc (1KG),80.0,5944773434615,110000,110000,0,0,12,ngon
277600266,BÁNH XẾP GÀ RÔ TI 50G (500G),1.0,1857293965376,83000,83000,0,0,0,ngon
274951806,Combo 2 Hộp Cà Phê Muối 89K,5.0,3196225497950,89000,89000,0,0,0,ngon
274844924,Bánh mì bì chay,11.0,6148994698142,30000,30000,0,0,0,ngon
274834601,Bánh mì kẹp xúc xích Đức / Hotdog ,3.0,6990360333385,35000,35000,0,0,0,ngon
274353180,Bánh Flan Phô Mai ,2.0,5284286098671,20000,20000,0,0,0,ngon
274317953,Bánh Bông Lan Tươi Vị Phô Mai,2.0,8062331285213,135000,135000,0,0,1,ngon
274278545,Rau câu dừa,1.0,8157234376044,20000,20000,0,0,0,ngon
274056235,Ba rọi rút sườn BBQ Meat Master  (400g/khay),27.0,7458863803130,121000,121000,0,0,2,ngon
274021287,COMBO 3 TÚI - CÀ PHÊ ÔNG BẦU OB2 HÀI HÒA (250G),2.0,8480830454438,260000,260000,0,0,0,ngon
272913134,Đế Bánh Pizza Nướng Sẵn 24cm (190g),2.0,6120240862663,26000,26000,0,0,1,ngon
251284025,Bánh bao mè đen 540g,3.0,9200223828247,112000,112000,0,0,0,ngon
251265739,Bánh bao sandwich 672g,2.0,9074910660985,59000,59000,0,0,0,ngon
204877127,Cà Phê Sữa Đá Ông Bầu Tươi Mới,13.0,7251981771406,46000,46000,0,0,0,ngon
204877103,Cà Phê Hài Hòa Nguyên Hạt OB2- Túi 1kg,2.0,2128929219540,305000,305000,0,0,0,ngon
194096323,Bình Gas Saigon Petro Màu Xám 12kg,1.0,8863202332442,488000,488000,0,0,0,ngon
191986551,Ức Gà Steak Sốt Phô Mai Hàn Quốc Ăn Liền Healthy Tăng Cơ Giảm Cân - Gói 100g,2.0,7204440711784,55000,55000,0,0,0,ngon
191986521,Xúc Xích Ức Gà Xông Khói Hàn Quốc Ăn Liền Healthy Tăng Cơ Giảm Cân - Gói 100g,2.0,8219966016679,48000,48000,0,0,1,ngon
191986512,Ức Gà Sốt Cay Hàn Quốc Ăn Liền Healthy Tăng Cơ Giảm Cân - Gói 130g,3.0,5425507402024,57000,57000,0,0,0,ngon
181107580,Móng heo Meat Master ( 400G ) - Giao nhanh,61.0,5752467556789,60000,60000,0,0,4,ngon
181107566,Xương ống heo Meat Master ( 400G ) - Giao nhanh,124.0,5604883583002,48000,48000,0,0,7,ngon
178720549,"Nước mắm Tĩn cá cơm than nhãn xưa 41N ( tĩn gốm 500ml) sánh đặc thịt cá, không chất bảo quản",4.0,2021012169160,320000,320000,0,0,1,ngon
177242864,Lốc 5 gói Khăn Giấy Tre bỏ túi - Elène Tre 300 tờ (100 Tờ/Bịch x 3 lớp),2.0,5076551793309,40500,40500,0,0,1,ngon
177242791,Khăn Giấy Tre Lụa Lau Mặt - Elène Tre 480 tờ (160 Tờ/Bịch x 3 lớp),1.0,9860837465958,26500,26500,0,0,1,ngon
177221212,Túi 4 gói Khăn giấy rút Tempo 4 lớp Không mùi ( 90 tờ/gói ),1.0,9567503080215,110000,110000,0,0,1,ngon
171889435,Bình gas total xám 12Kg,9.0,6362318854053,500000,500000,0,0,0,ngon
171889428,Bình gas VT đỏ 12Kg,2.0,9137985478291,500000,500000,0,0,1,ngon
162051529,Việt quất Newzealand- 1 hộp 125g,29.0,9448913810413,126000,126000,0,0,2,ngon
160559981,CHUỐI LABA ĐÀ LẠT HỮU CƠ 1KG,56.0,1983887799488,40000,40000,0,0,1,ngon
130364469,Sữa Chua Hy Lạp 200g,5.0,2227724260940,65000,65000,0,0,1,ngon
125502853,[CHỈ GIAO HCM] Phô Mai Mozzarella dạng khối 250gram - NK Đức,167.0,2044560319157,90000,90000,0,0,21,ngon
87054450,[Chỉ Giao HCM] - ĐẬU HỦ KY TOJY 200G,66.0,7014120706229,31000,31000,0,0,5,ngon
71003385,[Chỉ Giao HCM] - TRỨNG CÁ NGỪ ĐẠI DƯƠNG 500G,93.0,9666160671347,59000,59000,0,0,6,ngon
64378421,[Chỉ Giao HCM] - DƯA LEO NHẬT 500G,6.0,2428341045425,27500,27500,0,0,0,ngon
61864385,[Chỉ Giao HCM] - ĐÙI GÀ TA GÒ CÔNG 800G,103.0,3441672801132,208000,208000,0,0,4,ngon
59306232,[Chỉ Giao HCM] - TAI HEO HỮU CƠ FAU 500G,29.0,9359467547735,147000,147000,0,0,4,ngon
59305601,[Chỉ Giao HCM] - BA RỌI RÚT XƯƠNG HỮU CƠ FAU 500G,55.0,1985992395008,181000,181000,0,0,9,ngon
58941265,[Chỉ Giao HCM] - Hành lá hữu cơ - 50g,175.0,7363530858002,10000,10000,0,0,12,ngon
58941247,[Chỉ Giao HCM] - Bí ngòi - 500g,59.0,8998872587946,35000,35000,0,0,7,ngon
58941241,[Chỉ Giao HCM] - Cải bó xôi - 500g,426.0,7866677027329,40000,40000,0,0,32,ngon
58941212,[Chỉ Giao HCM] - Rau muống hữu cơ - 400g,86.0,3625119853339,34000,34000,0,0,7,ngon
274831369,Bánh mì thịt chả ,1.0,6671132376553,30000,30000,0,0,0,ngon
273554438,Lốc 5 Chai Sữa Uống Lên Men Yakult (5x65ml),18.0,1157895583890,25000,25000,0,0,0,ngon
261983256,Hải Sâm Baby,1.0,9198422487175,245000,245000,0,0,0,ngon
251265009,Bánh bao nấm 270g,1.0,9723990668168,54000,54000,0,0,0,ngon
204801755,Bánh bao kim sa Bamboo 240g,3.0,9202939081995,46000,46000,0,0,0,ngon
198746696,Bánh Gấu Nhân Kem DTFood 1kg,1.0,9856113297079,135000,135000,0,0,0,ngon
190086148,Combo Heo tiết kiệm Cốt lết - Sườn non Meat Master ( 400 G ) - Giao nhanh,53.0,1932266814838,188000,188000,0,0,2,ngon
189949444,Combo Heo tiết kiệm Thịt xay - Ba rọi Meat Master ( 400 G ) - Giao nhanh,88.0,7687743482774,118524,118524,0,0,5,ngon
181929376,Nước mắm tôm biển Làng Chài Xưa Hồng Ngọc Đại Dương 125ml/chai,121.0,3461400310687,29000,29000,0,0,7,ngon
181107567,Sườn già heo Meat Master ( 400G )- Giao nhanh,119.0,1793742630068,76000,76000,0,0,11,ngon
181107562,[GIÁ THẤP NHẤT THÁNG] Thịt heo xay Meat Master ( 400 G ) - Giao nhanh,986.0,9128433954441,55350,55350,0,0,29,ngon
181107558,Thịt vai heo Meat Master ( 400G ) - Giao nhanh,109.0,8835612233940,48380,48380,0,0,9,ngon
181107554,Bắp giò rút xương Meat Master ( 400G ) hạn sử dụng từ 1 tới 2 ngày - Giao nhanh,141.0,2745148784415,68200,68200,0,0,13,ngon
177221570,Nước giặt Tide USA 1.36L - Nhập chính hãng P&amp;G USA - Original,1.0,2646522266468,219500,219500,0,0,0,ngon
171057128,Súp Thưởng Cho Mèo Soup Thưởng Cho Mèo (Combo 5 thanh ngẫu nhiên),0.0,7416004194859,45000,45000,0,0,0,ngon
169494091,Tỏi cô đơn củ to - 1kg - Tỏi chuyên dùng làm tỏi đen - Size TO,15.0,3193509069199,149000,149000,0,0,1,ngon
162165409,"Chuối Tươi Union Trading - Nhánh 500g - Thơm Dẻo, Giàu Dinh Dưỡng - Trồng Công Nghệ Cao Tại Việt Nam",0.0,2838230254043,25000,25000,0,0,0,ngon
160437286,QUÝT 2PH 1KG,20.0,1811752625064,104000,104000,0,0,0,ngon
146514984,GÀ CHIPS 500g - GÀ CHIP K & U - 500g (chiên) Food - HÀNG PHÂN PHỐI,2.0,4553367607013,80000,80000,0,0,1,ngon
105368036,"HCM - Gà nguyên con Hàn Quốc (1-1.3kg/con) - Thích hợp với các món lẩu, nướng, hấp, rán, luộc, quay, nộm, cà-ri,… - [Giao nhanh TPHCM]",395.0,7416918864122,79000,79000,0,0,64,ngon
105367992,"HCM - Mực cắt hoa (500g)  - Thích hợp với các món xào, rim, nướng, om nước dừa,... - [Giao nhanh TPHCM]",1257.0,3986888075737,49000,49000,0,0,110,ngon
103046044,"HCM - Đùi tỏi gà (500g) - Thích hợp với các món nướng, sốt cà chua, rô-ti, rim, chiên, kho, bó xôi - [Giao nhanh TPHCM]",2173.0,8623948357997,49000,49000,0,0,173,ngon
103046028,"HCM - Sườn sụn heo (500g) - Thích hợp với các món cháo, hầm, súp,... - [Giao nhanh TPHCM]",6080.0,2550554460763,69000,69000,0,0,331,ngon
103044661,"HCM - Sườn non heo (500g) - Thích hợp với các món nướng, hầm, rang, xào chua ngọt - [Giao nhanh TPHCM]",6949.0,3696313955564,54000,54000,0,0,386,ngon
98636665,[Chỉ Giao HCM] - Dưa hấu ruột đỏ không hạt (3 - 5 kg/trái),130.0,8434282824854,30000,30000,0,0,19,ngon
77351149,Tôm Sú Tươi Sống Bơi Tại Hồ - 1 Đổi 1 Tận Nhà,38.0,6731876646239,286500,286500,0,0,12,ngon
74174006,[Chỉ Giao HCM] - ĐẬU HŨ BÌA TOJY 300G,77.0,5271129736391,20000,20000,0,0,5,ngon
72519129,[Chỉ Giao HCM] - TRỨNG VỊT ĐỒNG 6 TRỨNG,46.0,4513614512464,38000,38000,0,0,4,ngon
72312083,[Chỉ Giao HCM] - TRỨNG GÀ TA GÒ CÔNG 10 TRỨNG,110.0,6728659153420,63000,63000,0,0,4,ngon
65099013,[Chỉ Giao HCM] - ỚT HIỂM HỮU CƠ 50G,96.0,9101848915035,14000,14000,0,0,7,ngon
65091209,[Chỉ Giao HCM] - KHOAI TÂY 500G,115.0,6345020934800,31000,31000,0,0,11,ngon
64649625,[Chỉ Giao HCM] - Khổ qua hữu cơ 500g,52.0,3157756221894,51000,51000,0,0,3,ngon
59306328,[Chỉ Giao HCM] - LƯỠI HEO HỮU CƠ FAU 550G,31.0,6469625162571,176000,176000,0,0,4,ngon
59303025,[Chỉ Giao HCM] - THỊT CỐT LẾT HEO HỮU CƠ FAU 500G,26.0,5891924094573,150000,150000,0,0,0,ngon
58941331,[Chỉ Giao HCM] - Nạc đùi heo hữu cơ FAU - 500g,11.0,8517393413161,168000,168000,0,0,0,ngon
58941303,[Chỉ Giao HCM] - Tim heo hữu cơ FAU - 400g,24.0,1725327038343,149000,149000,0,0,0,ngon
58941293,[Chỉ Giao HCM] - Thịt ba rọi heo hữu cơ FAU - 500g,26.0,3900435132048,171000,171000,0,0,6,ngon
58941287,[Chỉ Giao HCM] - Sườn non heo hữu cơ FAU - 500g,99.0,5331085174221,180000,180000,0,0,3,ngon
58941233,[Chỉ Giao HCM] - Chanh không hạt - 300g,152.0,5349931558262,21000,21000,0,0,9,ngon
58719282,Cá Viên Nhân Thịt SG Food Gói 500g,65.0,6414730232978,66000,66000,0,0,11,ngon
276836604,Mì Somen Nhật Bản Men Sunaoshi 200g ,0.0,8240829718304,45000,45000,0,0,0,ngon
275716515,Xúc xích Master patê 200g/túi ,2.0,1253625335839,41000,41000,0,0,0,ngon
275197845,Ngũ Cốc BA! Granola các loại 300g,0.0,7876824167111,116000,116000,0,0,0,ngon
275120295,Đặc Sản Nha Trang - Bánh Đậu Xanh Nướng Seavy hộp 150g,0.0,3859319276717,40000,40000,0,0,0,ngon
274471185,Khoai Tây Chiên Hashbrowns Tam Giác Farm Frites Đông Lạnh 1kg - Maxzi,0.0,4138831991128,89000,89000,0,0,0,ngon
222396254,Khô Cá Đù,1.0,1935312568474,100000,100000,0,0,0,ngon
205011479,[HỎA TỐC HCM] Cá Trích Ép Trứng Nhật Bản Vàng 1Kg,0.0,8026806869874,1218000,1218000,0,0,0,ngon
204801705,Xíu mại tôm Bamboo 300gr,7.0,2153958671050,54000,54000,0,0,1,ngon
199916060,SÚP BÀO NGƯ VI CÁ,0.0,8358837762686,567000,567000,0,0,0,ngon
199911735,MỰC ỐNG ,0.0,2494160860760,239000,239000,0,0,0,ngon
197923038,Bào Ngư Hàn Quốc size 12-13con/kg,0.0,1453547443624,668000,668000,0,0,0,ngon
194013472,BÀO NGƯ HÀN QUỐC SỐNG BƠI HỒ (1 CON),0.0,4165532201865,99000,99000,0,0,0,ngon
191779073,Bánh Ngàn Lớp Trà Xanh Lava Phô Mai Trứng Muối,1.0,2188068253964,60000,60000,0,0,0,ngon
191779071,Bánh Ngàn Lớp Lava Chocolate,0.0,9589544322776,55000,55000,0,0,0,ngon
189674950,Ốc bulot Pháp ( size 60-80 con) - 1 kg,0.0,1585148120588,350000,350000,0,0,0,ngon
187725526,Cá bớp cắt khoanh - 400 grams,1.0,9410060284677,160000,160000,0,0,1,ngon
181456440,Thùng 6 chai nước mắm nhỉ xuất khẩu Làng Chài Xưa Nhãn Xanh 500ml/chai,8.0,5399940006829,590000,590000,0,0,2,ngon
181107572,Cốt lết heo Meat Master ( 400 G ) - Giao nhanh,171.0,9853002109305,50840,50840,0,0,9,ngon
179722543,Nước Mắm Tĩn lốc mini du lịch 40N đạm tự nhiên gồm 10 chai thủy tinh 60ml nước mắm rin nguyên chất truyền thống sạch là cốt nhĩ từ cá cơm than sánh đặc thịt cá không chất bảo quản,2.0,2344045373015,300000,300000,0,0,0,ngon
179445581,Nước giặt Essence Thái Lan đậm đặc 3500ml Màu Hồng Hương Floral,0.0,6154680151322,235500,235500,0,0,0,ngon
178280170,"Nước mắm Tĩn cá cơm than nhãn đỏ 40N chai thủy tinh (500ml/chai) sánh đặc thịt cá, không chất bảo quản",1.0,5312397719239,190000,190000,0,0,1,ngon
177221345,Giấy Vệ Sinh Elène Tre 10 Cuộn 3 lớp Cao Cấp Có Lõi,0.0,8472686559727,88500,88500,0,0,0,ngon
171889438,Bình gas gia đình xám 12Kg,7.0,3670895566406,500000,500000,0,0,1,ngon
164459838,[Gói lẻ] Trà Sữa Hoà Tan Hainan Malaysia - Ah Huat Tea Blends Hainan Tea,3.0,8268266092738,14000,14000,0,0,0,ngon
157058692,ĐỒ CHUA 150G,0.0,7359204205547,16000,16000,0,0,0,ngon
155608670,[Chỉ giao HCM] Một con KHÔ MỰC THƯỚC(loại 16-20c/kg),0.0,4204086667858,80000,80000,0,0,0,ngon
155608600,[Chỉ giao HCM] 500gr MỰC ỐNG LAO (11 - 20c/kg),1.0,6981209699614,185000,185000,0,0,0,ngon
114194492,[Chỉ bán HCM] - Thịt Đầu Thăn Ngoại Úc - AUST Beef Ribeye - 500gram,91.0,1620985986223,204000,204000,0,0,18,ngon
109357066,Thanh Cá Trích Ép Trứng Vàng - 1 Đổi 1 Tận Nhà - Hải Sản Hoàng Gia,1.0,7015195643781,194000,194000,0,0,0,ngon
105367955,"HCM - Cá saba (200 - 400g) - Thích hợp với các món kho, hấp cuốn bánh tráng, nướng chanh, sốt tương, chiên - [Giao nhanh TPHCM]",707.0,3870360382257,29000,29000,0,0,65,ngon
74749941,[Chỉ Giao HCM] - XÀ LÁCH XOONG 300G,10.0,9048008061280,27000,27000,0,0,0,ngon
73643316,Đậu hà lan SG Food 500g,73.0,4414051127221,52000,52000,0,0,11,ngon
71000953,[Chỉ Giao HCM] - CÁ NỤC ALO FISH 300G,11.0,5403314560133,53000,53000,0,0,1,ngon
65169182,[Chỉ Giao HCM] - BẮP BÒ ÚC 500G,98.0,4784772891313,150000,150000,0,0,8,ngon
64661494,[Chỉ Giao HCM] - RAU MÁ HỮU CƠ QUỲNH LÂM 250G,161.0,1468739485793,44000,44000,0,0,12,ngon
62328899,[Chỉ Giao HCM] - ỨC GÀ TA GÒ CÔNG 400G,113.0,7106053695040,176000,176000,0,0,3,ngon
60309286,[Chỉ Giao HCM] - Cá đù 1 nắng 300g,29.0,3267433959221,74000,74000,0,0,1,ngon
58941324,[Chỉ Giao HCM] - Bông cải xanh - 500g,341.0,4944802486401,35500,35500,0,0,25,ngon
58941273,[Chỉ Giao HCM] - Ớt chuông - 300g,121.0,1917058347027,27000,27000,0,0,4,ngon
58941219,[Chỉ Giao HCM] - Cải thảo hỏa tiễn - 500g,22.0,1810357969276,35000,35000,0,0,1,ngon
275119788,Đặc Sản Nha Trang - Bánh Tráng Dẻo Tôm Seavy túi 200g,1.0,5580912085669,40000,40000,0,0,0,ngon
274669633,Xúc Xích Đức ,1.0,5471156678286,105000,105000,0,0,0,ngon
273550531,Đặc Sản Nha Trang - Cá Đuối Sốt Trứng xốp thơm trứng bơ tỏi Seavy 500G,2.0,3169334595743,230000,230000,0,0,0,ngon
273409858,CÁ MÚ FILLET 80- UP,1.0,8483456180029,298000,298000,0,0,0,ngon
270908731,Thùng 12 hộp  Creamer đặc Sữa pha chế có đường nguyên liệu không thể thiếu trong làm bánh Nuti 1284g TH.SD01  - Thương Hiệu NUTIFOOD,5.0,7443499647868,699000,699000,0,0,1,ngon
254462128,Cá Thác Lác Rút Xương Tẩm Gia Vị (3 Con/KG),0.0,1392509010147,45000,45000,0,0,0,ngon
252166163,Mù Tạt Tươi Wasabi S&B Foods 43g,0.0,1381473577702,45000,45000,0,0,0,ngon
251750689,Tinh bột khoai tây Nhật Bản Katakuriko {Maehara} 200G ,0.0,9361058986273,66000,66000,0,0,0,ngon
216406313,"HCM - Thăn ngoại bò Úc (350g) - Thích hợp với các món sốt vang, áp chảo, chiên tỏi,... - [Giao nhanh TPHCM]",30.0,9987603078043,119000,119000,0,0,0,ngon
198746758,Khô Bò Miếng Hảo Hạng DTFood 250g,0.0,7996003509893,125000,125000,0,0,0,ngon
198746728,Trà Sâm Mật Ong Bio Apgold (580g),0.0,1778685694006,215000,215000,0,0,0,ngon
196802561,Bào ngư Hàn Quốc sống size lớn (12-14 con/kg),2.0,6640206345513,584000,584000,0,0,1,ngon
195948942,"THANH - Trà lá sen ướp hoa lài tươi Đất Phú Farm, 80gr",1.0,7154244184592,350000,350000,0,0,0,ngon
193104050,Bình gas VT Thủ Đức 12kg,0.0,9447201536739,474000,474000,0,0,0,ngon
188846900,Đặc Sản Cà Mau - Bánh Phồng Chuối Cà Mau - 500g,1.0,5076437796348,105000,105000,0,0,1,ngon
186066347,MĂNG TÂY 500G,20.0,8934115316900,74000,74000,0,0,0,ngon
181456363,Thùng 6 chai kết hợp NƯỚC MẮM NHỈ LÀNG CHÀI XƯA TRUYỀN THỐNG (3 chai đỏ + 3 chai xanh) 500ml/chai,3.0,5616057597530,590000,590000,0,0,3,ngon
181107584,[ HCM ]Bắp giò rút xương Meat Master ( 400G ) - Giao nhanh,20.0,5436648112032,68200,68200,0,0,1,ngon
180329575,"Cà Phê Nguyên Chất - Bột - Truyền Thống Số 3 - Buôn Mê Thuột - Hương Thơm Vừa, Vị Đắng Đậm, Hậu Vị Ngọt",2.0,2327596086678,160000,160000,0,0,0,ngon
180103305,"Đặc Sản Cà Mau - Bánh Phồng Tôm - Đặc biệt 50% tôm, Đặc sản Cà Mau, thương hiệu NaGi - Hộp 250g",6.0,6969916000424,95000,95000,0,0,1,ngon
179980197,"Đặc Sản Cà Mau - Tôm Khô Đất Sống Phơi Thượng Hạng, Tôm Khô Cà Mau Chính Hiệu - Hộp 150g",1.0,3803726555940,430000,430000,0,0,0,ngon
178034176,Nước mắm nhỉ Làng Chài Xưa xuất khẩu nhãn xanh chai thủy tinh 500ml cốt nhỉ đặc biệt vị dịu nhẹ gu Việt Kiều giới trẻ thành thị,6.0,9354710646230,120000,120000,0,0,2,ngon
177221440,Giấy Vệ Sinh Elene Hồng 10 Cuộn 3 Lớp,0.0,4270000230770,89500,89500,0,0,0,ngon
177119776,CÁ HỒI SOCKEYE ALASKA WHOLE FILLET ,0.0,1810035232518,630000,630000,0,0,0,ngon
164486751,Mật ong rừng nguyên chất hoa cà phê loại 50 gam,659.0,7630095668416,10000,10000,0,0,12,ngon
163027678,Các loại mì Samyang Hàn Quốc,0.0,9740297248988,26000,26000,0,0,0,ngon
162168365,"Nấm Đùi Gà Việt Nam 500g - Ngon Ngọt, Giòn Dai - Trồng Tại Nhà Máy Công Nghệ Cao Bắc Âu, Đak Lak",0.0,3364965881609,75000,75000,0,0,0,ngon
158713810,Hộp Nước Dừa Đóng Hộp từ 100% dừa tươi nguyên chất hương vị Tắc - Thương hiệu COCOXIM 330ml,0.0,9224326242599,19000,19000,0,0,0,ngon
155608590,"[Chỉ giao HCM] 500gr CÁ MÚ SAO (1 con từ 800gr-1,5kg)",1.0,9979190080754,175000,175000,0,0,1,ngon
129210972,"[Chỉ Giao HCM] Đu Đủ Chín - Trái 1,5kg trồng sạch",34.0,2147605856611,37500,37500,0,0,5,ngon
103044707,"HCM - Thịt nạc thăn heo (500g) - Thích hợp với các món nướng, chiên, áp chảo, kho,... - [Giao nhanh TPHCM]",760.0,2756447318791,59000,59000,0,0,54,ngon
72520387,[Chỉ Giao HCM] - DƯA LƯỚI MẬT 2.3KG,19.0,6258692553289,221000,221000,0,0,2,ngon
62725486,[Chỉ Giao HCM] - THĂN BÒ 250G,60.0,9100647660979,127000,127000,0,0,3,ngon
59306010,[Chỉ Giao HCM] - ÓC HEO HỮU CƠ FAU - 1 BỘ ÓC,66.0,5871862440847,105000,105000,0,0,3,ngon
58941281,[Chỉ Giao HCM] - Dưa hấu không hạt - 3kg,72.0,1991572635792,117000,117000,0,0,4,ngon
58941255,[Chỉ Giao HCM] - Củ hành tím - 200g,62.0,6679272031452,24800,24800,0,0,7,ngon
58941249,[Chỉ Giao HCM] - Cà rốt baby - 300g,85.0,7028757467054,36000,36000,0,0,6,ngon
58941216,[Chỉ Giao HCM] - Cải ngồng hữu cơ - 250g,95.0,9848581652390,24000,24000,0,0,5,ngon
58727938,Hải Sản Lẩu Thập Cẩm SG Food Gói 500g,64.0,9449505048772,85500,85500,0,0,10,ngon
275716413,Xúc xích Master xông khói chuẩn Đức 250g/túi,1.0,6809413059462,43000,43000,0,0,0,ngon
275273067,THANH CHÂN CUA ĐẠI 500GR _ GIANT CRAB LEGS 500GR,0.0,7291735406638,110000,110000,0,0,0,ngon
274322369,Bánh Bông Lan Tươi Vị Khoai Môn Phô Mai,2.0,9967787527652,145000,145000,0,0,1,ngon
273236811,Đặc Sản Nha Trang - Hộp Nước Mắm Nhĩ 584 Loại 40 Độ Đạm Seavy Xách 2 chai 500ml,0.0,2549199465190,180000,180000,0,0,0,ngon
272167729,Đầu mực ống làm sạch SEAPRODEX - 250G,0.0,9062419509746,62000,62000,0,0,0,ngon
270503432,Tôm sú thịt sinh thái Seaprodex kích cỡ 71/90-250gr.,0.0,8488489590179,100000,100000,0,0,0,ngon
204801743,Chả giò hải sản mayonnaise Bamboo 320gr,1.0,4354497685764,56000,56000,0,0,0,ngon
194042316,Bình Gas ELF Gaz Màu Đỏ 12.5kg,0.0,6780965090637,531000,531000,0,0,0,ngon
191814298,Nam Việt Quất Aro Đông Lạnh 1kg ,2.0,3013311512998,239000,239000,0,0,0,ngon
191714121,Bơ Lạt Thỏi Conviette Đông Lạnh 15g (Hộp 10 Thỏi),0.0,3002362021597,140000,140000,0,0,0,ngon
179718018,COMBO 2 BÌNH Nước mắm Tôm Biển Truyền Thống 60N đạm - Nước mắm Tĩn - 500ml/bình Thơm Ngon Hảo Hạng Không Chất Bảo Quản,0.0,3600775134676,1600000,1600000,0,0,0,ngon
178107933,Bánh Mandu Thịt và Bắp CJ Bibigo – Gói 175g,0.0,5167354124926,29000,29000,0,0,0,ngon
178107874,Chả giò đặc biệt hải sản Cầu Tre 500g,0.0,6261175923819,62192,62192,0,0,0,ngon
178107861,Chả giò đặc biệt Nhân thịt Cầu Tre 500g,0.0,8290908852112,63296,63296,0,0,0,ngon
178034686,Nước mắm nhỉ Làng Chài Xưa truyền thống nhãn đỏ chai thủy tinh 500ml cốt nhỉ đặc biệt vị đậm đà gu ông bà xưa từ 100% cá cơm tươi không chất bảo quản,3.0,2522413141004,120000,120000,0,0,1,ngon
178032170,Nước mắm nhỉ cá cơm vàng ruột đỏ Làng Chài Xưa 525ml/chai cá ngon vùng nước trồi 300 năm truyền thống,0.0,1792395568097,70000,70000,0,0,0,ngon
177971856,Nước mắm nhỉ cá cơm than Làng Chài Xưa 525ml (01 chai) sánh đặc thịt cá 300 năm truyền thống,1.0,3281878625601,60000,60000,0,0,0,ngon
177242561,Giấy vệ sinh Elene xanh 10 cuộn 3 lớp không lõi,3.0,8467591201533,92500,92500,0,0,0,ngon
177221374,Giấy vệ sinh Lency 15 cuộn cao cấp ( 3 lớp ),0.0,1007021530719,86500,86500,0,0,0,ngon
171795467,[Chỉ giao HCM] Thanh ăn kiêng Marzipan không đường hỗn hợp hạt và RAU CỦ QUẢ ORGANIC Cao cấp - 3 VỊ RAU CỦ 90g,0.0,5800673131011,261000,261000,0,0,0,ngon
171101278,Bình gas VT màu đỏ 12kg,0.0,6217946341984,498000,498000,0,0,0,ngon
158713813,Hộp Nước dừa Xiêm Sen 100% dừa tươi nguyên chất Cocoxim 1000ml,0.0,9959749477656,19000,19000,0,0,0,ngon
149366232,Đùi gà tỏi 1kg,0.0,3403016678825,80000,80000,0,0,0,ngon
148872674,Củ nén hành tăm - Dori Thơm - 250g 500g 1kg - Gia vị Việt Nam,1.0,8465479067254,79000,79000,0,0,1,ngon
146513546,Ba rọi xông khói cắt lát/Smoked bacon (Sliced)500GR/PE,0.0,7450429540691,163000,163000,0,0,0,ngon
133245864,Hành tím khô Ấn Độ - Dori Thơm - 1kg - Hành tím củ to tròn khô,13.0,2189724388871,33000,33000,0,0,1,ngon
121398595,[Chỉ giao HCM] Cherry Goco Smoothies - 500ml,0.0,2722832018617,53000,53000,0,0,0,ngon
113449301,[Chỉ Giao HCM]  CÁ HỒI FILLET -200G,20.0,6103672151712,145000,145000,0,0,6,ngon
113401455,Tôm hùm Canada (Alaska) sống size 500g,23.0,9346755522173,498000,498000,0,0,4,ngon
103044704,"HCM - Tai heo (500g) - Thích hợp với các món xào, gỏi, luộc, thịt đông, cuộn, ngâm,... - [Giao nhanh TPHCM]",134.0,8817592275429,49000,49000,0,0,16,ngon
103044699,"HCM - Đùi ếch (500g) - Thích hợp với các món chiên, xào, kho, lẩu, cari,... - [Giao nhanh TPHCM]",89.0,1375486783225,49000,49000,0,0,14,ngon
103044697,"HCM - Cánh gà (500g) - Thích hợp với các món chiên món chiên, sốt cay, hấp, nướng,... - [Giao nhanh TPHCM]",664.0,1613703622220,82000,82000,0,0,52,ngon
103044617,"HCM - Cá saba (400 - 600g) - Thích hợp với các món kho, hấp cuốn bánh tráng, nướng chanh, sốt tương, chiên - [Giao nhanh TPHCM]",56.0,1359759926105,29000,29000,0,0,5,ngon
102897739,"HCM - Mực ghim (450g Net) - Thích hợp với các món hấp, nướng, xào, chiên bột - [Giao nhanh TPHCM]",36.0,9024163219483,89000,89000,0,0,7,ngon
81804869,Cá Viên Nhân Tôm SG Food Gói 500g,63.0,4623951402795,89500,89500,0,0,13,ngon
72338570,[Chỉ Giao HCM] - BƠ ĐÀ LẠT 1KG,19.0,3170319508379,100000,100000,0,0,1,ngon
58941333,[Chỉ Giao HCM] - Củ dền - 500g,178.0,5334454105956,27500,27500,0,0,4,ngon
58941328,[Chỉ Giao HCM] - Củ cải trắng hữu cơ - 250g,30.0,5822168019992,31500,31500,0,0,4,ngon
58941235,[Chỉ Giao HCM] - Rau dền hữu cơ 250g,108.0,2447311143749,24000,24000,0,0,6,ngon
58728221,Lẩu Đầu Cá Hồi SG Food Gói 500g,65.0,9171816730304,65000,65000,0,0,8,ngon
275248858,TÔM XÙ RẾ 3 MÀU BAMBOO 30G (300G),0.0,7114638791786,89000,89000,0,0,0,ngon
274317848,Bánh Bông Lan Đài Loan Vị Lá Dứa,1.0,7736837034018,130000,130000,0,0,1,ngon
272554507,Mộc heo hữu cơ FAU 300g,4.0,3193702162706,98000,98000,0,0,0,ngon
263486091,Calzone Pizza gập nhân phô mai cà chua 400gr,3.0,5275162714722,62000,62000,0,0,0,ngon
205846087,Dưa leo hữu cơ,0.0,1388962648705,24500,24500,0,0,0,ngon
198127798,"Sữa ong chúa tươi nguyên chất HONIMORE 300g - bồi bổ sức khỏe, da căng mịn",0.0,4992996036424,710000,710000,0,0,0,ngon
194041213,Bình gas Thủ Đức bọc nhựa 6kg ,0.0,8388885449353,297000,297000,0,0,0,ngon
191779083,Bánh Lava Phô Mai Trứng Muối,1.0,1241670076191,55000,55000,0,0,0,ngon
189674942,Bào ngư Úc viền xanh ( size :11-12 con )- 1kg,0.0,3957765511231,1790000,1790000,0,0,0,ngon
187608778,Thạch trái cây - Cocon Nata de Coco Pudding Assorted 480g,0.0,2686413290615,60000,60000,0,0,0,ngon
183333313,GIÒ LỤA 500G,0.0,2848237879730,148000,148000,0,0,0,ngon
180028677,"Đặc Sản Cà Mau - Tôm Khô Đất Sống Phơi Thượng Hạng, Tôm Khô Cà Mau Chính Hiệu - Hộp 250g",2.0,1310278137823,690000,690000,0,0,1,ngon
179712707,"(Combo 02 chai) Nước Mắm Tĩn Cá Cơm Vàng Ruột Đỏ Độ Đạm 60N Tự Nhiên Chai Thuỷ Tinh 250ml Nước Mắm Rin Nguyên Chất Truyền Thống Sạch Nước Mắm Nhỉ Từ Thùng Lều Gỗ Cốt Nhĩ Đặc Biệt Cá Cơm Vàng Ruột Đỏ Muối Tinh Khiết, Sánh Đặc Thịt Cá, Không Chất Bảo Quản",4.0,9250791357155,360000,360000,0,0,2,ngon
177502103,Sữa tắm gội Coast Classic Scent 946ml Nhập khẩu USA [Ảnh thật],0.0,6019890364302,156500,156500,0,0,0,ngon
177221321,Khăn giấy lụa Lency gói 1 kg tiết kiệm ( 2 lớp ),0.0,6813469496162,73500,73500,0,0,0,ngon
176063150,LƯƠN LÀM SẠCH CẮT KHÚC NHẤT TÂM 500G,2.0,2653433385649,176000,176000,0,0,0,ngon
174598801,[Chỉ giao HCM] Khoai Tây Cắt Múi Cau Farm Frites 1kg,0.0,6619486124364,89000,89000,0,0,0,ngon
174382495,BÀO NGƯ 1KG,0.0,8596956309338,520000,520000,0,0,0,ngon
171795474,[Chỉ giao HCM] Thanh socola đen nguyên chất - Dark Chocolate MAIER Original - Đắng - Công thức Đức,0.0,3285085008567,65000,65000,0,0,0,ngon
169490200,TỎI CÔ ĐƠN CỦ TO - SIZE TRUNG,10.0,8229662960178,139000,139000,0,0,0,ngon
164459053,[Gói lẻ] Cà phê trắng ông già hoà tan Malaysia - Vị Smooth (Ah Huat White Coffee - Smooth),1.0,3729656625042,14000,14000,0,0,0,ngon
163027961,Miến khô  Ottogi Hàn Quốc,1.0,2485802238954,173000,173000,0,0,0,ngon
158713812,01 Thùng/ 12 Hộp 330mL Nước Dừa Xiêm Sen Tươi Nguyên Chất 100% COCOXIM,0.0,9425709670313,228000,228000,0,0,0,ngon
158713798,Hộp Nước dừa Xiêm xanh 100% dừa tươi nguyên chất Cocoxim 1000ml,0.0,9223921532774,39000,39000,0,0,0,ngon
155608680,[Chỉ giao HCM] Một con KHÔ MỰC BẦU (loại 30-40c/kg),0.0,2526262289719,29000,29000,0,0,0,ngon
155532086,"Cherry Đỏ Úc Size 28-30 - Trái căng đỏ, mọng nước, cherry đầu mùa có vị ngọt thanh xen chút chua nhẹ",0.0,9371974898927,699000,699000,0,0,0,ngon
150747633,01 Thùng/ 12 Hộp Sữa Dừa Nguyên Chất Cocoxim 330ml,0.0,8703940777834,228000,228000,0,0,0,ngon
130364481,Phô Mai Mozzarella Tươi 125g,19.0,4778174739580,85000,85000,0,0,2,ngon
129200854,"[Chỉ Giao HCM] Dưa Lưới Nhật Ngon Loại 1 - trái 1,5kg",31.0,5814510556826,75000,75000,0,0,4,ngon
121711249,[Chỉ giao HCM] So African Smoothies Bowl - 500ml ,0.0,2624003792609,79000,79000,0,0,0,ngon
120129623,Sườn rim mặn hộp 0.5kg,20.0,6925488381812,120000,120000,0,0,4,ngon
113449286,[Chỉ Giao HCM]  CÁ HỐ CẮT KHÚC- 500G,2.0,1694179461254,107000,107000,0,0,1,ngon
110346213,[Chỉ giao HCM] - Ba Rọi Heo Không Xương - Belly Boneless Pork - 500gram,2424.0,2522669918964,114000,114000,0,0,367,ngon
103044665,"HCM - Sườn vai heo (500g) - Thích hợp với các món nướng, rim, kho, chiên,... - [Giao nhanh TPHCM]",463.0,3972184936974,39000,39000,0,0,40,ngon
79487450,Combo 2 Chả mực hương vị truyền thống SG Food Hộp 250g,63.0,7898340205529,222000,222000,0,0,17,ngon
70977685,[Chỉ Giao HCM] - CÁ NGỪ ĐẠI DƯƠNG CẮT LÁT 500G,131.0,3374554063482,113000,113000,0,0,13,ngon
64670616,[Chỉ Giao HCM] - TỎI 200G,49.0,3172693513338,27000,27000,0,0,4,ngon
62334608,[Chỉ Giao HCM] - GÀ TA GÒ CÔNG NỬA CON 800G,97.0,2950431090805,162000,162000,0,0,7,ngon
58941259,[Chỉ Giao HCM] - Su su - 500g,24.0,6449813745526,22500,22500,0,0,4,ngon
58941231,[Chỉ Giao HCM] - Bầu hữu cơ Bio-ngon - 500g,36.0,1255953755623,45000,45000,0,0,6,ngon
276931791,Mì Ramen Nhật Bản ăn liền ( Itsuki ) Kumamoto Mokkos Dry vị nước tương và xương heo hầm 123g - Kèm gói sốt,0.0,3364490838113,66000,66000,0,0,0,ngon
275277195,"Hộp Quà Hải Sâm Cát Cao Cấp - 14 Con Hải Sâm Sấy Thăng Hoa-Giàu Collage Type 1, Trẻ Hóa Làn Da, Phục Hồi Vết Thương",0.0,5133662126004,2800000,2800000,0,0,0,ngon
274352757,Bánh Sữa Kem Hokkaido Vị VaNi 4 Múi,0.0,5590248487114,90000,90000,0,0,0,ngon
274276293,Bánh Mì Kem B.O.M Phô Mai,0.0,1839307610225,45000,45000,0,0,0,ngon
273243273,"Đặc Sản Nha Trang- Bánh Dừa Nướng Thái Bình, Giòn Không Cứng, Thơm Ngon  Seavy Hộp 230g",1.0,5307832955728,50000,50000,0,0,0,ngon
253275444,LƯỜN CÁ HỒI 1-3CM 500G,0.0,5975939170628,86000,86000,0,0,0,ngon
209617790,ĐỒ CHAY_ĐẬU HỦ HẢI SẢN CHAY 500G,1.0,3502059001795,139000,139000,0,0,0,ngon
207418894,"Bơ đậu phộng  Crunchy 400gr DAN D PAK 100% thành phần tự nhiên, không chất bảo quản, thơm ngon, phù hợp với người ăn kiêng, tiểu đường, tập thể dục thể thao",0.0,7173449722435,75000,75000,0,0,0,ngon
198244254,Khô mực,0.0,5768006038911,1290000,1290000,0,0,0,ngon
196141783,Bào ngư Hàn Quốc tươi size lớn 12-4c/kg,0.0,8922212037758,299000,299000,0,0,0,ngon
191986506,Ức Gà Xông Khói Hàn Quốc Ăn Liền Healthy Tăng Cơ Giảm Cân - Gói 100g,3.0,8167393137405,52000,52000,0,0,1,ngon
191659074,Ức Gà Ăn Liền Vị Tiêu Hàn Quốc,5.0,4906542081367,48000,48000,0,0,2,ngon
189674944,Bào ngư Úc viền xanh (size :18-20 con )- 1kg,0.0,3387871034537,1590000,1590000,0,0,0,ngon
189674938,Bào ngư Chile ( size : 10-12 con)- 1kg,0.0,4368202808314,590000,590000,0,0,0,ngon
189603283,Hải sâm canada tươi( size 14 - 16 con/kg)- Hộp 500gr,0.0,7353343079840,990000,990000,0,0,0,ngon
189603255,Cá hồi Nauy phile ( Khay :500-700g ) - 1kg,0.0,4138531104725,890000,890000,0,0,0,ngon
188503477,Sầu riêng cấp đông nhanh - Sầu Riêng BA ĐẢO,1.0,5279997406701,250000,250000,0,0,0,ngon
186484325,"Ngũ Cốc BAKALLAND Muesli hạt Đậu phộng hạt điều,hạt phỉ,hạnh nhân,hạt óc chó và mật ong 300g ",0.0,1129504180206,106000,106000,0,0,0,ngon
183337986,MỌC NẤM HƯƠNG 250G,0.0,7173476844852,76000,76000,0,0,0,ngon
179733713,[Mua 3 được 6] Mua 3 nước tương shiitake tặng 3 nước mắm shiitake chai nhựa cao cấp 525ml,2.0,2841378211133,720000,720000,0,0,1,ngon
178107879,Bánh Mandu Thịt CJ Bibigo 350g,0.0,8353922618850,54000,54000,0,0,0,ngon
178107857,Bánh Xếp Mandu Hải Sản Bibigo Cj Hàn quốc 350g,0.0,9730634145877,57000,57000,0,0,0,ngon
173836004,Tương Ớt Gochujang Singsong Hàn Quốc 500g,0.0,9177362176601,88600,88600,0,0,0,ngon
173108850,Nước Ép Dứa Malee 1L (Thái Lan),0.0,1401510358173,71400,71400,0,0,0,ngon
171896037,COMBO 5 THỨC ĂN SMART HEART DÀNH CHO CHÓ NHỎ (DƯỚI 12 THÁNG),0.0,3995015430530,145000,145000,0,0,0,ngon
171795495,"[Chỉ giao HCM] THANH BÁNH NĂNG LƯỢNG Chocolate - Gừng, bổ sung năng lượng, hổ trợ đốt mỡ thừa, tinh thần sảng khoái cho người tập luyện thể thao - Công thức Đức - 90g",0.0,9582355550280,95000,95000,0,0,0,ngon
163028124,"Tương trộn chấm, ăn liền Daesang Hàn Quốc",1.0,2823932823016,45000,45000,0,0,0,ngon
163028094,Sốt gà chiên O'Food (120g),1.0,2232976906165,25000,25000,0,0,0,ngon
158713114,Nước dừa Xiêm xanh Cocoxim 330ml 100% nguyên chất dừa tươi - Thương hiệu COCOXIM 330ml,0.0,1831927561477,19000,19000,0,0,0,ngon
146556624,Xúc xích heo xông khói 12-15cm 50g/Smoked pork sausage500GR/PE,0.0,4817299152995,121000,121000,0,0,0,ngon
140536300,Combo 5 gói Phô Mai Vuông Belcube Đủ Vị (15 viên) Hỗ trợ Hệ Miễn Dịch,0.0,3130740481575,207500,207500,0,0,0,ngon
124011780,"[Chỉ Giao HCM] - Thịt Ba chỉ bò Mỹ 1,5-2 li nhúng lẩu- US Beef Short Plate - 500gram",456.0,5448826400583,140000,140000,0,0,57,ngon
114197874,[Chỉ bán HCM] - Bơ lạt Thượng Hạng - NK Ukraine - 150gram,1673.0,7956267200585,36000,36000,0,0,129,ngon
113449280,[Chỉ Giao HCM]  HOÀNH THÁNH TÔM THỊT - 360G,14.0,7841998281924,83000,83000,0,0,4,ngon
110285255,[Chỉ giao HCM] - Thịt Ba chỉ bò Mỹ cắt BBQ - US Beef Short Plate - 500gram,899.0,9654236857690,140000,140000,0,0,148,ngon
64622590,[Chỉ Giao HCM] - HÀNH TÂY 400G,38.0,2153313266767,26500,26500,0,0,0,ngon
61823943,[Chỉ Giao HCM] - NHO XANH ÚC 1KG,32.0,5040495631667,285000,285000,0,0,1,ngon
59310178,[Chỉ Giao HCM] - XƯƠNG CỤC HEO HỮU CƠ FAU 500G,33.0,3746252795406,134000,134000,0,0,1,ngon
59292795,[Chỉ Giao HCM] - Thịt ghẹ tươi Tài Thịnh Phát (150G),7.0,6096343456950,293000,293000,0,0,1,ngon
58941338,[Chỉ Giao HCM] - Xương ống heo hữu cơ FAU - 500g,34.0,1717566962169,134000,134000,0,0,2,ngon
276835122,Mì Soba Kiều Mạch Nhật Bản (Men Sunaoshi) 200g,0.0,4472187190656,45000,45000,0,0,0,ngon
276835100,Mì Udon Nhật Bản Men Sunaoshi 200g,0.0,9970861214527,45000,45000,0,0,0,ngon
275400070,Thịt xay nhiều nạc Meat Master 400g/khay,3.0,9182479956309,68000,68000,0,0,0,ngon
275382256,Vú sữa tím 1kg,0.0,3857364659188,162000,162000,0,0,0,ngon
274844984,Bánh mì que Patê,0.0,4064883419378,8000,8000,0,0,0,ngon
274277356,Bánh Flan phô mai,0.0,4644304407268,20000,20000,0,0,0,ngon
274056132,Sườn Đế Vương Meat Master  (400g/khay),2.0,3898632625028,140700,140700,0,0,0,ngon
273300579,Đặc Sản Nha Trang-Nước Mắm Nhỉ Cá Cơm 584 Loại 40 Độ Đạm Seavy Xách 4 Chai Thủy Tinh,0.0,5780600687703,170000,170000,0,0,0,ngon
262822408,Há cảo ba loại nấm 240gr,4.0,3118939551041,48000,48000,0,0,0,ngon
252138141,Nước Tương Nhật Tokkyu Japanese Soy Sauce Extra {Yamamori} 500ML - Nước Tương Extra Không Chất Bảo Quản,0.0,6079979591771,82000,82000,0,0,0,ngon
225200783,Cá Thu Cắt Khúc ,1.0,4906593582573,110000,110000,0,0,0,ngon
204802823,Pizza gà xốt teriyaky BON 215gr,0.0,2201877503661,59000,59000,0,0,0,ngon
204801729,Bánh bao kim sa 540g,2.0,4075508469006,103000,103000,0,0,0,ngon
192297055,THANH LONG VÀNG HỮU CƠ 1KG,1.0,9571774177016,82000,82000,0,0,0,ngon
189674946,Hải sâm gai vàng ( size 30-40 con)- 1kg,0.0,4864694795996,750000,750000,0,0,0,ngon
189674940,Hải sâm gai vàng ( size 8-12 con)- 1kg,0.0,1914531148176,1090000,1090000,0,0,0,ngon
183343603,Combo 3 cơm chiên hải sản ngũ sắc Sài Gòn Food 200g,36.0,1043942975774,88500,88500,0,0,3,ngon
181456399,"Nước mắm me cao cấp Làng Chài Xưa, nguyên liệu tươi, thơm ngon đặc biệt từ me, tỏi, ớt tươi, chai thủy tinh 300g",0.0,6004374447840,90000,90000,0,0,0,ngon
181107582,Nạc giòn heo tuyển chọn Meat Master ( 400G ) - Giao nhanh,120.0,3094072441076,180800,180800,0,0,10,ngon
178107982,Bánh Mandu Thịt và Bắp CJ Bibigo – Gói 350g,0.0,7014060399045,54000,54000,0,0,0,ngon
178107867,Há cảo mini Cầu Tre gói 500g,0.0,2795970701550,71208,71208,0,0,0,ngon
177221148,Sữa tắm Old Spice Wolfthorn Body Wash 473 ml - Hàng USA,0.0,2088025738245,135500,135500,0,0,0,ngon
174598788,[Chỉ giao HCM] Khoai Tây Cắt Thẳng 10Mm Savepak 2kg,0.0,3048078147787,119000,119000,0,0,0,ngon
174598785,[Chỉ giao HCM] Khoai Tây Cắt Sợi 7Mm Finest 2kg,0.0,7846186678269,159000,159000,0,0,0,ngon
173249430,Pate Gan Cho Chó Từ 01 Tháng Tuổi Thức Ăn Chó Mèo Cấp Nước THE PET VN,0.0,2879750261393,100000,100000,0,0,0,ngon
171095882,Bình gas Petrolimxe van đứng 13kg,0.0,2930237735750,540000,540000,0,0,0,ngon
160562751,Trái thơm - 1 trái,16.0,6092421885080,46000,46000,0,0,0,ngon
147977124,Bào ngư Hàn Quốc sống size lớn (12-14 con/kg),0.0,6028850978108,1090000,1090000,0,0,0,ngon
133720355,Giò heo nấu Tứ xuyên hộp 0.5kg (không cay),4.0,2652976948492,120000,120000,0,0,2,ngon
114186016,[Chỉ bán HCM] - Bắp hoa bò Úc- AUS Beef Heel Muscle - 500gram,713.0,1676800325459,168000,168000,0,0,112,ngon
113402460,Tôm hùm Canada (Alaska) sống size 1kg,1.0,1857159386329,1260000,1260000,0,0,0,ngon
110349652,[Chỉ giao HCM] - Bò Mỹ Xay Us Minced ( Ground) Beef - 500gram,58.0,6125384013022,210000,210000,0,0,11,ngon
103044765,HCM - Chân giò sau heo (Chân/túi) - Thích hợp vói các món hầm/ nấu cháo - [Giao nhanh TPHCM],1231.0,4236369965543,29000,29000,0,0,110,ngon
103044648,"HCM - Đùi gà góc tư (600-800g) - Thích hợp với các món chiên, nướng, kho sả ớt,... - [Giao nhanh TPHCM]",438.0,8106914578689,79000,79000,0,0,36,ngon
92664588,[Chỉ Giao HCM] - TÁO XANH MỸ GRANNY SMITH 1KG,40.0,9857502693206,121000,121000,0,0,2,ngon
87054397,[Chỉ Giao HCM] - XOÀI CÁT HÒA LỘC 1KG,2.0,6172510870418,114000,114000,0,0,0,ngon
64376492,[Chỉ Giao HCM] - Cải thìa hữu cơ 250g,103.0,4142512122736,24000,24000,0,0,12,ngon
59292161,[Chỉ Giao HCM] - Thịt cua sinh thái Tài Thịnh Phát (150G),5.0,9056699674481,385000,385000,0,0,0,ngon
59191518,[Chỉ Giao HCM] - Xà Lách Hữu Cơ 200g,75.0,8737253190982,34000,34000,0,0,8,ngon
58941309,[Chỉ Giao HCM] - Ba rọi rút xương hữu cơ FAU - 500g,31.0,5242050182670,181000,181000,0,0,4,ngon
97894870,Hộp đựng đồng hồ - Hộp đựng 6 đồng hồ bằng gỗ màu nâu,143.0,5078595670347,275000,275000,0,0,33,dong-ho-va-trang-suc
13403838,Đồng hồ nam dây da Casio MTP-1381L-7AVDF,4.0,6640585764801,1401600,1752000,350400,20,1,dong-ho-va-trang-suc
253185542,Dây đồng hồ Da Cá Sấu Nâu Size 12/13/14/15/16/17/18/19/20/21/22/23/24/25/26mm - Dây Đeo Da Cá Sấu Thật 100% - Bảo Hành 12 Tháng,12.0,7925872309208,390000,690000,300000,43,4,dong-ho-va-trang-suc
106966720,"Dây Đồng Hồ Da Bò Thật 100%, Kiếu Cổ Điển, Cao Cấp - Sang Trọng, Mặt Lót Chống Thấm Mồ Hôi, Tích Hợp Lớp Gia Cố Chống Giãn Đặc Biệt, Phụ Kiện Khóa và Chốt Bằng Thép Không Gỉ 316L, Nhiều Màu, Nhiều Size - Hàng Chính Hãng SAIGIO",26.0,6371707370464,999000,999000,0,0,15,dong-ho-va-trang-suc
253236766,Dây đeo đồng hồ da bò màu trắng Size 14/15/16/17/18/19/20/21/22mm - Dây đồng hồ da bò Thật 100% - Bảo Hành 12 Tháng,8.0,5619916586274,245000,449000,204000,45,3,dong-ho-va-trang-suc
271012889,Dây đeo cho Redmi Watch 3 Active (DMI3A),33.0,6832773356660,120000,120000,0,0,6,dong-ho-va-trang-suc
270751693,"Cuộn Dây Thun CO GIÃN màu Đen xỏ vòng hạt chuỗi Dây này là dây thun chuyên xỏ vòng chuỗi màu Đen, có đủ màu Anh Chị đang đeo chuỗi muốn thay dây khác cho vòng thì đặt cuộn Thun chỉ này nhé",18.0,1181975851230,45000,90000,45000,50,2,dong-ho-va-trang-suc
205081199,Vòng trầm tốc kết chỉ đỏ may mắn - Ngọc Quý Gemstones,186.0,4986530777293,15000,15000,0,0,0,dong-ho-va-trang-suc
204190122,Vòng tay phật di lặc phong thủy trầm hương HÀ XÁ vòng đeo tay cặp đôi nam nữ may mắn tài lộc,13.0,2496906754810,199000,398000,199000,50,7,dong-ho-va-trang-suc
204039338,Vòng tay trầm hương trụ trúc 9 trụ 9 tròn đeo tay nam nữ phong thủy may mắn bình an tài lộc Trầm Hương Hà Xá,47.0,1257580720616,150000,300000,150000,50,34,dong-ho-va-trang-suc
244177969,Dây Đồng Hồ Da Cá Sấu Navy Size 18/20/22/24/26mm - Dây Đeo Da Cá Sấu Thật 100% - Bảo Hành 12 Tháng,7.0,9935564552844,490000,840000,350000,42,3,dong-ho-va-trang-suc
214515827,Dây Đồng Hồ Da Cá Sấu Xanh Navy Size 15/17/19/21/23/25mm - Dây Đeo Da Cá Sấu Thật 100% - Bảo Hành 12 Tháng,7.0,8455559018842,490000,840000,350000,42,2,dong-ho-va-trang-suc
249947043,Dây đồng hồ Handmade Da Cá Sấu Navy Chỉ Trắng Size 20/22mm - Dây Đeo Da Cá Sấu Thật 100% - Bảo Hành 12 Tháng,7.0,3799223191564,490000,840000,350000,42,2,dong-ho-va-trang-suc
253193935,Dây đeo đồng hồ Da Cá Sấu Xám Size 19/20/21/22 - Dây Đeo Da Cá Sấu Thật 100% - Bảo Hành 12 Tháng,3.0,4421764311998,390000,690000,300000,43,1,dong-ho-va-trang-suc
250081115,"Dây Đồng Hồ Da Bò Italy Cao Cấp Màu Vàng Bò Size 14/16/18/20/22mm - Dây Da Đồng Hồ Da Bò Thật 100%, Bảo Hành 12T",2.0,5762221065548,345000,640000,295000,46,1,dong-ho-va-trang-suc
204038070,Vòng tay trầm hương mix hoa sen tốc đeo tay nam nữ phong thủy may mắn bình an tài lộc Trầm Hương Hà Xá,52.0,8604195206196,199000,398000,199000,50,35,dong-ho-va-trang-suc
203214526,"Dây cước thun xỏ vòng xâu vòng cước chun làm vòng tattoo choker, thắt vòng đan dây xỏ chuỗi",80.0,6676158506073,10000,10000,0,0,14,dong-ho-va-trang-suc
192880293,"Cuộn dây co giãn xỏ vòng tay, đính cườm, xâu vòng cổ, xâu chuỗi, đàn hồi tốt, siêu bền",379.0,4661686996544,29000,58000,29000,50,51,dong-ho-va-trang-suc
188377253,"Pin LR41 / AG3 / L736F Maxell Nhật Bản 1,5V Vỉ 10 Viên",48.0,3505531473119,55000,55000,0,0,5,dong-ho-va-trang-suc
183037703,Dây Đeo Đồng Hồ Size Nữ 12mm 14mm 16mm 18mm Da Bò Mềm ,22.0,3486391733035,120000,120000,0,0,1,dong-ho-va-trang-suc
253194295,Dây Đeo đồng hồ Da Cá Sấu Đen Chỉ Trắng Size 19/20/21/22 - Dây Đeo Da Cá Sấu Thật 100% - Bảo Hành 12 Tháng,3.0,2613561576904,390000,690000,300000,43,1,dong-ho-va-trang-suc
111306433,"Dây Da Đồng Hồ Cổ Điển, 100% Da Bò Thật, Kiểu Dáng Phẳng Mỏng, Mặt Lót Chống Thấm Mồ Hôi, Tích Hợp Lớp Gia Cố Chống Giãn Đặc Biệt, Phụ Kiện Khóa và Chốt Bằng Thép Không Gỉ 316L - Hàng Chính Hãng SAIGIO",28.0,7126759495046,899000,899000,0,0,10,dong-ho-va-trang-suc
244170573,Dây Đồng Hồ Da Cá Sấu Đen Size 14/16/18/20/22/24/26mm - Dây Đeo Da Cá Sấu Thật 100% - Bảo Hành 12 Tháng,7.0,7173070233751,490000,840000,350000,42,2,dong-ho-va-trang-suc
101936375,Đồng Hồ Nam Casio MTP-V002GL-7B2 Dây Da,1.0,2460335708432,693420,889000,195580,22,1,dong-ho-va-trang-suc
216104520,"Dây Đồng Hồ Da Bò Italy Cao Cấp Màu Đen Size 15/17/19/21/23/25mm - Dây Da Đồng Hồ Da Bò Thật 100%, Bảo Hành 12T ",7.0,5213643409204,390000,640000,250000,39,2,dong-ho-va-trang-suc
178029300,Dây da đồng hồ nam nữ ba bê mỏng BO-07 TRƠN KHÔNG ĐƯỜNG MAY size 10 12 14 16 18 20 22mm nhiều màu,11.0,8939139227032,75000,75000,0,0,1,dong-ho-va-trang-suc
178027547,DÂY ĐÔNG HỒ THÉP LƯỚI KHÔNG GỈ CAO CẤP + TẶNG CHỐT,22.0,4751416506117,53000,53000,0,0,4,dong-ho-va-trang-suc
177929229,"[5 Mét] Dây Chun Tơ Gân Lụa Co Giãn USA Magicline Dùng Xỏ Vòng Tay, Chuỗi Hạt, Trang Sức 0.5MM, Dây Cước - Bead Art",68.0,6090697916043,20000,20000,0,0,8,dong-ho-va-trang-suc
176074126,Khung viền benzen ( bezel ) cho Samsung galaxy Galaxy Watch 4 classic 42mm/ 46mm,11.0,9930265243835,88000,88000,0,0,2,dong-ho-va-trang-suc
176073859,Dây silicon ngàm cong dành cho đồng hồ Samsung Galaxy Watch 4 40mm & Watch 4 44 mm,78.0,6939544822970,59000,59000,0,0,17,dong-ho-va-trang-suc
176072893,Dây Milanese thép dây Huawei GT3 42 mm/ GT3 46mm,15.0,7869946614058,99000,99000,0,0,6,dong-ho-va-trang-suc
176071877,Dây silicon thể thao mềm mại dành cho các loại Đồng hồ Xiaomi Miwatch,10.0,9868930578146,135000,135000,0,0,3,dong-ho-va-trang-suc
161523242,Dây Đeo SILICON dành Cho Huawei Honor Band 6 Chất Lượng cao,54.0,2477124574229,25000,25000,0,0,8,dong-ho-va-trang-suc
161522862,Dây Milanese thép dây galaxy watch 4,39.0,1405504247445,99000,99000,0,0,12,dong-ho-va-trang-suc
150615727,Vòng tay phong thủy đá thạch anh đỏ tỳ hưu thiên nhiên cho Nam Nữ làm trang sức chiêu Tài hút Lộc,5.0,3494177919457,159000,159000,0,0,3,dong-ho-va-trang-suc
145092650,"Dây đồng hồ nato vải dù D121 cỡ 18mm; 20mm, 22mm thoải mái đi trời mưa, lắp cho dây đeo đồng hồ dw rolex hublot orient seiko casio",172.0,4034329104568,49000,55000,6000,11,46,dong-ho-va-trang-suc
144367849,Dây AW da bò Saffiano Bụi Leather D117- Da thật khâu tay thủ công cao cấp - chính hãng,37.0,6820005910402,284000,341000,57000,17,15,dong-ho-va-trang-suc
143960604,Dây đồng hồ da bò Vintage Bụi Leather D111 - Da thật khâu tay thủ công cao cấp - Bảo hành 12 tháng,466.0,9140495429665,209000,327000,118000,36,156,dong-ho-va-trang-suc
106391798,Dây đồng hồ nam nữ size 12mm 14mm 16mm 18mm 20mm 22mm CỰC MỀM,102.0,1083796407583,50000,50000,0,0,29,dong-ho-va-trang-suc
105985711,Nhẫn nam titan đá màu cực đẹp Trang sức Bé Heo BHN115,160.0,5695437930841,61000,61000,0,0,40,dong-ho-va-trang-suc
101660316,Cuộn dây cước chun co dãn để xâu vòng tay,367.0,3308079581573,21000,21000,0,0,74,dong-ho-va-trang-suc
74853731,Dây Da Thay Thế Dành Cho Đồng Hồ Fossil Casio Samsung Huawei Da Bò Thật Dây Handmade - Tặng Kèm Chốt Và Dụng cụ thay,233.0,5634897329941,200000,200000,0,0,82,dong-ho-va-trang-suc
70203275,"Dây đồng hồ da bò trơn, mềm Italy nhiều size tặng chốt và dụng cụ tháo lắp",166.0,5041758970561,130000,130000,0,0,73,dong-ho-va-trang-suc
68428513,Dây Da Đồng hồ Size Nam Da Bò thật [Tặng Hộp Gỗ] - Hàng Việt Nam Xuất Khẩu,22.0,1785173502160,99000,99000,0,0,7,dong-ho-va-trang-suc
68427641,Dây Da Đồng hồ Da Bò thật Size Nữ Nhiều Màu [Tặng Hộp Gỗ],253.0,4433212000654,110000,110000,0,0,100,dong-ho-va-trang-suc
56510780,Bông tai ngôi sao phương Nam,16.0,5649452913596,35000,35000,0,0,0,dong-ho-va-trang-suc
54687717,Dây Đồng Hồ Da Bò Cao Cấp Tặng Kèm Chốt và Dụng cụ,445.0,6104653926947,130000,130000,0,0,154,dong-ho-va-trang-suc
48658720,Hộp đựng đồng hồ da Thời trang,41.0,3484678966184,45000,45000,0,0,11,dong-ho-va-trang-suc
42194457,Bông Tai Nam Nữ Đeo 2 Kiểu Chất Liệu Thép Titan Ko Đen Cao Cấp TT 2076 - 1 Cặp,178.0,9646597797193,68000,68000,0,0,17,dong-ho-va-trang-suc
21754311,Dây đồng hồ da bò có vân cao cấp,1340.0,7422747424889,42000,42000,0,0,428,dong-ho-va-trang-suc
13246837,Bông tai nam titan kẹp vành không cần bấm lỗ xỏ lỗ 2 chiếc,397.0,2512107634517,35000,35000,0,0,82,dong-ho-va-trang-suc
10597090,Bông tai nam Titan cao cấp ,158.0,5486537719502,45000,45000,0,0,36,dong-ho-va-trang-suc
7803174,Bông tai nam inox khuyên tròn 12mm BT233 - 2 chiếc,417.0,6768922051961,35000,35000,0,0,48,dong-ho-va-trang-suc
7802880,Bông tai nam inox khuyên tròn 14mm BT233 - 2 chiếc,498.0,5085260945778,35000,35000,0,0,77,dong-ho-va-trang-suc
107338668,Hộp Đựng Đồng Hồ Cơ 4 Xoay Và 6 Trưng Bày Gỗ Cao Cấp,70.0,8131876955949,1350000,1350000,0,0,14,dong-ho-va-trang-suc
273682676,[BH 2 Năm Động Cơ] Hộp Đựng Đồng Hồ Cơ 4 Xoay Và 6 Trưng Bày Gỗ Sơn Bóng,1.0,7633780239991,1450000,1450000,0,0,0,dong-ho-va-trang-suc
276280497,Bông tai cỏ 4 lá tourmaline 11mm - Ngọc Quý Gemstones,1.0,9457047302143,799000,1140000,341000,30,0,dong-ho-va-trang-suc
275347598,Dây da dây chuyền đeo cổ khóa inox đen cao cấp -  Ngọc Quý Gemstones,9.0,3363136675812,40000,40000,0,0,1,dong-ho-va-trang-suc
275168446,￼Hộp Xoay Đồng Hồ Cơ Dành Cho 3 Chiếc Chất Liệu Da,8.0,9033896159062,450000,450000,0,0,2,dong-ho-va-trang-suc
272367367,VÒNG CỔ CHUỖI HẠT GỖ CHỦNG TỰ KALACHAKRA VÀ NGỌC LAM TÂY TẠNG,2.0,4146012433164,140000,140000,0,0,1,dong-ho-va-trang-suc
272123890,Dây đeo cho Huawei Watch 4/ 4 Pro/ 3/ 3 Pro/ GT4/ GT5/ GT3/ GT3 Pro/ GT2/ Buds/ GT/ GT Runner/ GT2e (DC),15.0,6373008064097,139000,139000,0,0,1,dong-ho-va-trang-suc
249262734,Dây Đồng Hồ Đeo Tay Daniel_Watch Da Bò Màu Nâu Đậm Tặng Kèm Hộp Gỗ và Phụ kiện,4.0,4194631548990,180000,180000,0,0,1,dong-ho-va-trang-suc
229697149,Dây silicon trơn dành cho các loại đồng hồ cơ và Smartwatch size 20mm,12.0,9400776570977,66000,66000,0,0,2,dong-ho-va-trang-suc
229696872,Dây đồng hồ silicon khoá nam châm dành cho Xiaomi Miwatch / S1 / S1 Active,25.0,2216621920778,115000,115000,0,0,6,dong-ho-va-trang-suc
192706493,Nhẫn bạc nữ thời trang chất liệu bạc s925 MS041,6.0,4095182745314,80000,80000,0,0,2,dong-ho-va-trang-suc
190551808,Pin Nhật Maxell SR616SW / SR616 / 321 Chính Hãng 1 Viên,15.0,9317772400054,25000,25000,0,0,5,dong-ho-va-trang-suc
185169212,Vòng tay phong thủ kết dây thủ công 100% mẫu mới,4.0,4629646947814,99000,99000,0,0,2,dong-ho-va-trang-suc
178028585,DÂY ĐỒNG HỒ DA BÒ THẬT DẬP VÂN CÁ SẤU BỀN ĐẸP (NHIỀU SIZE),19.0,3965266028244,49000,49000,0,0,1,dong-ho-va-trang-suc
165706461,Combo Vòng đeo tay Trầm Hương - Chuỗi tràng 108 Hạt Gỗ và Lá Bồ Đề Dát Vàng Kèm Hộp Gấm Cao Cấp - Phong thủy,6.0,2830025834366,95000,95000,0,0,1,dong-ho-va-trang-suc
163476321,Dây đồng hồ HAVIAS Classy,2.0,8581542610772,435000,435000,0,0,1,dong-ho-va-trang-suc
161523095,Dây vải thể thao dành cho đồng hồ Samsung galaxy watch 3 41 mm và 45mm,26.0,4387471786987,149000,149000,0,0,3,dong-ho-va-trang-suc
161522863,Dây Ceramic dành cho Huawei Watch GT3 42mm Và GT3 46mm,4.0,6817655071233,400000,400000,0,0,0,dong-ho-va-trang-suc
145167618,"Dây đồng hồ AW lynon cao cấp D127 thoải mái đi trời mưa, dây AW series 3, 4, 5, 6, SE, size 38mm-40mm-42mm-44mm",116.0,9794197696618,39000,41000,2000,5,39,dong-ho-va-trang-suc
144355714,Dây đồng hồ dành cho AW da cá sấu đốt tre D108 - Da thật khâu tay thủ công cao cấp,25.0,2675844724215,279000,368000,89000,24,12,dong-ho-va-trang-suc
111039158,"Nhẫn inox bản mo tròn 4mm đẹp, khồng đen, hợp thời trang",3.0,8881458358406,19000,19000,0,0,0,dong-ho-va-trang-suc
106393508,Khoá đồng hồ dây da inox đủ size màu vàng giá rẻ nhất thị trường,4.0,2532213714145,18000,18000,0,0,0,dong-ho-va-trang-suc
106392741,Dây đồng hồ vân cá sấu nam nữ các màu,9.0,4414516613791,120000,120000,0,0,1,dong-ho-va-trang-suc
106392394,Bộ dụng cụ ép đáy đồng hồ cơ bản,14.0,1298212136273,185000,185000,0,0,2,dong-ho-va-trang-suc
106391733,"Dây da đồng hồ cực mềm, dây chống nước đủ size 12 đến 20mm",5.0,5999044249989,228000,228000,0,0,1,dong-ho-va-trang-suc
104717961,Mặt Dây Chuyền Hình Vuông Chữ Nhật Đá Ngọc Bích Nephrite Thiên Nhiên,1.0,8621335553922,1751000,1751000,0,0,0,dong-ho-va-trang-suc
93275231,Lắc chân bi chất liệu bạc s925 MS15m,6.0,8659325432571,236000,236000,0,0,1,dong-ho-va-trang-suc
87451745,Mặt dây chuyền 12 con giáp phong thủy đá mắt hổ,7.0,8578330355002,190000,190000,0,0,1,dong-ho-va-trang-suc
82921772,"Vòng đeo tay, lắc tay hoa ưu đàm phong thủy đá san hô hóa thạch",2.0,5385587405911,250000,250000,0,0,1,dong-ho-va-trang-suc
82877750,Dây đeo cổ dạng rút điều chỉnh kích thước - Ngọc Quý Gemstones,130.0,4066201359321,20000,40000,20000,50,15,dong-ho-va-trang-suc
82412659,Dây Đồng Hồ Size 20mm 22mm Khóa Nam Châm Lưới Thép Thép Không Gỉ ,3.0,2141387640275,69900,69900,0,0,0,dong-ho-va-trang-suc
78503804,"Bó 10m-20m dây tim bóng handmade loại 1,5mm - Dây vải bóng 1.5mm để đan vòng, thắt dây handmade - Ngọc Quý Gemstones",306.0,4962148215175,13000,26000,13000,50,116,dong-ho-va-trang-suc
59263751,"Lắc tay bạc đá thạch anh dâu phối charm lông vũ mệnh hỏa, thổ - Ngọc Quý Gemstones",12.0,9349888857124,399000,590000,191000,32,2,dong-ho-va-trang-suc
57137196,Combo charm bạc chuông mặt treo - Ngọc Quý Gemstones,5.0,9825283583016,142000,152000,10000,7,3,dong-ho-va-trang-suc
56383050,Đồng Hồ Pin Bỏ Túi Cổ Điển Retro Năm Tuổi 12 Con Giáp Tuổi Dân Hổ Tặng Kèm 2 Pin,39.0,9505008686023,123000,123000,0,0,14,dong-ho-va-trang-suc
46289675,Bông Tai Nam Châm Đính Đá Màu Titan Không Đen TT 2445 – 1 Cặp,210.0,8505524175774,49000,49000,0,0,33,dong-ho-va-trang-suc
28631184,Dây chuyền nữ dáng dài lá dây ngọc trai,46.0,5240529629954,143000,143000,0,0,6,dong-ho-va-trang-suc
26736320,BÔNG TAI CÚC TÒNG TENG NHỎ,5.0,4030474838744,75000,75000,0,0,4,dong-ho-va-trang-suc
22194676,Bông tai ngọc trai,44.0,4794160865086,49000,49000,0,0,7,dong-ho-va-trang-suc
15940723,Khuyên tai nam kẹp vành bản dày không cần bấm lỗ,152.0,3756506859044,80000,80000,0,0,12,dong-ho-va-trang-suc
276392644,Dây cho Garmin Fenix 8/ 7/ 7S/ 6/ 6S/ 5/ 5S/ 3/ Quatix 7/ Instinct 2/ 2S/ Forerunner 965/ 955/ 945/ 935 (DGM4),16.0,7325011867892,199000,199000,0,0,3,dong-ho-va-trang-suc
273682629,[BH 2 Năm Động Cơ] HỘP XOAY 4 ĐỒNG HỒ CƠ DÁNG NGANG,2.0,8096651241093,1800000,1800000,0,0,0,dong-ho-va-trang-suc
273082792,Bông tai bạc khuyên tròn thời trang chất liệu bằng bạc s925 MS060c,1.0,1953740989661,106000,106000,0,0,1,dong-ho-va-trang-suc
271711821,Thẻ Thay Pin Miễn Phí Trọn Đời tại TP-Watch | Battery Replacement Card,46.0,4216123896098,650000,650000,0,0,0,dong-ho-va-trang-suc
270267544,DÂY CHUYỀN VÒNG CỔ THIÊN CHÂU DZI TÂY TẠNG 9 MẮT KÈM HỘP VÀ GIẤY CHỨNG NHẬN,3.0,2907054531968,350000,350000,0,0,0,dong-ho-va-trang-suc
249288616,Đồng Hồ Thể Thao Cao Cấp MR 8215 Chính Hãng KHÔNG VÔ NƯỚC Đồng Hồ Điện Tử Dành Cho Bé Trai Bé Gái ,7.0,6548253663080,159000,159000,0,0,2,dong-ho-va-trang-suc
216203382,Đồng bạc ta nguyên chất dùng để đánh cảm,9.0,9059564701189,178000,178000,0,0,1,dong-ho-va-trang-suc
212489482,Hộp Xoay Đồng Hồ Cơ SAIKE SAIKE S4602 Mẫu 4 Xoay 6 Tĩnh Vỏ Da Cá Sấu Màu Đen Sang Trọng,20.0,9293314252069,1290000,1290000,0,0,2,dong-ho-va-trang-suc
208645385,Dây da đồng hồ dành cho Amazfit GTR4 / GTS4,8.0,6650394869949,195000,195000,0,0,0,dong-ho-va-trang-suc
203222510,"Quà tặng trang sức , Đồng hồ nữ cao cấp",1.0,4802715838465,380000,380000,0,0,0,dong-ho-va-trang-suc
187513909,Khóa đồng hồ MS07 thép không gỉ dùng cho dây da SIZE 18 20 22 24mm (Màu Đen-Màu Bạc),14.0,4832385946990,19000,19000,0,0,0,dong-ho-va-trang-suc
184475923,"Đồng Hồ Thể Thao Nam SKMEI 1416, 1426 Đồng Hồ Kỹ Thuật Số Chống Nước, Đồng Hồ Đeo Tay Thời Trang Báo Thức Đếm Ngược",34.0,5551428884564,139000,139000,0,0,7,dong-ho-va-trang-suc
184317339,Nhẫn titan unisex,1.0,8272854439485,85000,85000,0,0,1,dong-ho-va-trang-suc
177896565,Dây đồng hồ caosu silicon size dây 20/22mm,34.0,1106887866680,84000,84000,0,0,7,dong-ho-va-trang-suc
176742982,Bông tai bạc thời trang tua đá chất liệu bằng bạc s925 MS45d,2.0,7472698287620,88000,88000,0,0,2,dong-ho-va-trang-suc
170496556,Vòng đeo tay chuỗi hạt 108 hạt gỗ đỏ hồng phong thủy niệm Phật,31.0,6021329189363,54000,54000,0,0,3,dong-ho-va-trang-suc
169577869,Đồng hồ nam DEYROS thiết kế thể thao dây thép lưới đen chạy lịch ngày cao cấp Sporty Design,61.0,3821999423620,99000,198000,99000,50,15,dong-ho-va-trang-suc
161523475,Dây silicon thể thao mềm mại dành cho các loại đồng hồ size dây 20/22mm,26.0,9966161165782,135000,135000,0,0,4,dong-ho-va-trang-suc
150150734,Dây đeo cho Garmin Forerunner 165/ 55/ 245/ 255/ 645/ Venu 2/ SQ 2/ SQ/ Vivoactive 5/ 4/ 3 (DG),117.0,5925393867622,180000,180000,0,0,16,dong-ho-va-trang-suc
145763594,"10 Viên Pin Maxell AG10 LR1130 LR54 Cúc Áo 1,5V Nhật Bản",168.0,6115072971235,55000,55000,0,0,18,dong-ho-va-trang-suc
143839272,Dây đồng hồ nam da đà điểu Bụi Leather D104 - Da thật khâu tay thủ công cao cấp - Bảo hành 12 tháng,105.0,9017143655224,259000,350000,91000,26,35,dong-ho-va-trang-suc
110868875,Dây Da Thay Thế Dành Cho Đồng Hồ Fossil Casio Samsung Huawei Da Bò Thật Dây Handmade ,74.0,5369637943696,200000,200000,0,0,27,dong-ho-va-trang-suc
106392561,Dây đồng hồ kim loại dạng lưới mắt khúc khóa bướm,15.0,9445577189148,304000,304000,0,0,4,dong-ho-va-trang-suc
106390688,Dây Đồng Hồ Vải Dù Zulu Nato size 18mm 20mm,8.0,6044137103179,63699,63699,0,0,1,dong-ho-va-trang-suc
106390658,Máy Ép Đáy Đồng Hồ ẢNH THẬT 100% KHÔNG ĐÚNG HOÀN TIỀN,3.0,1468840223060,169999,169999,0,0,1,dong-ho-va-trang-suc
106390567,Gói gioăng đáy đồng hồ dùng trong sửa chữa đồng hồ,21.0,1266327339882,20000,20000,0,0,3,dong-ho-va-trang-suc
106149876,Nhẫn titanium phim Chúa tể những chiếc nhẫn BHN76-1,21.0,6122984322889,60000,60000,0,0,11,dong-ho-va-trang-suc
97902261,Hộp đựng đồng hồ - Hộp đựng 12 đồng hồ 2 hàng bằng gỗ màu nâu,84.0,6118395489957,375000,375000,0,0,26,dong-ho-va-trang-suc
93819008,"Dây Thun Co Giản, Dây Cước Đàn Hồi Xỏ Chuỗi Hạt size 1mm dài 100m",271.0,5112223701216,57000,68000,11000,16,38,dong-ho-va-trang-suc
92964825,Charm bạc khoen tròn kín - Ngọc Quý Gemstones,7.0,4344965995029,11000,11000,0,0,0,dong-ho-va-trang-suc
84738196,Dây chuyền inox nam dạng xích - Ngọc Quý Gemstones,10.0,1673204657857,49000,90000,41000,46,2,dong-ho-va-trang-suc
68785171,Nhẫn nữ titan không đen bản nhỏ one love ( 1 chiếc ),231.0,1513829614079,54000,54000,0,0,62,dong-ho-va-trang-suc
58324319,Dây đồng hồ nibosi lưới thép khoá nam châm hít,43.0,9905444953640,99000,99000,0,0,13,dong-ho-va-trang-suc
54925075,"Dây đồng hồ da bò loại mỏng, trơn mờ",107.0,5720210857885,130000,130000,0,0,36,dong-ho-va-trang-suc
52468904,Bông tai nam châm - mẫu ngọc trai - đính đá đen - đính đá trắng,34.0,3392353701039,49000,49000,0,0,3,dong-ho-va-trang-suc
46242612,Vòng tay nam phong thủy may mắn (đá Obsidian với tỳ hưu vàng),56.0,9010194701608,60000,60000,0,0,16,dong-ho-va-trang-suc
37139753,Bông Tai Nam Nữ 1 Hạt Đá  Chất Liệu Thép Titan Không Đen Không Dị Ứng TT 1689,324.0,4274707473092,39900,39900,0,0,70,dong-ho-va-trang-suc
23250421,VÒNG THẠCH ANH TÍM 12LY  ĐÁ TỰ NHIÊN NAM NỮ MẠNG  HOẢ THỔ ,1.0,9977139688472,528000,960000,432000,45,1,dong-ho-va-trang-suc
22079638,Bộ trang sức 2 món trái tim BHB64,6.0,6459776852889,59000,59000,0,0,1,dong-ho-va-trang-suc
12271701,Vòng Tay Tỳ Hưu Đá Mắt Hổ 14MM,6.0,6389505742207,167280,328000,160720,49,1,dong-ho-va-trang-suc
276583236,Dây đeo cho Samsung Watch 7/ 6/ 5/ 4/ 3/ FE (DNC3),6.0,9151526273647,149000,149000,0,0,0,dong-ho-va-trang-suc
275807052,(Không độn) Dây đồng hồ da bò thật vân Epsom phom mỏng BO-79 cao cấp size 10 12 13 14 15 16 17 18 19 20 21 22mm,5.0,4643501989268,59000,59000,0,0,0,dong-ho-va-trang-suc
274936493,Dây da đồng hồ P31 dập vân cá sấu không thấm nước size 12 14 16 18 20 22mm Phụ kiện đồng hồ,3.0,8101790841692,19000,19000,0,0,0,dong-ho-va-trang-suc
272123027,Dây đeo cho Garmin Forerunner 165/ 265/ 265S/ 255/255S/ 245/ 645/Vivomove/ Vivoactive 3/4/ 5/ 6/ 2S/3S/4S/ Venu 2/ SQ2 (DC),24.0,8350413412182,139000,139000,0,0,2,dong-ho-va-trang-suc
260939911,"Pin CR2032 Hàng Nhật Bản Cao Cấp, Pin Chìa Khoá Xe Máy, Ô tô, PC [Viên Rời]",41.0,1606792101508,30000,30000,0,0,1,dong-ho-va-trang-suc
248901461,Dây Đeo Đồng Hồ Vải Dù Nato - Dây Đồng Hồ Nam 18mm 20mm 22mm,11.0,2319163951092,64999,64999,0,0,3,dong-ho-va-trang-suc
229696985,Dây đồng hồ Silicon 22mm Smartwatch và đồng hồ cơ,5.0,4578102491586,95000,95000,0,0,0,dong-ho-va-trang-suc
208644838,Dây đồng hồ smartwatch silicon size dây 20mm và 22mm,41.0,1165579480510,145000,145000,0,0,8,dong-ho-va-trang-suc
202203813,Pin CR2032 Nhật Bản Hàng Cao Cấp 3V Date 2032,35.0,4247704755333,55000,55000,0,0,2,dong-ho-va-trang-suc
199007435,"Vòng Đeo Cổ Dây Dù 3MM Size Nhỏ Nhiều Màu Bền Đẹp, Chắc Chắn",15.0,7434251244089,29000,29000,0,0,0,dong-ho-va-trang-suc
197792505,Dây Đeo Cao Su Xiaomi Miband 7 / Mi band 7 hoạ tiết xinh xắn Chất Lượng cao,5.0,3523670233598,39000,39000,0,0,0,dong-ho-va-trang-suc
189587846,"Chuỗi hạt đeo tay niệm phật gỗ Đàn Hương Xanh Ấn độ, điêu khắc hình Phật, kèm hộp đựng Cẩm tú",4.0,4886277703108,111180,218000,106820,49,0,dong-ho-va-trang-suc
186590679,Mặt dây chuyền Hồ Ly phong thủy đá mã não,35.0,4638964061031,200000,200000,0,0,3,dong-ho-va-trang-suc
178029964,Dây đồng hồ da bò cao cấp OULANG nhiều size kèm khóa bướm ĐÔi thép không gỉ 316L (Khóa Vàng hồng),21.0,8528941422607,132000,132000,0,0,3,dong-ho-va-trang-suc
177488107,"Đồng hồ thể thao nam CITIPLUS . Model: X-CAPTAIN T-1 chất lượng cao, chống nước, kiểu dáng sang trọng, mạnh mẽ.",27.0,1395012040261,145000,145000,0,0,6,dong-ho-va-trang-suc
176073123,Dây silicon thể thao mềm mại dành cho các loại đồng hồ size dây 20/22mm,14.0,4348952755596,135000,135000,0,0,2,dong-ho-va-trang-suc
153066111,5 Viên Pin Đồng Hồ SR626 / SR621 / SR716 / SR521 / SR616 / SR516 / SR721 / SR920 / SR927 Maxell Chính Hãng,33.0,2129318306944,65000,65000,0,0,8,dong-ho-va-trang-suc
150602678,Dây đeo Xiaomi Redmi Watch 2 Lite (DMILI2),134.0,5949556939111,120000,120000,0,0,26,dong-ho-va-trang-suc
145763569,"10 Viên Pin Maxell LR44 AG13 L1154 Cúc Áo 1,5V Nhật Bản",215.0,9756342595683,55000,55000,0,0,28,dong-ho-va-trang-suc
145763567,Dây Mesh Lưới Cho Đồng Hồ Fossil Casio Samsung Huawei [Tặng Chốt thông minh & Dụng cụ tháo lắp],15.0,4797489184225,130000,130000,0,0,5,dong-ho-va-trang-suc
145763559,Combo 2 Vỉ 20 viên Pin Đồng Hồ Đeo Tay AG1 / LR621 / 364 / SR621 / 164,15.0,4414210349275,17000,17000,0,0,4,dong-ho-va-trang-suc
144321607,Cuộn dây chỉ tơ xỏ chuỗi,81.0,2845950094300,38000,38000,0,0,11,dong-ho-va-trang-suc
117006925,Nhẫn bạc nữ đính đá chất lệu bạc s925 MS66b,14.0,5909724519869,120000,120000,0,0,4,dong-ho-va-trang-suc
114673118,Khóa Đồng Hồ Thay Thế Dành Cho Hublot - Khoá Tự Động Cao Cấp,24.0,9398057379093,249000,249000,0,0,5,dong-ho-va-trang-suc
113403111,"Dây Chun Xâu Vòng Tay, Chuỗi Hạt - Dây Co Giãn 4 Chiều Cực Kì Bền Chắc - (5 MÉT )",343.0,1439884792978,90000,90000,0,0,59,dong-ho-va-trang-suc
106393775,(TẶNG DỤNG CỤ THAY DÂY VÀ CHỐT DÂY)Dây đồng hồ thép lưới (dây Mesh) hàng nhập khẩu loai mắt to dày 1.8mm cao cấp,11.0,8868929911757,120000,120000,0,0,1,dong-ho-va-trang-suc
106392676,(TẶNG KÈM CHỐT VÀ DỤNG CỤ THAY DÂY) Dây đồng hồ kim loại đúc đặc size 19mm 21mm,26.0,3173150615933,160000,160000,0,0,5,dong-ho-va-trang-suc
106390176,Dây Đồng Hồ Cao Su Mềm Chống Nước Thay Thế Cho Đồng Hồ Đeo Tay,102.0,3277476160340,65000,65000,0,0,33,dong-ho-va-trang-suc
106107764,Nhẫn titan nam nữ - nhẫn nam bền màu - Trang sức Bé Heo BHN119,59.0,4380688781147,32000,32000,0,0,25,dong-ho-va-trang-suc
97902357,"Hộp xoay đồng hồ 4 chế độ xoay - Hộp đựng 2 đồng hồ cơ, lên dây cót đồng hồ cơ",250.0,2042451772289,859000,859000,0,0,57,dong-ho-va-trang-suc
92817188, Khuyên Tai Nam Không Cần Bấm Lỗ - Bông Tai Kẹp Titan,95.0,1024352287445,18000,18000,0,0,17,dong-ho-va-trang-suc
82412853,Dây Da Đồng Hồ Size 18mm 20mm 22mm Da Bò thật ,90.0,2495366110588,110000,110000,0,0,26,dong-ho-va-trang-suc
81319726,Đồng Hồ Nam Chính Hãng ECONOMICXI Dây Thép Mành Đen Kích Thước Mặt 40mm Có Lịch Ngày - Thiết Kế Nam Tính ECNTA23,8.0,4357366591942,99000,198000,99000,50,1,dong-ho-va-trang-suc
66485690,Vòng cổ choker phối ren cá tính,9.0,5632771931167,25000,25000,0,0,2,dong-ho-va-trang-suc
56046483,Bông tai ngọc hoa BHBT354,8.0,8545305675376,94000,94000,0,0,2,dong-ho-va-trang-suc
46242432,Dây chuyền nam,190.0,2826895421526,45000,45000,0,0,42,dong-ho-va-trang-suc
41556614,Bông Tai Nam Khuyên Tròn Chất Liệu Thép Titan Ko Rỉ TT 0850 - 1 Cặp,139.0,8770385021410,34000,34000,0,0,38,dong-ho-va-trang-suc
31604663,Bông tai dài hình tròn 2 tua BHBT254,6.0,8981864830809,49000,49000,0,0,0,dong-ho-va-trang-suc
26318814,Dây chuyền nam mạ vàng 24k ô vuông cá tính,27.0,1504054520006,100000,100000,0,0,5,dong-ho-va-trang-suc
7809362,Mặt Phật Văn Thù Bồ Tát thạch anh đỏ 3.6cm - Phật bản mệnh tuổi Mão,11.0,7193171225303,200000,200000,0,0,6,dong-ho-va-trang-suc
274504009,Đồng hồ nam Hublot - nam size 42mm - DH201 - Được Cung Cấp Bởi AmandaC Life,13.0,9617128586997,299000,299000,0,0,4,dong-ho-va-trang-suc
205550381,Dây chuyền cao su khóa titan cao cấp - Ngọc Quý Gemstones,35.0,5488702517170,60000,60000,0,0,7,dong-ho-va-trang-suc
201282396,Vỉ 5 Viên Pin SR621SW / 364 Maxell 1.55V Cho Đồng Hồ Đeo Tay,0.0,7208517721814,55000,55000,0,0,0,dong-ho-va-trang-suc
196207747,Dây silicon cao dấp dành cho Garmin Venu/ Garmin Venu 2,15.0,2213229553688,84000,84000,0,0,3,dong-ho-va-trang-suc
194498823,Nhíp bằng thép không gỉ sửa chữa thủ công Tiện ích DIY điện tử nhíp chính xác nhọn khuỷu tay nhọn miệng nhíp nhỏ,8.0,7837978539070,17000,17000,0,0,0,dong-ho-va-trang-suc
190482192,Bông tai bạc nụ đá chốt ren chất liệu bạc s925 MS075,2.0,9270521393854,160000,160000,0,0,1,dong-ho-va-trang-suc
182112726,Bông tai bạc 3 tua trai chất liệu bạc s925 MS65t,1.0,5034124936007,115000,115000,0,0,0,dong-ho-va-trang-suc
179438678,Lắc tay bạc nữ MS80,13.0,3513791503322,140000,140000,0,0,9,dong-ho-va-trang-suc
176071848,Dây da hydrid 20mm dành cho Samsung galaxy watch 4,8.0,7308476635651,198000,198000,0,0,2,dong-ho-va-trang-suc
161523391,Dây đồng hồ cao su silicon cao dấp dành cho Xiaomi Mi watch,51.0,8584700647358,58800,58800,0,0,18,dong-ho-va-trang-suc
161522894,Dây vải thể thao 20mm dành cho đồng hồ Samsung galaxy watch 4,22.0,4852023451494,149000,149000,0,0,3,dong-ho-va-trang-suc
153470235,Vòng cổ dây chuyền thời trang gắn hạt đá phong thủy thiên nhiên cho Nam và Nữ,14.0,9136311842934,39000,39000,0,0,3,dong-ho-va-trang-suc
144366976,Dây đồng hồ dành cho AW da bò Vintage D116 - Hàng khâu tay thủ công cao cấp,91.0,2030512671874,284000,341000,57000,17,40,dong-ho-va-trang-suc
130787676,Lắc tay nữ thời trang chất liệu bạc s925 MS85t,21.0,8108558258576,168000,168000,0,0,8,dong-ho-va-trang-suc
118787623,Dây Da Đồng Hồ Daniel Sheffield Tặng kèm Hộp gỗ,44.0,7221246491585,180000,180000,0,0,9,dong-ho-va-trang-suc
115719867,Dây chuyền vòng cổ ngọc trai nhân tạo đơn giản nam nữ unisex phong cách,15.0,2551803867870,75000,75000,0,0,2,dong-ho-va-trang-suc
114912009,Bông tai khuyên tai tròn nam châm basic không cần bấm lỗ unisex,19.0,1392027420423,35000,35000,0,0,3,dong-ho-va-trang-suc
111695904,Lắc tay nữ cỏ 4 lá chất liệu bạc s925 MS155c,67.0,1382116498332,274000,274000,0,0,30,dong-ho-va-trang-suc
111041041,"DÂY CHUYỀN CAO SU 2LY KHÓA INOX KHÔNG ĐEN rẻ, đẹp mà chất",4.0,3713696505962,29000,29000,0,0,2,dong-ho-va-trang-suc
110789392,Bông tai mặt cỏ 4 lá chất liệu bạc s925 MS05a,11.0,4114260836482,89000,89000,0,0,5,dong-ho-va-trang-suc
106394081,Dây đồng hồ kim loại inox đúc 5 hạt đúc đặc đầu ôm và đầu bằng,28.0,7247823353786,199500,199500,0,0,10,dong-ho-va-trang-suc
106393440,Dây da đồng hồ nam và nữ dây cá sấu ép,7.0,9145709820237,85500,85500,0,0,3,dong-ho-va-trang-suc
102143192,Nhẫn bạc ta mặt hồ ly free size nhiều màu,15.0,2327873874577,97000,97000,0,0,4,dong-ho-va-trang-suc
102143155,Dây chuyền nữ 2 trong 1 bạc Ý si vàng MS19d,19.0,1947010152377,283000,283000,0,0,6,dong-ho-va-trang-suc
97899787,Hộp đựng đồng hồ - Hộp đựng 10 đồng hồ bằng gỗ màu nâu,73.0,7715583282594,345000,345000,0,0,20,dong-ho-va-trang-suc
89878871,Bông tai nữ thời trang chất liệu bằng bạc Ý tua dài MS135,14.0,7401316990954,240000,240000,0,0,3,dong-ho-va-trang-suc
82832880,Dây Thép Đồng Hồ 2 Trong 1 Thép Đặc Không Gỉ [Tặng Chốt + Dụng cụ tháo lắp],77.0,1716472065344,160000,160000,0,0,29,dong-ho-va-trang-suc
82412636,Dây Da Đồng Hồ Da Bò Italy Mềm - Tặng Kèm Chốt Gắn và Dụng cụ tháo lắp,22.0,4439730972578,110000,110000,0,0,9,dong-ho-va-trang-suc
67173628,Pin Đồng hồ đeo tay Maxell SR626SW 1.55V 377,728.0,7363156737972,55000,55000,0,0,180,dong-ho-va-trang-suc
58047528,Đồng hồ nam chính hãng Lobinni No.16003,3.0,8328219059285,7650000,7650000,0,0,2,dong-ho-va-trang-suc
56347059,Bông tai khuyên tai hoa tai nữ thời trang set 7 đôi,43.0,5254225429176,57000,57000,0,0,10,dong-ho-va-trang-suc
55611004,"Bông tai nam khuyên tròn Hàn Quốc, đơn giản, nam tính, nhiều mẫu",66.0,2326555462468,56000,56000,0,0,11,dong-ho-va-trang-suc
54900013,Vòng Tay Trầm Hương Trụ Trúc Sánh Chìm Tự Nhiên (Nam),3.0,2509017518693,811000,811000,0,0,0,dong-ho-va-trang-suc
54717885,Pin Đồng Hồ Maxell Nhiều Kích cỡ Vỉ 5 viên,168.0,2956692038396,55000,55000,0,0,50,dong-ho-va-trang-suc
46651646,Vòng tay mã não đen mảnh mệnh thủy mộc - Ngọc Qúy Gemstones,9.0,7382930590220,169000,169000,0,0,2,dong-ho-va-trang-suc
32492139,Dây Đồng Hồ Da Bò Khóa Bướm Hộp Đựng Bằng Gỗ Cao Cấp YE-003G,108.0,9369270990734,135000,135000,0,0,17,dong-ho-va-trang-suc
21471019,VÒNG ĐIỀU HÒA HUYẾT ÁP NHẬT BẢN - ND16,5.0,7762516916567,599000,599000,0,0,1,dong-ho-va-trang-suc
9850682,Đồng Hồ Casio Nam Dây Da Phối Vải AE-1200WHB-3BVDF,42.0,2896387490866,912000,1347000,435000,32,15,dong-ho-va-trang-suc
274525195,Đồng hồ nam SRWATCH SG3008.4101CV,1.0,4428691320002,1050000,1050000,0,0,0,dong-ho-va-trang-suc
229697030,Dây đồng hồ smartwatch silicon khoá nam châm size dây 20mm và 22mm,16.0,1129806154581,115000,115000,0,0,1,dong-ho-va-trang-suc
196207305,Miband 7 - Dây đeo Milanese thép lưới Xiaomi Mi band 7,31.0,2611094311826,99000,99000,0,0,6,dong-ho-va-trang-suc
196058952,Đồng Hồ Skmei 1163 Kĩ Thuật Số Chống Thấm Nước Có Đèn Led Thời Trang Cho Bé Trai Gái,3.0,6724549685454,197000,197000,0,0,0,dong-ho-va-trang-suc
195189050,Dây đồng hồ Hamod,1.0,8260607480344,525000,525000,0,0,0,dong-ho-va-trang-suc
187189292,Dây chuyền nam mắt xích vuông chất liệu bạc s925 MS27d,4.0,8773847570448,450000,450000,0,0,1,dong-ho-va-trang-suc
183720581,"VÒNG TAY , LẮC TAY DÂY ĐỎ NANH CHÓ MỰC TRỪ TÀ HỘ MỆNH",12.0,3403360889049,100000,100000,0,0,1,dong-ho-va-trang-suc
178028099,Dây đeo đồng hồ thép không gỉ 9 khớp mới G07 size 22mm,2.0,7647933742466,69000,69000,0,0,0,dong-ho-va-trang-suc
178027887,Dây da đồng hồ nam nữ DA BÒ THẬT 3 LỚP SIÊU DẺO KHÓA CÀI dập vân cá sấu Việt Nam size 18 - 20 - 22,2.0,3555313189661,83000,83000,0,0,2,dong-ho-va-trang-suc
176074309,Dây đồng hồ cao su silicon cao dấp dành cho Samsung Galaxy watch 3 45mm - Khóa đen,46.0,2846744434602,88110,88110,0,0,11,dong-ho-va-trang-suc
176072099,Dây đồng hồ cao su silicon cao dấp dành cho đồng hồ Huami Amazfit Gtr2 / Gtr2 e,23.0,9864157016339,59000,59000,0,0,6,dong-ho-va-trang-suc
176071962,Dây silicon thể thao mềm mại dành cho các loại đồng hồ watch 3 41 mm và watch 3 45 mm,8.0,4877828139305,135000,135000,0,0,1,dong-ho-va-trang-suc
176071770,Dây đồng hồ cao su silicon cao dấp dành cho Xiaomi Mi watch,53.0,7467758194153,58800,58800,0,0,7,dong-ho-va-trang-suc
160419283,Dây Đeo Đồng Hồ Thép Không Gỉ Đúc Đặc Có Đầu Bo Cong Size 20mm 22mm,28.0,5264243653006,160000,160000,0,0,8,dong-ho-va-trang-suc
146845655,Hộp đồng hồ xoay . Hộp đựng đồng hồ cơ quay tự động bọc da PU cao cấp,94.0,8174623663262,400000,400000,0,0,20,dong-ho-va-trang-suc
137941919,Dây đeo Xiaomi Miband 6 và Mi band 5 - chính hãng Mijobs,138.0,6310779321212,40000,40000,0,0,33,dong-ho-va-trang-suc
111911041,Đồng Hồ Nam Chính Hãng Casio F-94WA-8D Dây Nhựa,5.0,9294141608053,501020,611000,109980,18,1,dong-ho-va-trang-suc
106392571,Bộ dụng cụ sửa đồng hồ đeo tay 18 món,3.0,6950702148854,119999,119999,0,0,0,dong-ho-va-trang-suc
106390876,Dây Đồng Hồ HUBLOT Lót Da Vân Đen Thơm Mùi Vani Case 38 Size Dây 15 - 21 - 18,8.0,7421577893246,150000,150000,0,0,5,dong-ho-va-trang-suc
105803816,Vòng Tay Trầm Hương Cao Cấp Hạt Tròn Đơn 14mm Trầm Tốc Việt - Trầm Hương Tự Nhiên,2.0,8484946931567,450000,450000,0,0,1,dong-ho-va-trang-suc
102143096,Dây chuyền bạc trẻ em mặt hình con giáp MS15,1.0,8012186655907,248000,248000,0,0,1,dong-ho-va-trang-suc
95986590,Dây Đồng Hồ Da Bò Sáp Nhiều Màu Kèm Chốt Thông Minh,17.0,6183107839178,199000,199000,0,0,7,dong-ho-va-trang-suc
82412738,Dây Lưới Đồng Hồ Size 22mm 20mm 18mm 16mm 14mm 12mm ,44.0,6086618541624,130000,130000,0,0,13,dong-ho-va-trang-suc
75551211,Bông tai vành tai S925 ngôi sao chứng nhân mẫu hot 2021,104.0,3230665323733,39900,39900,0,0,15,dong-ho-va-trang-suc
72093668,Pin Đồng hồ đeo tay Maxell SR927SW 1.55V 395 vỉ 5 viên,69.0,5613895644584,133000,133000,0,0,19,dong-ho-va-trang-suc
70120675,Vòng tay chuỗi đá mắt hổ loại A+,1.0,4209396885185,225000,225000,0,0,0,dong-ho-va-trang-suc
66524417,Dây đồng hồ DA BÒ MỊN cao cấp OL-801 kèm khóa bướm ĐÔI thép không gỉ 316L ,43.0,5077578055362,125000,125000,0,0,14,dong-ho-va-trang-suc
58530502,Dây đồng hồ nibosi thép lưới khoá gài,27.0,1963023059075,130000,130000,0,0,4,dong-ho-va-trang-suc
58311532,"Nhẫn nam đá mã não trắng ni 19 mệnh thủy, kim - Ngọc Quý Gemstones",22.0,4368796937365,179000,350000,171000,49,5,dong-ho-va-trang-suc
52430126,"Vòng tay đá ngọc bích phối charm bạc trắng mệnh hỏa, mộc - Ngọc Quý Gemstones",9.0,7925766552996,1000000,1430000,430000,30,1,dong-ho-va-trang-suc
52060568,Vòng tay may mắn vòng tay cặp nam nữ nhịp tim,141.0,4710538341426,75000,75000,0,0,18,dong-ho-va-trang-suc
42788270,Vòng tay cặp đá mã não liền khối tự nhiên - Ngọc Quý Gemstones,33.0,9660247945772,189000,189000,0,0,7,dong-ho-va-trang-suc
33033766,Khóa cài dây đồng hồ cao cấp thép không gỉ.,46.0,5322109738529,15000,15000,0,0,4,dong-ho-va-trang-suc
25059503,Nhẫn nam titanium chạm rồng BHN80,157.0,5269570677288,83000,83000,0,0,68,dong-ho-va-trang-suc
16931764,Nhẫn nam nữ bát nhã tâm kinh trì chú khai quang N6,140.0,9862501199932,45000,45000,0,0,51,dong-ho-va-trang-suc
12960322,Vòng tay đá ngọc Malaysia mix tỳ hưu đổi màu theo nhiệt độ MS304,2.0,9166716953878,125000,125000,0,0,1,dong-ho-va-trang-suc
10787668,Dây da đồng hồ nam nữ da bò thật dập vân cá sấu bền đẹp,146.0,3212163564559,42000,42000,0,0,39,dong-ho-va-trang-suc
7796951,Dây đồng hồ thép không gỉ dây mesh cao cấp YE-008,598.0,9355064750486,130000,130000,0,0,225,dong-ho-va-trang-suc
6187133,2 vỉ pin đồng hồ đeo tay,142.0,9258318321299,17000,17000,0,0,28,dong-ho-va-trang-suc
609821,Dây Chuyền Mặt Phật Mạ Vàng Bọc Thủy Tinh VD17080,3.0,3302826541260,19000,19000,0,0,1,dong-ho-va-trang-suc
276069468,"Pin Tiểu 2A 3A Con Ó Chính Hãng, Bin Đồng Hồ, Pin Xe Đồ Chơi Chất Lượng Cao (Có Hàng Sẵn) (Xả Rẻ Lấy 5*)",1.0,8891990959200,3000,3000,0,0,0,dong-ho-va-trang-suc
275950958,Nhẫn Nam Đá Mắt Hổ Vàng Nâu Tiger Eyes Tự Nhiên đậm bóng đẹp mới ni 20mm x Cao 12mm / 11mm dầy 4mm nam mệnh Kim mệnh Thổ mệnh Thủy đeo ni 20mm rẻ đẹp ạ,1.0,5138246410093,328900,598000,269100,45,1,dong-ho-va-trang-suc
275193999,Hộp đựng đồng hồ gỗ Songmics 2 tầng - Đẳng cấp châu Âu Hàng chính hãng,2.0,8703602522914,1590000,1590000,0,0,0,dong-ho-va-trang-suc
272401823,"LẮC TAY , VÒNG TAY DÂY CHỈ ĐỎ 10 HẠT THẬP TOÀN THẬP MỸ",1.0,8635313584564,120000,120000,0,0,0,dong-ho-va-trang-suc
202033896,Đồng Hồ Nam Dây Nhựa Casio G-Shock GBA-800-8A Bluetooth - Đếm Bước Chân - Đo Lượng Kcalo Đã Đốt,1.0,7549099942775,3539000,4661000,1122000,24,0,dong-ho-va-trang-suc
188482535,Dây vải dành cho Apple watch Serie 7,3.0,9599194159947,84000,84000,0,0,2,dong-ho-va-trang-suc
186638903,Đồng Hồ Nam Dây Nhựa Casio Standard WS-1400H-1AVDF Chính Hãng - WS-1400H-1A Pin 10 Năm,8.0,4118078307815,889000,1182000,293000,25,3,dong-ho-va-trang-suc
186090055,Dây đồng hồ Size 18mm 20mm 22mm da cá sấu xịn hàng Việt Nam tặng kèm phụ kiện,10.0,3024512682582,160000,160000,0,0,3,dong-ho-va-trang-suc
184499928,Cây Thay Dây Đồng Hồ - Tool Tháo Dây- Dụng Cụ Tháo Dây Đồng Hồ,10.0,8677814760518,9999,9999,0,0,1,dong-ho-va-trang-suc
184475889,Đồng Hồ Thể Thao Led Skmei 1251 chống thấm nước,17.0,5291922392802,149000,149000,0,0,4,dong-ho-va-trang-suc
184096918,Vòng tay nữ charm bạc phong thuỷ chất liệu bạc s925 MS236,1.0,3977905492529,400000,400000,0,0,0,dong-ho-va-trang-suc
182744755,Pin Đồng Hồ Đeo Tay 1 Viên Maxell Nhật Bản Nhiều Cỡ Lựa Chọn,14.0,3047950944612,30000,30000,0,0,0,dong-ho-va-trang-suc
178030826,Dây đeo đồng hồ thép không gỉ đúc đặc sợi Mảnh,7.0,7808711133546,195000,195000,0,0,2,dong-ho-va-trang-suc
176074047,Dây Đeo SILICON dành Cho Samsung Watch 3 45mm Chất Lượng cao,1.0,2688715852309,50000,50000,0,0,0,dong-ho-va-trang-suc
176073973,Dây Silicon cao cấp hai khóa nhiều màu sắc dành cho Xiaomi Miband 5,2.0,6914874000895,58650,58650,0,0,0,dong-ho-va-trang-suc
176073854,Dây đồng hồ cao su Sikai 22mm cao cấp chống thấm nước,18.0,7846151601092,135000,135000,0,0,4,dong-ho-va-trang-suc
176071758,Kính cường lực 2D chống trầy xước bảo vệ cho đồng hồ Samsung Galaxy Watch 4 40mm / 44mm và Watch 4 classic 42mm / 46mm,32.0,1223723518938,25000,25000,0,0,6,dong-ho-va-trang-suc
161523505,Dây đồng hồ cao su silicon Sikai cao cấp dành cho Samsung galaxy watch 3 41 và 45mm,10.0,6652826938758,135000,135000,0,0,1,dong-ho-va-trang-suc
145763626,"10 Viên Pin Cúc Áo LR41 - AG3 - L736 Vinnic 1,5V",35.0,6902902493380,18000,18000,0,0,2,dong-ho-va-trang-suc
118787616,20 Vỉ 200 Viên Pin Đồng hồ AG1 - LR621 - 364 - SR621 - 164,9.0,2860482922626,120000,120000,0,0,1,dong-ho-va-trang-suc
117002624,Đồng hồ nữ dây nhựa Casio Standard chính hãng LW-204-1BDF,41.0,9964785326601,739000,1081000,342000,32,15,dong-ho-va-trang-suc
112548864,Đồng hồ nữ Lobinni L026-4 Chính hãng Thụy Sỹ,1.0,7022750255684,3850000,3850000,0,0,1,dong-ho-va-trang-suc
106393058,"Kính lúp gắn mắt xịn dùng trong sửa chữa đồng hồ 5x,10x",17.0,5318345701944,120000,120000,0,0,4,dong-ho-va-trang-suc
106390917,Tặng Kèm Tovit Thay Dây đồng hồ Hublot cao su nữ màu thơm mùi vani 13-19-18,32.0,3063720669030,127500,127500,0,0,5,dong-ho-va-trang-suc
103343531,BeCharm Pha Lê Swarovski Mặt Cắt 3 Màu S14mm,1.0,4084700794476,450000,750000,300000,40,0,dong-ho-va-trang-suc
102143002,Lắc tay bạc kim tiền mặt hồ ly MS115,5.0,3875840964589,198000,198000,0,0,1,dong-ho-va-trang-suc
102142756,Charm Tỳ hưu bằng bạc dùng để mix vòng phong thuỷ,7.0,3105239209422,78000,78000,0,0,0,dong-ho-va-trang-suc
99427357,Combo 5 dây chuyền đeo cổ vải dù ( giao màu ngẫu nhiên) -  T027,15.0,7082166253891,82800,82800,0,0,1,dong-ho-va-trang-suc
94517970,Charm bạc túi tài lộc treo - Ngọc Quý Gemstones,5.0,1197788341830,99000,180000,81000,45,1,dong-ho-va-trang-suc
89878697,Nhẫn bạc nữ thời trang chất liệu bằng bạc s925 MS06kt,7.0,8144007681108,110000,110000,0,0,3,dong-ho-va-trang-suc
88998854,Nhẫn nam nữ bát nhã tâm kinh trì chú khai quang màu bạc,15.0,4202196683130,49000,49000,0,0,7,dong-ho-va-trang-suc
74027211,Đồng hồ nam chính hãng KASSAW K998-5,1.0,6319563532113,6875000,6875000,0,0,1,dong-ho-va-trang-suc
66511294,Dây chuyền nam inox thời trang hỏa tiển trơn 2mm thép không gỉ BC02,31.0,6314889667662,40000,40000,0,0,5,dong-ho-va-trang-suc
57746922,Dây chuyền vòng cổ nam titan,22.0,6254524406006,92000,92000,0,0,5,dong-ho-va-trang-suc
55607299,"Combo Dây Chuyền Nam Nữ Mạ Vàng 18K, Dạng Mảnh, Dài 45cm, Cỡ 1,2li, Kèm Túi Nhung",75.0,1829341358446,129000,129000,0,0,15,dong-ho-va-trang-suc
54859508,Nhẫn chỉ trơn khắc 9999 mạ 24k cao cấp ,70.0,2000220840132,79000,79000,0,0,16,dong-ho-va-trang-suc
54815750,Vòng Tay Trầm Hương 108 Hạt (Nữ) | Trầm Tốc Lào Tự Nhiên 100%,55.0,1347422890871,94000,94000,0,0,19,dong-ho-va-trang-suc
52319751,Khóa bướm đồng hồ ĐƠN thép không gỉ dùng cho dây da nhiều SIZE 14 16 18 20 22mm,103.0,1198804025714,25000,25000,0,0,28,dong-ho-va-trang-suc
32079760,"Vòng tay phong thủy đá thạch anh trắng mệnh kim , thủy - Ngọc Quý Gemstones",60.0,5937199281499,190000,370000,180000,49,15,dong-ho-va-trang-suc
7804969,Bông tai nam inox khuyên tròn 10mm BT233 - 2 chiếc,397.0,3688120896238,35000,35000,0,0,57,dong-ho-va-trang-suc
273521943,"Vòng chuỗi hạt đeo tay đá thạch anh tóc trắng, tím, xanh, đỏ cho nam nữ đẹp MySun ",16.0,3133588221973,9900,15000,5100,34,0,dong-ho-va-trang-suc
271343637,Dây đeo cho Oppo Band (DOPB),22.0,6065213876401,49000,49000,0,0,1,dong-ho-va-trang-suc
271042483,Dây đeo cho Redmi Band 2/ Mi Band 8 Active (DRB2),11.0,3908635157996,79000,79000,0,0,5,dong-ho-va-trang-suc
249730017,Vòng Tay Phong Thủy Trầm Hương Chuỗi Tràng 108 Hạt 6 Li Charm Ngẫu Nhiên Phối Đá Đeo Tay Mệnh Kim Mộc Thủy Hỏa Thổ,2.0,9615283190971,958000,958000,0,0,1,dong-ho-va-trang-suc
207802744,Bông Tai Khoen Tròn Ngôi Sao Titan Ko Đen TT 4246,1.0,6436347190540,140000,140000,0,0,0,dong-ho-va-trang-suc
204282368,Vòng tay hoa sen vàng phong thủy trầm hương HÀ XÁ 8li vòng đeo tay cặp đôi nữ may mắn tài lộc,40.0,7259683916433,199000,398000,199000,50,34,dong-ho-va-trang-suc
192986084,Pin CR1620 Maxell 3V Hàng Chính Hãng Made in Japan 1 Viên,23.0,9481343006085,40000,40000,0,0,5,dong-ho-va-trang-suc
185791240,Dây chuyền vòng cổ ngọc trai 1 tầng basic tiểu thư Hàn Quốc sang chảnh,1.0,9948806821615,89000,89000,0,0,0,dong-ho-va-trang-suc
178030651,Dây đồng hồ điện tử thông minh 38/40/42/44 da bò cao cấp nhiều lỗ Chốt thông minh,2.0,5065111294669,132000,132000,0,0,0,dong-ho-va-trang-suc
178028912,(Dây Xanh lá) DÂY ĐỒNG HỒ DA BÒ THẬT DẬP VÂN CÁ SẤU BỀN ĐẸP SIZE 12 14 16 18 20 22 24,8.0,3161610566419,49000,49000,0,0,1,dong-ho-va-trang-suc
178028347,Vỉ 10 viên Pin đồng hồ VINNIC AG1 / LR621SW / 364A / CX60W Chính Hãng,37.0,7936380141356,12000,12000,0,0,0,dong-ho-va-trang-suc
176692593,Hộp Đựng Đồng Hồ Và Mắt Kính 2 Tầng SAIKE SAIKE S609 Vỏ Da Màu Đen,4.0,9795246818479,550000,550000,0,0,0,dong-ho-va-trang-suc
176073390,Đế Sạc Kèm Dây Cáp Usb cho đồng hồ thông minh Huawei GT/ GT2 46mm/ Honor Magic/ GT 2E,7.0,1824322594170,105000,105000,0,0,1,dong-ho-va-trang-suc
168872083,Nhẫn bạc nữ mặt vương miện chất liệu bạc s925 MS47d,1.0,6163976147777,94000,94000,0,0,0,dong-ho-va-trang-suc
167879267,LẮC TAY PHA LÊ NGŨ PHÚC LÂM MÔN,1.0,5561997134543,140000,140000,0,0,0,dong-ho-va-trang-suc
153912906,"Nhẫn Bọ cạp vàng kiểu cổ, Khắc nổi, Chất liệu hợp kim Titanium; mang lại sự mạnh mẽ, cá tính, kèm túi nhung Hồng phát",2.0,9221744561511,108680,209000,100320,48,0,dong-ho-va-trang-suc
153547493,VÒNG TAY HUYẾT ÁP,2.0,3366549857733,650000,650000,0,0,0,dong-ho-va-trang-suc
153471379,Lắc chân may mắn gắn hạt đá phong thủy thiên nhiên xinh xắn,8.0,1986996980961,39000,39000,0,0,0,dong-ho-va-trang-suc
143838450,Dây đồng hồ nam da cá sấu đốt tre Bụi Leather D103 - Hàng khâu tay thủ công cao cấp - Bảo hành 12 tháng,290.0,7558200679111,269000,320000,51000,16,91,dong-ho-va-trang-suc
135348102,"Dây đeo Samsung Watch 3 41/ 45mm - Dây thép, khóa nam châm",11.0,2525641788468,149000,149000,0,0,3,dong-ho-va-trang-suc
106393314,Dầu Thuỵ Sỹ xịn 100% tra cho đồng hồ cơ tự động,24.0,4333510499396,140000,140000,0,0,5,dong-ho-va-trang-suc
106391981,Bàn Ép Tay Đồng Hồ 11 Cỡ Để Thay Pin Đồng Hồ,12.0,2933222592529,185000,185000,0,0,2,dong-ho-va-trang-suc
106390639,Dụng Cụ Tháo Nhổ Kim Đồng Hồ Loại 1 Kèm Dụng cụ Bảo Vệ Mặt Số Khi Tháo Lắp Kim Đồng Hồ,9.0,8036301392181,45000,45000,0,0,6,dong-ho-va-trang-suc
100186581,Bộ dụng cụ sửa chữa đồng hồ 13 món có kèm túi đựng - DMA store,6.0,5404665850180,148999,148999,0,0,0,dong-ho-va-trang-suc
84597743,Dây Chuyền Nam Ngôi Sao 6 Cánh Titanum Cao Cấp - Ngọc Quý Gemstones,3.0,2910877914406,59000,100000,41000,41,1,dong-ho-va-trang-suc
71958295,Vòng tràng hạt Trầm Tốc tự nhiên 108 hạt mùi thơm vĩnh viễn ,1.0,8379415026236,126480,248000,121520,49,0,dong-ho-va-trang-suc
68234937,Dây Da Đồng hồ Cá sấu Xuất Khẩu [Tặng kèm Hộp gỗ và Dụng cụ],45.0,3640669395146,150000,150000,0,0,23,dong-ho-va-trang-suc
58204009,NHẪN ĐÁ CẨM THẠCH MÀU ĐỎ ĐẸP NI NHẪN 17MM HỢP MỆNH HỎA THỔ,11.0,8236090743516,324800,560000,235200,42,5,dong-ho-va-trang-suc
51477870,Vòng tay nam hình thánh giá,17.0,8211355118872,60000,60000,0,0,4,dong-ho-va-trang-suc
46327728,Dây Chuyền Nam Titan Không Đen TT 2449,29.0,5092699286488,142000,142000,0,0,3,dong-ho-va-trang-suc
37769268,Bông Tai Nam Khoen Tròn Sơn Tùng Chất Liệu Thép Titan Ko Rỉ Ko Dị Ứng TT 0861 - 1 cặp,282.0,9477551236324,35000,35000,0,0,75,dong-ho-va-trang-suc
20007800,Bông tai dài ngọc hoa BHBT158,10.0,3902132492555,76000,76000,0,0,2,dong-ho-va-trang-suc
19716288,VÒNG NAM Mệnh THUỶ MỘC 14ly ĐÁ TN MẮT HỔ ĐEN XANH,3.0,7645206876689,481600,860000,378400,44,3,dong-ho-va-trang-suc
11405385,Vòng cổ choker tattoo tim trắng V65,14.0,5642669684501,16000,16000,0,0,0,dong-ho-va-trang-suc
11405379,Vòng cổ choker tattoo tim đỏ V62 thời trang,4.0,1660976860153,16000,16000,0,0,0,dong-ho-va-trang-suc
5758459,Vòng tay chuỗi hạt gỗ Đàn hương đen 10 ly 18 hạt,2.0,9109275200465,121000,121000,0,0,0,dong-ho-va-trang-suc
5569315,"Chuỗi đeo tay Đá Mắt Hổ Vàng Đen 8 ly 21 hạt - hợp mệnh Thổ, mệnh Kim",4.0,4368996323586,165000,165000,0,0,0,dong-ho-va-trang-suc
2401561,Vòng cổ Choker Tatoo ren hoa 6 cánh nhẹ nhàng,9.0,6374296137356,16000,16000,0,0,1,dong-ho-va-trang-suc
1812239,Vòng Tay Đá Mã Não Đỏ Mix Charm Bạc 925 8mm Ngọc Quý Gemstones VT165,6.0,8404413084220,306000,360000,54000,15,2,dong-ho-va-trang-suc
902880,Vòng Tay Đá Mắt Hổ 14mm Mix Tỳ Hưu,3.0,3307573348827,500000,500000,0,0,1,dong-ho-va-trang-suc
276074195,Dây chuyền mặt phật ngọc,1.0,2744922529343,75000,75000,0,0,1,dong-ho-va-trang-suc
275807586,Dây đồng hồ bằng Denim kiểu dáng slim mỏng BO-76 bền và chống thấm nước tốt các size 8 10 12 14 16 mm,2.0,7794677346065,69000,69000,0,0,1,dong-ho-va-trang-suc
272744656,Cuộn Dây Thun co giãn chuyên Xỏ Vòng Tay chuỗi hạt nhe  Thun có đủ màu nhe anh chị trắng đen đỏ hồng tím vàng xanh lá xanh dương ạ  Anh chị đang đeo chuỗi muốn thay dây khác thì đặt cuộn chỉ này nhé,5.0,4661290939606,45000,90000,45000,50,0,dong-ho-va-trang-suc
272399522,Dây da Đồng hồ Samsung size 20mm (dây Dùng cho được Active2/ watch 4/watch 5/watch 6) Hàng Chính hãng,15.0,6684045634681,49000,49000,0,0,0,dong-ho-va-trang-suc
253098741,"Dây đeo cho Miband 8/ Miband 9/ Miband 10 - Dây thép, khóa nam châm (DTMB8)",14.0,7684907785337,149000,149000,0,0,4,dong-ho-va-trang-suc
249287804,Chuỗi 108 Hạt Đàn Hương 6mm/8mm Chuỗi Đeo Tay Mala Thiền/Cầu Nguyện Phối Charm Hoa Sen Hoàng Dương,12.0,1218740810167,325000,325000,0,0,3,dong-ho-va-trang-suc
242778439,"Vòng tay phong thủy bạch ngọc bồ đề làm từ hạt bồ đề Nepal, hộ mệnh trừ tà giúp tài lộc, kèm túi nhung cung hỷ",7.0,5699716947300,151980,298000,146020,49,4,dong-ho-va-trang-suc
229697147,Dây vải nilon dành cho đồng hồ Amazfit GTR4 / GTS4 / GTR 4 / GTS 4,16.0,5709920879127,68000,68000,0,0,2,dong-ho-va-trang-suc
199977081,"Đinh Đục Lỗ Thắt Lưng Da, dây da đồng hồ 2.5 3.0 3.5 4.0 mm",17.0,5789550452741,9000,9000,0,0,5,dong-ho-va-trang-suc
196207773,"Dây silicon 20mm thời trang dành cho đồng hồ Garmin Venu
",37.0,1946837497166,59000,59000,0,0,6,dong-ho-va-trang-suc
194570978,Vòng tay trầm hương chuỗi 108 hạt mix râu đá màu mệnh kim mộc thủy hỏa thổ đeo tay nam nữ may mắn bình an tài lộc Trầm Hương Hà Xá,190.0,9815921232413,199000,398000,199000,50,64,dong-ho-va-trang-suc
178950126,Hộp Đựng Đồng Hồ Đeo Tay 6 Ngăn SAIKE SAIKE S600 Vỏ Da Màu Đen,9.0,9034593158682,270000,270000,0,0,0,dong-ho-va-trang-suc
172181808,"Vòng tay lu thống đá aquamarine mệnh thủy, mộc - Ngọc Quý Gemstones",1.0,6844868978645,739000,1060000,321000,30,0,dong-ho-va-trang-suc
161522785,Dây đồng hồ cao su silicon Sikai 2 màu cao cấp dành cho Huawei Watch GT3 46mm,12.0,2631785970773,168000,168000,0,0,7,dong-ho-va-trang-suc
145395221,"Vòng tay ngũ sắc, phong cách phật giáo, 108 hạt, gỗ tự nhiên 100%, Kèm túi đựng Cung hỷ",5.0,7902716619020,39000,75000,36000,48,1,dong-ho-va-trang-suc
143174401,"Bộ Vòng đeo cổ dạ hội, Phong cách Hàn Quốc, chất liệu Pha lê Swarosi, sang trọng, đẳng cấp và quý phái, Kèm Hộp đựng thiên thanh lót nhung nỉ - Mẫu Luxi Green 0077",1.0,9319819256285,170560,328000,157440,48,0,dong-ho-va-trang-suc
133039692,Dây đeo Samsung Watch 3/ Active 1/ 2/ 46mm (DSG),8.0,9228300408889,140000,140000,0,0,0,dong-ho-va-trang-suc
111035402,"Dây chuyền nam kiểu ống trúc Khóa Vip mạ vàng siêu đẹp, bền màu - Đem lại đẳng cấp, phong độ cho người đeo",2.0,9223843039177,99000,99000,0,0,0,dong-ho-va-trang-suc
110979025,"Đồng hồ nam SUNRISE 1190SA full hộp, kính sapphire chống xước chống nước tốt",3.0,7513720956354,985000,985000,0,0,0,dong-ho-va-trang-suc
106392036,GIÁ HỦY DIỆT Dây đồng hồ HUBLOT nam lót da lộn Xám Tối Case 42 size dây 19 - 25 - 22,32.0,6972597423163,150000,150000,0,0,4,dong-ho-va-trang-suc
106391147,"Khăn Bergeon lau sáng bóng, làm sạch đồng hồ inox và các loại trang sức bạc vàng",15.0,6075515251956,50000,50000,0,0,3,dong-ho-va-trang-suc
106139389,Nhẫn cặp trái tim BHN32-1,6.0,1086977631282,85000,85000,0,0,2,dong-ho-va-trang-suc
90691638,"Vòng đeo tay, lắc tay phong thủy mix phụ kiện đá ngọc Jade",2.0,8470132805357,250000,250000,0,0,1,dong-ho-va-trang-suc
87093899,Nhẫn cưới trơn 1 chỉ mạ vàng 24k (Thái Lan),83.0,6790138487992,43000,43000,0,0,13,dong-ho-va-trang-suc
82874965,Dây vải đeo cổ dạng rút - Dây rút điểm vàng - Ngọc Quý Gemstones,99.0,9039864885960,20000,20000,0,0,10,dong-ho-va-trang-suc
72688928,"Mặt dây chuyền hồ ly đá ruby 16.9x14.2mm mệnh hỏa, thổ - Ngọc Quý Gemstones",8.0,1787547947560,779000,1110000,331000,30,4,dong-ho-va-trang-suc
72095740,Pin Đồng hồ đeo tay Maxell SR920SW 1.55V 371 vỉ 5 viên,278.0,3958570740291,85000,85000,0,0,70,dong-ho-va-trang-suc
66604091,Dây chuyền chain titan bản đại vòng khoá sịn sò,1.0,5168539792669,132000,132000,0,0,1,dong-ho-va-trang-suc
65580383,Vòng tay chỉ đỏ đính ngọc cầu an,10.0,8000605969605,9690,19000,9310,49,1,dong-ho-va-trang-suc
58299829,"Nhẫn nam đá băng ngọc thủy tảo mệnh hỏa , mộc - Ngọc Quý Gemstones",7.0,3368743421580,499000,980000,481000,49,4,dong-ho-va-trang-suc
56999925,Combo charm bạc hình đồng tiền xỏ ngang  - Ngọc Quý Gemstones,6.0,7371148217562,150000,150000,0,0,2,dong-ho-va-trang-suc
41272809,Bông Tai Nam Hình Chữ Vạn Chất Liệu Thép Titan Không Rỉ TT 1702 - 1 Cặp,15.0,5237413724765,65000,65000,0,0,3,dong-ho-va-trang-suc
34477970,Bông tai inox dài ngọc không đen BHBT260,3.0,2081829162429,72000,72000,0,0,0,dong-ho-va-trang-suc
31707205,"Nhẫn nam đá băng ngọc thủy tảo ni23 mệnh hỏa , thổ - Ngọc Quý Gemstones",8.0,8205797862615,499000,980000,481000,49,2,dong-ho-va-trang-suc
29138413,Khuyên tai nam Titan cá tính,211.0,2466501270003,35000,35000,0,0,31,dong-ho-va-trang-suc
28618823,Dây chuyền dáng dài mặt hoa pha lê đá to,12.0,6886338909659,143000,143000,0,0,2,dong-ho-va-trang-suc
22614325,Vòng tay dâu tằm gỗ tự nhiên cho bé,121.0,9616680778507,24900,24900,0,0,11,dong-ho-va-trang-suc
15421345,Nhẫn xoay Bát Nhã Tâm Kinh khắc chữ Vạn - Nhẫn phong thủy Hán ngữ may mắn bình an Ri99,219.0,7121610425779,49000,49000,0,0,47,dong-ho-va-trang-suc
12274430,Đồng hồ nữ dây nhựa Casio LRW-200H-4B2VDF,8.0,4254347835634,751200,939000,187800,20,3,dong-ho-va-trang-suc
11140078,Bộ 3 vòng tay cao su giúp bỏ thói quen xấu (3 màu),243.0,3258158228785,90000,90000,0,0,19,dong-ho-va-trang-suc
275401052,Túi Chống Sốc Cho Laptop 2 Ngăn Không Thấm Nước - Hàng Chính Hãng,243.0,7843300581887,118750,125000,6250,5,18,balo-va-vali
253146707,Vali kéo American Tourister Maxwell Spinner TSA,3.0,8986249214564,2200000,4400000,2200000,50,2,balo-va-vali
275405848,Túi Laptop Chống Sốc 5 Ngăn – Túi Chống Thấm Nước - Hàng Chính Hãng,47.0,3098645838116,160550,169000,8450,5,8,balo-va-vali
253149261,Vali kéo American Tourister Applite 4 Eco Spinner EXP TSA,5.0,6859444435147,2592000,4800000,2208000,46,2,balo-va-vali
249991570,"Túi xách túi chống sốc cho laptop 15,6 inh-16.1 inh và 17.3 inh cao cấp phong cách mới",36.0,7569872005980,351500,370000,18500,5,9,balo-va-vali
277471313,"Móc Khóa Zip Kéo Thay Thế Bằng Nhựa Kim Loại Có Thể Tháo Rời Cho Balo Túi Xách, Vali, Áo Khoác, Quần ",13.0,3566357118858,6000,6000,0,0,0,balo-va-vali
276605657,AS - VALI DU LỊCH,139.0,5542202864844,407000,407000,0,0,2,balo-va-vali
276457647,"Bộ 8 Bọc Cao Su Bánh Xe Vali Silicone Bảo Vệ Giảm Tiếng Ồn, Chống Mài Mòn Cho Vali Hành Lý Phụ Kiện",35.0,3260723379556,14000,14000,0,0,3,balo-va-vali
276101277,"1 KG túi hột xoài trơn bóng dẻo màu đỏ,đủ size - Hàng chính hãng",11.0,5951206198253,45000,45000,0,0,0,balo-va-vali
275600427,"Cặp Đựng Chống Sốc Cao Cấp Teement, Chống Nước, Chống Xước, Dành Cho Laptop 13,14,15.6icnh - Hàng Chính Hãng",8.0,4798441084578,320000,320000,0,0,2,balo-va-vali
274871219,"Túi xách túi chống sốc cho laptop 14inh -15,6 inh và 16.1 inh cao cấp phong cách mới",16.0,5005034893359,351500,370000,18500,5,1,balo-va-vali
216379232,Vali kéo American Tourister Maxivo Spinner TSA,9.0,6180667657327,2250000,4500000,2250000,50,5,balo-va-vali
276231775,Túi trống Boeing chính hãng RC,0.0,1714342626648,1710000,1900000,190000,10,0,balo-va-vali
253145813,Vali kéo American Tourister Curio Spinner EXP TSA Book Open,6.0,9948805008428,2700000,5400000,2700000,50,1,balo-va-vali
216379205,Vali kéo American Tourister Hundo Spinner EXP TSA,8.0,9622929229170,1750000,3500000,1750000,50,1,balo-va-vali
275253697,Túi Thể Thao Đeo Hông Đeo Bụng Dùng Cho Chạy Bộ Tập Thể Dục,14.0,9327654409293,41000,41000,0,0,0,balo-va-vali
275058076,Lọ Chiết Nước Hoa Du Lịch 5ml - Hàng chính hãng ,74.0,6131151700565,29000,29000,0,0,3,balo-va-vali
184415829,Balo nữ sinh đi học đi chơi đi làm không thấm nước cao cấp phong cách hàn quốc,113.0,1442617106158,370500,390000,19500,5,32,balo-va-vali
216115007,Vali kéo American Tourister Squasem Spinner EXP TSA,7.0,2436852561273,2450000,4900000,2450000,50,1,balo-va-vali
270104338,Vali kéo American Tourister Frontec Spinner,11.0,3396536308590,3050000,6100000,3050000,50,1,balo-va-vali
247425503,Vali kéo American Tourister LOCKation Spinner Frame,4.0,3979390929025,3350000,6700000,3350000,50,0,balo-va-vali
82939706,"Balo nam thời trang vải canvas cao cấp phong cách mới 15,6""",21.0,7332222502300,378100,398000,19900,5,11,balo-va-vali
274086152,Balo Yuumy ( Thời trang nữ phong cách tối giản cỡ trung - Balo da Seasand YBA88 ),8.0,2289508974505,235000,440000,205000,47,1,balo-va-vali
273269030,Dây Đai Buộc Khóa Hành Lý Vali Treo Balo Túi Xách Giỏ Cặp Đi Máy Bay Du Lịch Dã Ngoại Picnic Cắm Trại Legaxi,62.0,4049018923329,14000,14000,0,0,5,balo-va-vali
210442060,"Hộp đựng bàn chải, kem đánh răng du lịch - Hàng chính hãng",180.0,5653885501701,33250,35000,1750,5,19,balo-va-vali
204875405,Túi Chống Sốc Laptop 13 inch 14 inch 15 inch 17inch HARAS TC001,117.0,5586084296561,69000,69000,0,0,18,balo-va-vali
203803252,Balo nam nữ thời trang phong cách đơn giản đi học đi làm đi chơi có ngăn đựng laptop KBN008,8.0,3914935471099,240000,240000,0,0,3,balo-va-vali
197620945,"Dây đai vali đôi 4m, có khóa dùng cho vali từ 20-32inch+ TẶNG TÚI ĐỰNG- CHỌN MÀU- Dây buộc/ dây ràng vali 2 chiều, bảo vệ hành lý an toàn",233.0,8151533692932,85000,85000,0,0,15,balo-va-vali
196344507,"Set 8 Túi Đựng Đồ Du Lịch Cho Vali KUNBE Phiên Bản Cao Cấp Chất Liệu Dày Dặn, Siêu Tiện Lợi",282.0,5612320667073,199000,199000,0,0,22,balo-va-vali
192155106,Bộ 7 Túi Đựng Đồ Du Lịch Tiết Kiệm Phân Loại Hành Lý Dành Cho Vali,0.0,5926775863100,150000,150000,0,0,30,balo-va-vali
191800394,"Balo Nam Đi Phượt US ARMY,BaLo Chiến Thuật Leo Núi, Du Lịch Chuyên Dụng Chất Liệu Cavan Cao Cấp Chống Nước - HÀNG CHÍNH HÃNG",94.0,6836788043019,229500,459000,229500,50,38,balo-va-vali
177680830,"Hộp Đựng Thuốc Cho 1 Tuần Có Thể Tháo Rời Theo Từng Ngày , Mỗi Ngày Có 4 Ngăn Đựng Tiện Lợi PaKaSa - Hàng Chính Hãng ",46.0,3975593300309,59000,118000,59000,50,5,balo-va-vali
169218891,"Túi Đựng Giày Dép Grepaco Vải Bố Canvas Dù Chống Thấm Nước Dùng Cho Nam Nữ Đi Công Tác, Đi Du Lịch, Thể Thao Dạng Khóa Kéo Có Quai Xách (Combo: Size L + Size M) - Hàng Chính Hãng",288.0,3102620765307,49000,49000,0,0,31,balo-va-vali
167469136,Combo 3 Túi Đựng Mỹ Phẩm Nhiều Kích Cỡ Tiện Lợi PaKaSa - Hàng Chính Hãng ,11.0,9216300841536,103530,164000,60470,37,1,balo-va-vali
161390143,Combo 10 Thẻ Ghi Nhớ Nhãn Tag Name Gắn Móc Chìa Khóa Đánh Dấu Hành Lý Vali,477.0,9846065521767,15000,15000,0,0,24,balo-va-vali
151952470,"Túi Đựng Đồ Cá Nhân Du Lịch , Túi Đựng Mỹ Phẩm Kiểu Hàn Quốc  Mẫu Mới - MP002",992.0,8332954421845,150000,150000,0,0,144,balo-va-vali
146517662,Combo 5 Túi Đựng Giày Dép Túi Xách Chất Liệu Vải Không Dệt Có Dây Rút THAFA Size Lớn (44x35cm),651.0,6724287798141,50000,50000,0,0,81,balo-va-vali
142244992,"Túi chống sốc- Cặp đựng laptop-Túi xách nam nữ cao cấp chống thấm nước, đơn giản, tinh tế, sang trọng và hiện đại",222.0,7512912201673,359000,359000,0,0,68,balo-va-vali
137953987,Túi Đựng Ipad Máy Tính Bảng Grepaco Chống Sốc Cao Cấp Vải Bố Canvas Nam Nữ Unisex Mẫu Mới Đẹp Thời Trang – Hàng Chính Hãng,171.0,2611886184145,49000,49000,0,0,33,balo-va-vali
126890607,Túi chống sốc bao da dành cho ipad laptop macbook surface kiêm giá đỡ tản nhiệt kèm ví đựng sạc chuột - Hàng chính hãng,36.0,2904512356720,350000,350000,0,0,7,balo-va-vali
82961526,"Cặp Tài Liệu Chống Sốc, làm bằng vải bạt, Cầm Tay đeo chéo cho laptop 15.6 Inch, Túi Xách Túi Đeo Vai Đựng Máy Tính Xách Tay Bao Đựng Máy Tính Xách Tay",391.0,6916825661633,190000,190000,0,0,116,balo-va-vali
78965799,"Túi Đựng Giày Dép Du Lịch KUNBE 3 Ngăn, Chất Liệu Chống Thấm Nước, Túi Để Giày Thể Thao Đa Năng Có Móc Gài Tay Kéo Vali Tiện Lợi - Hàng Loại 1 Dày Dặn",482.0,8960176988310,82900,82900,0,0,71,balo-va-vali
68820518,"balo nam -ba lô nam thời trang phong cách mới (15,6"")",7.0,4440091309280,420000,420000,0,0,2,balo-va-vali
44589613,"balo dây rút vải, không thấm nước, chất liệu bền tốt (Nhiều mẫu để chọn)",205.0,2906303471937,89000,170000,81000,48,47,balo-va-vali
40775154,Vali nhựa STARGO MARIS,3.0,1446815808650,4090000,4090000,0,0,1,balo-va-vali
24554545,Balo UNISEX  Thời Trang HARAS HRS008,500.0,8701114327060,200000,200000,0,0,150,balo-va-vali
12208064,Balo nắp đậy vải polyster AT-H1151,10.0,4422764151808,1840000,1840000,0,0,0,balo-va-vali
10708288,Balo nam thời trang hàn quốc HARAS HR244,740.0,1044947923120,250000,250000,0,0,157,balo-va-vali
9732299,Túi du lịch Hasun HS-668,206.0,4785816643011,269100,299000,29900,10,73,balo-va-vali
6486773,Túi xách du lịch thời trang HARAS HR224,890.0,1388530534585,129000,129000,0,0,56,balo-va-vali
2297015,Túi bọc bảo vệ vali -Áo vỏ bọc vali - Around-Vuông,292.0,1699487382397,169000,250000,81000,32,21,balo-va-vali
277587015,Túi Tote Nhựa PVC Trong Suốt Họa Tiết Cầu Vồng - Thời Trang Hiện Đại - HÀNG CHÍNH HÃNG MINIIN,1.0,7896581994036,25000,25000,0,0,0,balo-va-vali
276821000,Balo nam thông minh đa chức năng thời trang cao cấp phong cách mới,1.0,3728961873343,332500,350000,17500,5,0,balo-va-vali
276734938,"Balo Nữ Cao Cấp, Balo Nữ Dây Kéo Trước Vải Oxford Chống Thấm, Nhiều Ngăn Rộng Rãi Tiện Dụng, Balo Đi Chơi, Du Lịch, Dã Ngoại ",2.0,4560793806209,180000,180000,0,0,0,balo-va-vali
276409364,"Bộ 11 Lọ Chiết Mỹ Phẩm Du Lịch Tiện Dụng Kèm Túi Đựng 11 Món- Chọn màu-Combo 11 Món Chai Chiết Du Lịch Cao Cấp – Silicone Mềm, Đa Dụng, Chuẩn Mang Lên Máy Bay",13.0,6607471067793,79000,79000,0,0,2,balo-va-vali
275840511,"Set 3 tuýp chiết mỹ phẩm du lịch đựng dầu gội, sữa tắm, lotion, toner 60ML- Bộ chai lọ chiết mỹ phẩm tái sử dụng Phượt Dã Ngoại Đi Chơi Văn Phòng",4.0,1780822794328,100000,100000,0,0,0,balo-va-vali
275380973,Ổ KHOÁ MINI KHOÁ VALI DU LỊCH COLUM,27.0,2854881682435,34000,34000,0,0,3,balo-va-vali
275249439,"Gối Kê Cổ Chữ U Văn Phòng, Gối Du Lịch Bamozo Tiện Dụng Chống Mỏi Vai Gáy",6.0,8745827780746,99000,159000,60000,38,1,balo-va-vali
275150893,VALI KHUNG NHÔM NV SIZE 20 INCH & 24INCH & 29INCH CAO CẤP BO 4 GÓC BẢO HÀNH 10 NĂM,2.0,3617127540260,834000,1390000,556000,40,2,balo-va-vali
275128264,"Balo Nam Đa Chức Năng Teement, Đựng Vừa Laptop 15.6 Inch Siêu Nhẹ, Chống Xước , Chống Nước Hiệu Quả - Hàng Chính Hãng",9.0,8539608205629,250000,250000,0,0,1,balo-va-vali
275056361,Balo laptop 16inh đi học đi chơi đi làm thời trang cao cấp phong cách mới,3.0,3237365129967,351500,370000,18500,5,2,balo-va-vali
187657723,Balo nữ sinh đi học đi chơi đi làm không thấm nước cao cấp phong cách hàn quốc,91.0,4370196900472,375250,395000,19750,5,24,balo-va-vali
185910043,"Balo laptop nam đa chức năng cao cấp phong cách mới 15.6""",21.0,2828452727192,456000,480000,24000,5,3,balo-va-vali
188427287,Balo nữ kết hợp túi đeo vai nữ thời trang cao cấp phong cách mới,19.0,8323988189599,503500,530000,26500,5,8,balo-va-vali
263693619,"Vali kéo Droyce AMERICAN TOURISTER - MỸ Vali kéo vải có thiết kế thời trang, hiện đại và trọng lượng nhẹ Khóa kéo chống trộm DUOSAF tăng cường bảo mật Khóa số tích hợp TSA an toàn tiêu chuẩn Hoa Kỳ",3.0,3040554707079,2646000,4900000,2254000,46,0,balo-va-vali
274807234,Túi Đựng Mỹ Phẩm Vãi Lưới Thoáng Khí TRAVELBAG - Hàng chính hãng,5.0,8493785162918,119000,182000,63000,35,1,balo-va-vali
274357111,Vali khung nhôm khóa sập Bamozo 9066 size 20/24/28 inch cao cấp bịt 4 góc kim loại chống va đập bảo hành 5 năm,50.0,1436648405215,749000,1250000,501000,40,7,balo-va-vali
273909943,Balo du lịch gấp gọn chống nước 22L NatureHike NH17A017-B,12.0,5742829818003,350000,350000,0,0,0,balo-va-vali
273674035,"Túi chống sốc laptop, bao chống sốc máy tính xách tay mỏng gọn nhẹ chống nước - Hàng chính hãng",3.0,1070397096417,199000,199000,0,0,0,balo-va-vali
273381445,"[CHỌN MÀU]-Ổ khóa số 3 mật mã dành cho vali, balo, cặp xách, tủ đồ nhỏ 5.3x2cm- Ổ khóa vali du lịch- Khóa hành lý số",10.0,2994456350908,59000,59000,0,0,2,balo-va-vali
273380997,"[CHỌN MÀU]- Ổ khóa vali có mật mã, 4 số không cần chìa 8x4.3cm-Ổ khóa số dành cho vali/ balo du lịch",16.0,8836185113584,69000,69000,0,0,1,balo-va-vali
263033625,Ba lô nữ thời trang công sở cao cấp phong cách mới,3.0,8015105067120,408500,430000,21500,5,0,balo-va-vali
249019368,"Túi trống túi xách du lịch đựng đồ thể thao tập gym, yoga, đá bóng nam nữ có ngăn đựng giày ngăn chống nước",2.0,7677701308739,125000,125000,0,0,0,balo-va-vali
222703393,Balo nữ thời trang cao cấp phong cách mới,7.0,9204707155329,370000,370000,0,0,2,balo-va-vali
216463864,"Túi Du Lịch - Túi Đựng Phụ Kiện Công Nghệ,Thẻ Nhớ, Ổ Cứng, Pin Sạc Dự Phòng, Điện Thoại, Cáp Sạc USB, Tai Nghe, Túi Đựng  Nhỏ Gọn Có Quai Xách ",86.0,4046912757420,75000,75000,0,0,8,balo-va-vali
216210612, Balo American Tourister Zork 2.0 Backpack 2 AS,2.0,1630330087324,1890000,2700000,810000,30,0,balo-va-vali
213587684,"Túi chống sốc, túi đựng dành cho máy tính bảng các loại 10.8 inch - 13 inch có nhiều ngăn riêng biệt, vải chống thấm, chống mài mòn – Hàng chính hãng",70.0,7922055648694,149000,149000,0,0,12,balo-va-vali
200621700,Túi chống sốc dành cho ipad cho macbook laptop surface da lộn chống nước lót lông siêu dày - Hàng chính hãng,11.0,4036331870629,175000,175000,0,0,1,balo-va-vali
195687692,Balo nam thời trang cao cấp phong cách mới,57.0,8989522705932,370500,390000,19500,5,9,balo-va-vali
194041528,"Balo Nam, Nữ Công Sở Đa Năng Teement, Đựng Vừa Laptop - Macbook - Máy Tính Xách Tay, Chất Liệu Vải Cao Cấp Chống Thấm Nước, Chống Xước, Có Cổng Sạc USB Tiện Lợi - Hàng Chính Hãng",82.0,5132255532575,250000,250000,0,0,21,balo-va-vali
192583198,"Túi đựng mỹ phẩm du lịch WashBag DẠNG HỘP có quai xách mini trong suốt, Túi đựng đồ trang điểm makup chống nước - Chính Hãng ",79.0,1680327268152,69000,138000,69000,50,10,balo-va-vali
183791755,"Túi chống sốc Laptop, Túi chống sốc Mac-book cao cấp (nhiều kích thước) - Bảo vệ chống va chạm, Chống thấm nước - Hàng chính hãng VinBuy",875.0,3252430407950,125000,190000,65000,34,111,balo-va-vali
173731769,"Túi đựng mỹ phẩm, đồ trang điểm đi du lịch trong suốt, chống thấm nước tiện dụng - HENRYSA",81.0,7708131724057,49500,65000,15500,24,14,balo-va-vali
169331134,Balo nam nữ vải canvas cao cấp phong cách mới,6.0,2797541632631,473100,498000,24900,5,1,balo-va-vali
145627465,MTS4 - 34x23 cm - 25 Túi chống sốc bọc bóng khí,228.0,3374019935869,90000,90000,0,0,3,balo-va-vali
98605526,"Balo nam, nữ thời trang đa năng - Balo Laptop - Macbook 15.6 inch chất liệu cao cấp chống thấm Besti - Hàng Chính Hãng",386.0,8051565470910,230000,230000,0,0,100,balo-va-vali
74258075,"Túi Đựng Đồ Cá Nhân Du Lịch , Túi Đựng Mỹ Phẩm Kiểu Hàn Quốc 2021 - MP001",57.0,8995782587974,50000,50000,0,0,6,balo-va-vali
72635702,"Túi chống sốc cho macbook 13 inch, 14 inch, 15 inch, bao chống sốc chất liệu polyster, chống thấm nước (nhiều inch để chọn)",457.0,1054946606481,175000,250000,75000,30,107,balo-va-vali
72167877,"Balo dây rút vải, vải dù, vải bố, vải thun, vải nỉ, đựng giấy tờ A4, laptop, quần áo, giày thể thao",497.0,3500510782405,75000,150000,75000,50,118,balo-va-vali
72094674,túi xách - túi chống sốc cho laptop 14 inh cao cấp phong cách mới,82.0,3581660043332,313500,330000,16500,5,23,balo-va-vali
35314613,Túi Y Tế Gia Đình Omron,50.0,2382190294505,125000,125000,0,0,7,balo-va-vali
32460218,Balo Đi Học Thời Trang Hàn Quốc Praza - BL176 ,1224.0,4647993557867,169000,169000,0,0,135,balo-va-vali
7462853,Túi bọc bảo vệ vali -Áo vỏ bọc vali - Sóng Biển,146.0,5168151714292,169000,232000,63000,27,10,balo-va-vali
2298707,Túi bọc bảo vệ vali -Áo vỏ bọc vali - Summer,188.0,7089037352316,169000,250000,81000,32,12,balo-va-vali
2229719,Balo SimpleCarry B2B04 (11.5 x 41 cm),27.0,5452711958814,590000,590000,0,0,2,balo-va-vali
277310914,"Balo cầu lông chống nước để vợt Pickleball Tennis Badminton, ba lo thể thao đựng giày dụng cụ Sport Bag 47*19*31CM phong cách siêu đẹp",9.0,3117540447060,395000,700000,305000,44,0,balo-va-vali
276838093,"Túi Chống Sốc Laptop 14 inch 15.6 inch Cao Cấp Chống Thấm Nước, Thời Trang, Nhiều Màu Sắc Cá Tính, Vải Trơn Mịn Sịn",6.0,4723550396411,115000,115000,0,0,0,balo-va-vali
276756827,Vỏ Bọc Hộ Chiếu PVC Bao Passport Cover Chống Bụi Bẩn Trong Suốt Có Ngăn Đựng Thẻ Tiện Lợi,34.0,4182145811119,12500,20000,7500,38,0,balo-va-vali
276552415,Balo Du Lịch Xếp Gọn Siêu Nhẹ Naturehike 22L NH17A017-B,12.0,8491400718295,350000,350000,0,0,2,balo-va-vali
275420477,Túi xách tay du lịch nam nữ 2 TẦNG gấp gọn cỡ size to lớn đựng nhiều đồ cá nhân MySun,2.0,8477442490921,169000,220000,51000,23,0,balo-va-vali
275335390,Combo 6 túi đựng đồ du lịch xếp gọn gàng trong vali chống thấm,15.0,1961100205840,150000,150000,0,0,2,balo-va-vali
275287268,"Túi Trống Thể Thao Tập GYM, Đá Bóng Có Ngăn Đựng Giầy Vải Dầy Cao Cấp",5.0,5853035949679,139000,139000,0,0,1,balo-va-vali
275246442,Hộp Đựng Bàn Chải Kem Đánh Răng Có Thể Làm Cốc Nước Súc Miệng Tiện Lợi Đi Du Lịch - Hộp ĐỰng Bàn Chải Du lịch Đa Năng - Hàng Chính Hãng MINIIN,4.0,6169871243027,35100,35100,0,0,0,balo-va-vali
275163472,Balo laptop du lịch HS 2001,118.0,8099163578035,332100,369000,36900,10,47,balo-va-vali
274470016,"Áo bọc vali trong suốt, nhiều size- CHỌN SIZE- Bao trùm vali chống trầy xước đủ cỡ 18- 20-22-24-26-28-30 inch -Hàng chính hãng",82.0,6838421017602,109000,182000,73000,40,5,balo-va-vali
273984457,"Túi Trong Suốt Đựng Mỹ Phẩm, Đồ Trang Điểm Đi Du Lịch Chống Thấm Nước - Henrysa",21.0,4005199983656,36300,50000,13700,27,3,balo-va-vali
273232138,"Set 4 tuýp chiết mỹ phẩm du lịch đựng dầu gội, sữa tắm, lotion, toner 60ML- Bộ chai lọ chiết mỹ phẩm tái sử dụng",26.0,8279185707119,69000,69000,0,0,2,balo-va-vali
258369934,Dây đai ràng vali dây đai hành lý,38.0,1436513933243,50000,50000,0,0,3,balo-va-vali
253110422,"Balo Nữ Cao Cấp Teement, Balo Hàn Quốc Dây Kéo Trước Nhiều Ngăn Chứa Cho Nữ, Vải Oxford Chống Thấm, Nhiều Ngăn Rộng Rãi Tiện Dụng, Balo Đi Chơi, Du Lịch, Dã Ngoại - Hàng Chính Hãng",37.0,2665706775252,150000,150000,0,0,9,balo-va-vali
252673851,Túi Đựng Đồ Lót Đi Du Lịch Nhiều Ngăn Nhỏ Gọn Không Thấm Nước Tiện Dụng,17.0,3341474760433,94000,94000,0,0,0,balo-va-vali
242504242,"Balo laptop nam nữ đa chức năng cao cấp phong cách mới 15.6""",3.0,9931592072659,370500,390000,19500,5,0,balo-va-vali
209379444,Vali Nhôm Nguyên Khối Khóa Sập NiceVilla 20inch-24inch-29inch,86.0,5757550489696,2200000,2200000,0,0,22,balo-va-vali
197500041,"Túi Chống Sốc Laptop Cao Cấp Teement , Lót Trong Dày, Chống Xước, Chống Thấm Nước, Công Nghệ Giảm Chấn Bảo Vệ Laptop, Chống Va Đập Máy Tính An Toàn Hiệu Quả, Dành Cho Laptop ,13,14,15,15.6inch - Hàng Chính Hãng",98.0,2396180595279,250000,250000,0,0,12,balo-va-vali
192630380,túi xách du lịch thể thao nam kiêm balo du lịch cao cấp phong cách mới,14.0,8650646401571,883500,930000,46500,5,5,balo-va-vali
189885668,"Túi Chống Sốc Da Kai Mẫu Ngang Dành Cho Macbook - iPad - Laptop, Surface Chống Nước Nắp Đậy Nam Châm- Hàng chính hãng",11.0,7305978340188,329000,329000,0,0,2,balo-va-vali
186860669,Balo laptop nam 17.3 inh đa chức năng cao cấp phong cách ca tính mới,57.0,6627869139659,513000,540000,27000,5,15,balo-va-vali
185949127,"Túi chống sốc macbook 13 và 13,3 inh cao cấp lót dày, công nghệ giảm chấn bảo vệ laptop, chống va đập máy tính an toàn hiệu quả",146.0,7864609285445,256500,270000,13500,5,17,balo-va-vali
183338620,"Túi Chống Sốc Laptop Macbook 13inch, 14 inch, 15.6 inch, 17inch - TXTK092",194.0,8507987250805,49000,49000,0,0,26,balo-va-vali
174023385,Balo laptop thời trang nam nữ đi học chống nước đa năng BLLT0010,17.0,3265433491340,390000,390000,0,0,8,balo-va-vali
167410361,Túi Đựng Mỹ Phẩm PaKaSa - Hàng Chính Hãng ,42.0,1410299274134,69000,138000,69000,50,8,balo-va-vali
144505664,"Túi Chống Sốc dành cho Laptop 11.6""/13.3""/14"" /15.6"" TARGUS City Gear 3 - Hàng Chính Hãng",85.0,7800213140461,394000,394000,0,0,13,balo-va-vali
133811312,"Hộp Đựng Bàn Chải , Kem Đánh Răng ( Thân Hộp Có Thể Sử Dụng Như Ly ) - Thích Hợp Với Những Chuyến Du Lịch , Công Tác - Chính Hãng",75.0,7644488832146,39000,78000,39000,50,5,balo-va-vali
94685564,"Túi Đựng Bảo Vệ Phụ Kiện Công Nhệ Cao Cấp Chống Nước , Túi Du Lịch , Túi Công Sở Văn Phòng",332.0,3140632887028,155000,155000,0,0,73,balo-va-vali
85698834,Vali du lịch cao cấp Size 20inch- Chất lượng cao  KS-155,2123.0,8590483723827,343000,368000,25000,7,254,balo-va-vali
78022701,"Túi xách - túi chống sốc cho laptop 15,6"" cao cấp phong cách mới",105.0,4625796836192,313500,330000,16500,5,25,balo-va-vali
77326476,"Balo nam thời trang cao cấp phong cách mới 15,6""",100.0,3843334991350,370500,390000,19500,5,28,balo-va-vali
74491832,Túi Xách Du Lịch Cỡ Lớn Thời Trang HARAS HR272,259.0,4518026337803,170000,170000,0,0,75,balo-va-vali
68752056,Vali nhựa du lịch size ký gửi hành lý 24inch 60cm i'mmaX X12,100.0,1592104451844,570000,570000,0,0,41,balo-va-vali
44472717,Túi bọc bảo vệ vali -Áo vỏ bọc vali - Chuột H109,67.0,5507055581317,169000,250000,81000,32,9,balo-va-vali
38064939,Balo Laptop 15.6 Inch Thời Trang Cao Cấp SAKOS Agatha - Hàng Chính Hãng,68.0,2254279626517,1050000,1050000,0,0,28,balo-va-vali
22022072,Balo Nữ Yuumy YBA5 (34 x 17 cm),1585.0,9199630787281,250000,500000,250000,50,635,balo-va-vali
10186846,Balo Laptop có cáp sạc HARAS HRTK237,1098.0,5954329105845,200000,200000,0,0,79,balo-va-vali
9797956,Túi du lịch HARAS HRTK0231,309.0,3923960720986,250000,250000,0,0,45,balo-va-vali
4720129,Túi xách du lịch Sakos Balancer ,44.0,2045695509740,1990000,1990000,0,0,14,balo-va-vali
771419,"Balo Laptop Haras HRTK099 15.6"" - Xanh",1484.0,7107060550032,200000,200000,0,0,94,balo-va-vali
277564086,"Balo Cầu Lông Thể Thao nhiều màu hottrend, đựng giày vợt cầu lông Tenis bóng bàn Size lớn 47*19*31cm, balo học sinh sinh viên sport bag",2.0,5279136953809,394000,700000,306000,44,1,balo-va-vali
276811646,"Balo Thể Thao Đựng Vợt Pickleball , Cầu Lông , Tennis, Bá bóng Hoặc để đồ đi du lịch thoải mái, KT 45x35x25 cm",6.0,6319569917807,229000,229000,0,0,0,balo-va-vali
276651252,Vali Doanh Nhân - Vali nhựa NiceVilla Size 20inch,5.0,1886954167435,234000,312000,78000,25,0,balo-va-vali
276285577,"Balo du lịch, balo phượt, balo leo núi thể thao phong cách mới - BEE GEE BLLN1035",3.0,2198500478124,650000,1300000,650000,50,1,balo-va-vali
275399599,"Túi xách chống sốc máy tính laptop surface, túi công sở nam nữ đeo chéo cặp đựng laptop",2.0,6576041092461,320000,320000,0,0,0,balo-va-vali
275283013,Túi tập gym túi xách thể thao túi đá bóng siêu đẹp có ngăn giày riêng,7.0,7614535361569,105000,105000,0,0,2,balo-va-vali
275267000,Túi xách du lịch size lớn - Túi đeo vai siêu nhẹ - Túi xách du lịch không thấm nước - HENRYSA,6.0,6467734396482,69000,80000,11000,14,0,balo-va-vali
274842649,Túi Nhựa Dây Rút Đựng Đồ Du Lịch Chống Nước,48.0,3549051020575,19950,21000,1050,5,2,balo-va-vali
273698299,"Túi đựng mỹ phẩm RONCATO IRONIK 2.0 BEAUTY CASE, Vải chống thấm nước, Thương hiệu Ý",3.0,5742836051033,1300000,1300000,0,0,0,balo-va-vali
273479723,"Túi Trùm Vali Gấp Gọn STARGO - Chống Nước, Chống Trầy Xước",6.0,8868346255484,128000,160000,32000,20,0,balo-va-vali
273358095,"Túi xách túi chống sốc cho laptop 14,1 và 15,6 inh và 16.1 inh cao cấp phong cách mới",9.0,5543692113435,427500,450000,22500,5,2,balo-va-vali
272694932,"Túi xách - túi chống sốc cho laptop 13.3 INCH, 13.3 INCH, 14.1-15.4 INCH, 16 INCH cao cấp phong cách mới - TL0127",94.0,3072450208125,290000,580000,290000,50,10,balo-va-vali
271983299,Túi đựng giày dép dây rút TRIP gấp gọn tiện dụng,15.0,8178980208584,30000,30000,0,0,0,balo-va-vali
271793657,Vali kéo Brothers 701 - chất liệu nhựa dẻo PP cao cấp chống bể vỡ,3.0,4622564027000,1300000,1300000,0,0,1,balo-va-vali
253324959,Túi Du Lịch Trong Suốt Có Quai Xách Bằng Nhựa PVC,75.0,9389452234990,7600,8000,400,5,0,balo-va-vali
252576355,Túi Đựng Giày Mia Pack-it shoes bag II S Orange,47.0,4380530410339,149000,149000,0,0,0,balo-va-vali
217206100,Túi Đựng Y Tế - Túi Đựng Thuốc Cá Nhân - Túi Y Tế Du Lịch Nhỏ Gọn Mẫu Mới,170.0,3067812937917,99000,99000,0,0,21,balo-va-vali
208404962,Bộ chiết mỹ phẩm du lịch 5 món nhỏ gọn tiện lợi - Henrysa,30.0,3644237970473,35000,58000,23000,40,2,balo-va-vali
198768648,"Vali du lịch SKYWAY GLACIER BAY - Size 20/24/28 inch - Chống va đập, hạn chế trầy xước, Thương hiệu Mỹ",19.0,4890979173551,3500000,3500000,0,0,9,balo-va-vali
196159039,"Túi Xách Du Lịch Đa Năng Cao Cấp Teement, Có Ngăn Đựng Giày Riêng Biệt, Ngăn Chống Thấm Nước - Hàng Chính Hãng",57.0,3738536418615,320000,320000,0,0,5,balo-va-vali
196002059,"Vali du lịch thời trang Bamozo 8812 size 20/24 , vali nhựa kéo được bảo hành 5 năm.",311.0,4255814050381,439000,749000,310000,41,81,balo-va-vali
192134398,Balo laptop đa năng màu đen trơn hàng chính hãng YVan 213,7.0,4786387619815,580000,580000,0,0,1,balo-va-vali
190701837,Vali Kéo Du Lịch MIA Pisani X9 YG1849A Khoá Khung Bảo Mật Chắc Chắn,22.0,2257799152644,4612000,4612000,0,0,7,balo-va-vali
190229763,"Balo Nam, Nữ Thời Trang Đa Năng, Balo Laptop Thời Trang Đi Học Cao Cấp Teement Chống Nước Cổng Sạc USB 9003 - Hàng Chính Hãng",70.0,9951893652050,350000,350000,0,0,13,balo-va-vali
189473456,Áo trùm vali immax vải không dệt,76.0,4417106622076,50000,50000,0,0,6,balo-va-vali
187009931,TẶNG DÂY ĐAI - Vali kéo i'mmaX Z1100 nhựa PC/ABS chống va đập có đủ size 20-24inch - Bảo hành 3 năm - Hàng chính hãng,32.0,7965339353876,570000,570000,0,0,9,balo-va-vali
185978071,Balo laptop 17.3 inh đa chức năng cao cấp phong cách mới,102.0,6699409538603,460750,485000,24250,5,25,balo-va-vali
185271864,"Túi Chống Sốc Laptop Teement TM01 2 Ngăn Có Quai Xách Đứng, Vân Da Mịn Chất Liệu Da Chống Thấm Nước Bảo Vệ Cho Macbook, Laptop, 13 Inch, 14 Inch, 15 Inch, 15.6 Inch- Hàng Chính Hãng ",157.0,9078292278760,270000,270000,0,0,21,balo-va-vali
173404690,"Balo Túi Xách Du Lịch Vải Dù Chống Nước, Túi Đựng Đồ Tập Gym Vải Polyeste (45x24cm) - Hàng loại 1 - Chính Hãng MINIIN",8.0,5621200409525,99000,99000,0,0,6,balo-va-vali
170601088,Túi Trùm Chống Xước Cho Vali Cao Cấp Bamozo TT01,863.0,4584258900256,39000,49000,10000,20,36,balo-va-vali
166474859,"Balo nam chống trộm chống nước cao cấp phong cách mới 15,6""",58.0,8434742743260,399000,420000,21000,5,20,balo-va-vali
137527486,Túi chống sốc laptop - túi đựng laptop 14inch - 15.6in 0131,207.0,1890400161839,109000,218000,109000,50,41,balo-va-vali
135628142,Vali kéo du lịch Kingsun xách tay máy bay size 20inch KS-219-Xanh lam nhạt,87.0,1825848537745,343000,378000,35000,9,16,balo-va-vali
112085286,Balo nam thông minh đa năng cao cấp phong cách mới,83.0,3649614286745,427500,450000,22500,5,21,balo-va-vali
53519628,"Bộ Balo Laptop (15.6"") + Túi Messenger HARAS HR191HR118 - Xám",188.0,1186918590280,250000,250000,0,0,9,balo-va-vali
49124279,Balo Laptop 15.6 Chính Hãng Kim Long KL024,76.0,8990791804623,380000,380000,0,0,28,balo-va-vali
23478175,Khóa vali du lịch Yale Y-NOVELTY-2,18.0,9861797833315,109000,109000,0,0,1,balo-va-vali
23014395,Balo Laptop Mikkor The Royce Delux (42 x 27 x 11 cm),7.0,9843537063534,690000,690000,0,0,1,balo-va-vali
7462917,Túi bọc bảo vệ vali -Áo vỏ bọc vali - Ticket,169.0,9652521007375,169000,250000,81000,32,9,balo-va-vali
4210881,Balo laptop Simplecarry B2B05 ,4.0,7809059460581,580000,580000,0,0,1,balo-va-vali
276885876,"Vali Du Lịch Lug Lusetti S20/S24/S28 MH047 Nhựa ABS Hạn Chế Trầy Xước, Khóa Số Bảo Mật An Toàn",1.0,1732151539348,938000,2780000,1842000,66,0,balo-va-vali
276828721,"Túi đựng mỹ phẩm ,dạng hộp ,nắp khóa ,có quai xách , móc treo tiện dụng , hợp đi  du lịch ,dạo phố , đi biển  , thiết kế sang trọng chống thấm nước ",1.0,9216450375720,113050,119000,5950,5,0,balo-va-vali
276777444,Túi Zip Đựng Quần Áo Mỹ Phẩm Đồ Lót Du Lịch Ziplock Mờ Lưu Trữ Đồ Khoá Kín Chống Thấm Tiện Lợi,10.0,3002410535440,5800,9000,3200,36,0,balo-va-vali
276070527,"Remote máy lạnh, remote điều hòa điều khiển tất cả máy lạnh nội địa Nhật, Việt Nam các loại đa năng có clip HDSD",6.0,7277066980873,18000,18000,0,0,0,balo-va-vali
275724327,AS - BALO V2,39.0,5471154401961,289000,289000,0,0,0,balo-va-vali
275521940,Vali khung nhôm khóa sập Bamozo 9066 size 20/24/28 inch bịt 4 góc kim loại chống va đập bảo hành 5 năm - BẢN THƯỜNG,9.0,2878382431568,649000,1150000,501000,44,0,balo-va-vali
275351148,"Túi Đựng Giày Dép Du Lịch,Túi Bảo Quản Giày Dép Gắn Vali Du Lịch,Thể Thao Tiện Dụng 3 Ngăn Chống Nước - HENRYSA",27.0,7967306655921,109000,150000,41000,27,2,balo-va-vali
260920159,Túi bảo vệ máy tính bảng 7.9/8 inch và 10.8/11inch lót dày chống sốc cực tốt,27.0,7007049290716,180500,190000,9500,5,2,balo-va-vali
249214113,Balo Đi Học Hàn Quốc Ulzzang Thời Trang Nam Nữ Youbaili Deli - Phù Hợp Cho Học Sinh Cấp 2 Cấp 3 Tiểu Học Trung Học Sinh Viên Chống Nước Đựng Được Laptop Đi Chơi Du Lịch Dễ Thương Cute Nhiều Màu Cá Tính Unisex Nam Nữ,9.0,4839843069131,249000,556200,307200,55,1,balo-va-vali
249156423,"Túi chống sốc laptop surface, bao chống sốc laptop mỏng gọn nhẹ",4.0,7020915761426,225000,225000,0,0,1,balo-va-vali
247796308,"Vali khung nhôm khóa sập size 20/24, bịt 4 góc kim loại KS-051",17.0,6729858288762,654000,1069000,415000,39,6,balo-va-vali
217728229,Túi xách du lịch thể thao nam đa năng cao cấp phong cách mới,9.0,4376624105635,465500,490000,24500,5,1,balo-va-vali
217219088,Hộp Đựng Y Tế Cho Gia Đình và Du Lịch Nhỏ Gọn Chống Nước và Chống Va Đập  - Túi Đựng y tế /Thuốc Nhỏ Gọn,59.0,1549425857888,85000,85000,0,0,8,balo-va-vali
192710343,"Balo nữ sinh đi học không thấm nước cao cấp phong cách hàn quốc 15.6""",19.0,5501111676143,408500,430000,21500,5,9,balo-va-vali
188660238,Balo nữ 100% da thật hàng cao cấp phong cách cá tính mới,11.0,6083316765777,693500,730000,36500,5,4,balo-va-vali
185947268,"Túi chống sốc macbook và laptop 15 và 15,6 inh cao cấp lót dày, công nghệ giảm chấn bảo vệ laptop, chống va đập máy tính an toàn hiệu quả",29.0,8252706007993,256500,270000,13500,5,3,balo-va-vali
184906825,Vali du lịch BAMOZO 8801 vali kéo nhựa được bảo hành 5 năm,3426.0,2663424525635,379000,580000,201000,35,471,balo-va-vali
184816905,Vali du lịch BAMOZO cao cấp 8801 vali kéo nhựa được bảo hành 5 năm,420.0,9746009324328,399000,700000,301000,43,94,balo-va-vali
181122639,Vali Kéo Du Lịch Pisani LANI 3 SIZE 20/24/28 Thời Trang Hạn Chế Bể Vỡ- Bảo Hành Trọn Đời,66.0,6982255884966,2530000,2530000,0,0,19,balo-va-vali
175887647,"Balo Du Lịch Cao Cấp Hasun HXK bền bỉ, chắc chắn - Hàng Chính Hãng",155.0,1578946968441,368100,409000,40900,10,38,balo-va-vali
171762214,Vali du lịch kéo cao cấp Size 24inch- Chất lượng cao  KS-155 - Vàng,160.0,6335389330958,443000,468000,25000,5,6,balo-va-vali
171573411,Vali kéo du lịch cao cấp bảo hành chính hãng Size 24inch KS-219 - Trắng Sữa,41.0,8628645706045,484000,499000,15000,3,4,balo-va-vali
169339506,Túi xách chính hãng TOMTOC (USA) Briefcase Premium - H21-C01 cho Macbook 13 - 14 inch/Ultrabook 13 inch,5.0,3245997946115,1290000,1290000,0,0,1,balo-va-vali
165092013,"Áo trùm vali chống trầy trong suốt- Bọc bảo vệ vali nhựa PVC cao cấp - Vỏ bọc vali trong suốt tiện lợ- Áo phủ vali chống nước, chống bụi",852.0,2301718586671,99750,99750,0,0,81,balo-va-vali
160148239,Bộ túi đựng đồ du lịch 7 món May 10 mã 369/18,7.0,8804358503398,250000,250000,0,0,0,balo-va-vali
155224163,Túi rút thể thao chống thấm BZH001,9.0,7919539790166,15000,20000,5000,25,1,balo-va-vali
126699572,"Bao da, cặp da chống sốc, chống nước cho Surface Go, Surface Pro 3, 4, 5, 6, 7 - Hàng chính hãng",26.0,1098069171750,399000,399000,0,0,2,balo-va-vali
90476326,Balo nam thông minh đa năng cao cấp chống trộm và chống nước,97.0,3382434100125,655500,690000,34500,5,32,balo-va-vali
87895768,"Túi đựng mỹ phẩm, túi đồ du lịch cá nhân tiện lợi chống nước và bụi bẩn MP01",178.0,4571112849342,125000,125000,0,0,35,balo-va-vali
66233031,BALO LAPTOP 17 INCH MR VUI 776,64.0,8662613378215,629100,699000,69900,10,28,balo-va-vali
58699493,"Balo Laptop Du Lịch Thời Trang Cao Cấp SAKOS FRONTIER Dành Cho Laptop 14 Inch (14"")",26.0,4210799592990,664000,830000,166000,20,10,balo-va-vali
58025051,"Balo Nam Thời Trang Du Lịch Cỡ Lớn Vải Bố Canvas Bền Chắc Phong Cách mới Dành Cho Đi Học, Dã Ngoại, Đi Phượt, Đựng Laptop (14-17"")",47.0,7111577485404,446500,470000,23500,5,30,balo-va-vali
54159671,Balo nữ đi học kiểu dáng Hàn Quốc,13.0,3386706854053,169000,169000,0,0,4,balo-va-vali
50490162,Ba lô du lịch thể thao nam công suất lớn phong cách châu âu hiện đại đã tích hợp công nghệ 4.0,83.0,1860419749216,949050,999000,49950,5,28,balo-va-vali
48161461,Ba lô thông minh đa năng siêu cao cấp nam sạc USB tiện dụng chứa máy tính 14 đến 17 inh,92.0,5890480222307,465500,490000,24500,5,35,balo-va-vali
39377570,"Túi Đeo Tay Chạy Bộ Đựng Điện Thoại Chống Sốc Đa Năng Quấn Bắp Tay Cho Chạy Bộ, Đi Bộ, Tập Thể Thao, Tập Gym - Mai Lee",729.0,8270890984595,28400,28400,0,0,62,balo-va-vali
20241668,"Vali Kéo Vải Du Lịch SAKOS  ELITE 6 - Size M (24inch)/ Ký Gửi (Trung) - Khóa TSA - Chống Thấm, Trượt Nước",13.0,2965422631141,2999000,2999000,0,0,2,balo-va-vali
5839905,"Túi đựng Macbook Air, Pro cao cấp 13.3 inch Chống Sốc 2 Ngăn (ghi xám) - Hàng Chính Hãng",43.0,8909018416556,114000,120000,6000,5,16,balo-va-vali
3015491,Túi Hộp Bút Mikkor Penbox (18 x 7 x 4 cm),6.0,6981324628474,179000,179000,0,0,1,balo-va-vali
574376,Cặp Laptop Sakos Astro i15 SVO038BKNG01,30.0,7100470002580,1499000,1499000,0,0,2,balo-va-vali
277361630,Balo nam balo laptop nam công sở chống trộm chống nước thời trang cao cấp phong cách mới,1.0,3043175459098,693500,730000,36500,5,0,balo-va-vali
277017130,[QUÀ TẶNG - MÀU NGẪU NHIÊN] Bao da Passport chữ nhật IDIGO FW2-001,1.0,5365602436741,90000,90000,0,0,1,balo-va-vali
276636655,Hộp nhựa hình tròn chia 7 ngăn đựng thuốc uống theo ngày nhiều màu sắc - Giao màu ngẫu nhiên,4.0,5021934947324,19000,38000,19000,50,0,balo-va-vali
276318942,"Túi Đựng Giày Dép Du Lịch HENRYSA , Gắn Vali Du Lịch - Túi Đựng Giày Dép Thể  Thao Tiện Dụng 3 Ngăn Chống Nước",4.0,3561962230646,105000,150000,45000,30,0,balo-va-vali
275934621,Bọc Bánh Xe Vali bằng Silicon Giảm Tiếng Ồn Tiện Dụng STARGO MOLLIS,14.0,8581903357895,74000,99000,25000,25,0,balo-va-vali
275824903,"Vali Kéo Du Lịch S20/S25/S31 Thương Hiệu IT Luggage 12-2894E08: Chất Liệu 100% Từ Chai Nhựa Thải Tái Chế Sau Tiêu Dùng, Khóa TSA An Ninh Quốc Tế",1.0,8704120283184,3900000,7800000,3900000,50,1,balo-va-vali
275287341,"Túi Trống Thể Thao Túi Tập GYM Túi Du Lịch Nam Nữ, Nhiều Màu",4.0,1095096707808,135000,135000,0,0,0,balo-va-vali
275224261,Lọ chiết nước hoa du lịch 5ml (Giao màu ngẫu nhiên),26.0,8595044132472,42000,42000,0,0,2,balo-va-vali
273263626,"Combo 11 Món Chai Chiết Du Lịch Cao Cấp – Silicone Mềm, Đa Dụng, Chuẩn Mang Lên Máy Bay",25.0,7397189990472,79000,79000,0,0,0,balo-va-vali
252773239,"Vali Kéo LUG Aber S20/S24/S28 MHL027: Nhựa ABS Hạn Chế Trầy Xước, Khóa Số Bảo Mật An Toàn",24.0,2172993150609,738000,2400000,1662000,69,5,balo-va-vali
251394127,Balo Da Đựng Laptop 15.6 Inch Nhiều Ngăn Rộng Rãi Rất Tiện Dụng ZBL04,3.0,4228207166178,540000,540000,0,0,0,balo-va-vali
214658607,Túi đeo hông chạy bộ chống nước AOLIKES A-CW2211,15.0,2504282001420,149000,259000,110000,42,1,balo-va-vali
197636758,Túi chống sốc túi xách cho laptop 13 và 13.3 inh cao cấp phong cách mới,8.0,7737879336408,332500,350000,17500,5,3,balo-va-vali
196788353,Set 7 Túi Đựng Đồ Du Lịch Cho Vali KUNBE Nhiều Kích Cỡ Đa Năng Giúp Vali Luôn Gọn Gàng Ngăn Nắp,274.0,2670145349735,135000,135000,0,0,29,balo-va-vali
195694496,Balo laptop 14.1 và 15.6 inh nam nữ thời trang cao cấp phong cách mới ,31.0,2781593711465,444752,468160,23408,5,10,balo-va-vali
193459817,Ví Đựng Hộ Chiếu Da Epsom Handmade Lealux Passport Wallet,1.0,9654250651298,659000,659000,0,0,0,balo-va-vali
192583987,"Túi Đựng Mỹ Phẩm, Đồ Trang Điểm Đi Du Lịch Washbag Trong Suốt Chống Thấm Nước Tiện Lợi Nhiều Kích Thước Nhiều Mẫu Chính Hãng",14.0,6167114800803,49000,49000,0,0,1,balo-va-vali
191628801,"Balo Nam Tích Hợp Khóa Chống Trộm Cao Cấp Teement, Chống Rạch, Chống Nước, Chống Xước Thời Trang Phong Cách Mới - Hàng Chính Hãng",113.0,7743851886397,430000,430000,0,0,23,balo-va-vali
190232145,Túi rút thể thao chống thấm cao cấp 2 mặt màu BZH003,18.0,4880198251147,42000,80000,38000,48,1,balo-va-vali
185967603,"Túi xách túi chống sốc cho macbook và laptop 15,6 inh cao cấp phong cách mới",10.0,5227709975599,304000,320000,16000,5,3,balo-va-vali
184332883,"Balo nữ sinh đi học không thấm nước cao cấp phong cách hàn quốc 15.6""",87.0,1502344405254,361000,380000,19000,5,23,balo-va-vali
179206477,"Balo Nam Chống Thấm Nước, Chống Xước, Chống Trộm, Thoáng Khí  Phong Cách Thời Trang  Besti BTY01 Chất Liệu Vải Cao Cấp Oxford - Hàng Chính Hãng",138.0,8324627690998,240000,240000,0,0,37,balo-va-vali
177827838,Balo laptop nam thông minh đa chức năng cao cấp phong cách mới,0.0,3168836429529,350000,350000,0,0,2,balo-va-vali
177319087,Túi đựng giày bóng đá đeo chéo TN Bags TN.B 9001 túi thể thao mini,5.0,5660854488502,187600,268000,80400,30,2,balo-va-vali
163928160,"Túi Đựng Giày Boots Phong Cách Hàn Quốc, Có Hai Ngăn Riêng Biệt Cho Từng Chiếc Giày",36.0,2254586275626,143000,143000,0,0,0,balo-va-vali
137951164,"Balo Túi Dây Rút Grepaco Vải Dù Bố Canvas Cao Cấp Chống Thấm Nước Mềm Mịn Phong Cách Thời Trang Hàn Quốc Unisex Nam Nữ Đi Học, Chơi, Du Lịch - Hàng Chính Hãng",176.0,2925016343488,99000,99000,0,0,60,balo-va-vali
114661088,[ Combo 5 ] Túi Đựng Giày Vải Không Dệt - Hàng Chính Hãng ,76.0,8266409882436,39000,78000,39000,50,6,balo-va-vali
102810385,(HOT TREND) Balo da cao cấp - Balo nữ thời trang YUUMY YBA4 - balo da bò bền đẹp,1029.0,8563751101540,189000,330000,141000,43,220,balo-va-vali
85050973,Balo thời trang phong cách Hàn Quốc HARAS tặng hộp bút HR280,4.0,6412645990623,350000,350000,0,0,0,balo-va-vali
79666044,Balo du lịch đa năng thông minh cao cấp phong cách châu âu,10.0,5167181998472,1092500,1150000,57500,5,1,balo-va-vali
74884017,Túi xách du lịch thể thao cao cấp phong cách mới,98.0,1615388010054,487350,513000,25650,5,31,balo-va-vali
71340057,"BAO DA, TÚI DA, CẶP DA CHỐNG SỐC CHO MACBOOK, LAPTOP, SURFACE KÈM VÍ ĐỰNG PHỤ KIỆN",23.0,8504181823172,350000,350000,0,0,7,balo-va-vali
70115891,"balo nam -ba lô nam thời trang phong cách mới (15,6"")",62.0,4922702154569,464550,489000,24450,5,23,balo-va-vali
65419924,"Dây đai cố định và bảo vệ vali an toàn mẫu đôi 2m, màu ngẫu nhiên+ Tặng kèm thẻ đeo hành lý ngẫu nhiên",243.0,4815529789307,85000,85000,0,0,15,balo-va-vali
49126213,Balo Du Lịch Nữ Kim Long KL026 Đỏ - Chính Hãng,15.0,3058287299690,479000,479000,0,0,3,balo-va-vali
34822578,"Balo nam thời trang vải canvas BL0018 - đi học, đi làm, đi chơi, đựng laptop",69.0,7032441417942,375000,375000,0,0,7,balo-va-vali
10187501,Combo Balo Laptop Thời Trang HR237 Và Túi Đeo Chéo HARAS HR147,326.0,7583419242726,350000,350000,0,0,34,balo-va-vali
4933081,Cặp Xách Công Sở Thời Trang Cao Cấp SAKOS VIRGO 14 Inch,11.0,9235091276350,1444000,1910000,466000,24,2,balo-va-vali
2296435,"Balo Laptop 15.6 Inch Hasun HS 654 chất vải trượt nước dày dặn, bền bỉ - Hàng Chính Hãng",171.0,8532255957348,422100,469000,46900,10,80,balo-va-vali
277481952,Cặp Đa Năng FRANKI Đựng Laptop 15.6 inch Có Thể Chuyển Đổi Giữa Xách Và Đeo Cao Cấp PRAZA - TXTK098,1.0,3071188712942,299000,479000,180000,38,0,balo-va-vali
277320473,Balo nữ phong cách mới - BEE GEE BLNN9151,1.0,1885082031203,320000,640000,320000,50,0,balo-va-vali
276860346,"Túi đựng mỹ phẩm hoa văn Brahma Flamingo-Giao màu , họa tiết ngẫu nhiên - Hàng chính hãng ",12.0,7690737422995,49000,98000,49000,50,1,balo-va-vali
276727602,"Balo Da Nam Nữ Cao Cấp Chống Thấm Nước HARAS HR341 Đựng được laptop 15.6inch, đi học , đi chơi, đi làm",2.0,8567480530538,279000,279000,0,0,1,balo-va-vali
276463453,"Túi chống sốc laptop surface, túi công sở nam nữ đeo chéo cặp đựng laptop",1.0,8901541127153,290000,290000,0,0,0,balo-va-vali
276455002,"Túi chống sốc laptop surface, túi công sở nam nữ đeo chéo cặp đựng laptop",3.0,5749204307049,290000,290000,0,0,0,balo-va-vali
276330937,Túi Chống Sốc Dành Cho Macbook Laptop TCS - Đen,1.0,5186732194725,179000,179000,0,0,0,balo-va-vali
276101779,"Thẻ Nametag, Thẻ Hành Lý Da Simili SAKOS",4.0,8919740223714,159000,219000,60000,27,1,balo-va-vali
276086623,"REMOTE ĐIỀU KHIỂN MÁY LẠNH ĐA NĂNG, REMOTE MÁY LẠNH, REMOTE ĐIỀU HÒA ĐIỀU KHIỂN TẤT CẢ MÁY LẠNH NỘI ĐỊA NHẬT, VN",3.0,3786619511815,6400,6400,0,0,0,balo-va-vali
275351026,"Túi Đựng Giày Dép Du Lịch 3 Ngăn Chất Liệu Chống Thấm Nước, Túi Để Giày Thể Thao Đa Năng Có Móc Gài Tay Kéo Vali Tiện Lợi - Hàng chính hãng",19.0,7915470850452,113050,176000,62950,36,1,balo-va-vali
275147835,Balo laptop nam đi làm đi chơi đi học thời trang cao cấp phong cách mới,2.0,8044971280629,522500,550000,27500,5,0,balo-va-vali
275125054,"Balo Laptop 14 inch TUCANO COMFORT chất liệu Recycle Plastic thương hiệu Ý, bảo hành 2 năm",1.0,9281575247397,1500000,1500000,0,0,1,balo-va-vali
275089645,Balo laptop chống nước siêu bền – chống trộm – tích hợp USB sạc ngoài phong cách DRU - BL03 - Hàng Chính Hãng,1.0,2927760524862,217600,272000,54400,20,0,balo-va-vali
275087002,Balo Laptop 15.6 inch KINGBAG PONOS- Hàng Chính Hãng,2.0,6591693107396,494000,545000,51000,9,0,balo-va-vali
274672708,Balo nữ thời trang công sở cao cấp phong cách châu âu,5.0,5391241466084,541500,570000,28500,5,2,balo-va-vali
273793147,Balo nam laptop 17.3 inh thông minh đa chức năng thời trang cao cấp phong cách mới,8.0,6236148147158,617500,650000,32500,5,4,balo-va-vali
273640384,"Hộp Đựng Bàn Chải, Kem Đánh Răng, Lược, Khăn Mặt MUDU Thích Hợp Cho Những Chuyến Du Lịch Và Công Tác- Hàng Chính Hãng",30.0,8784459041352,49000,98000,49000,50,5,balo-va-vali
267178223,"Túi lưới đựng đồ trong suốt đa năng A5 có khóa kéo tiện dụng Deli, Túi đựng Bút Viết, Túi đựng Mỹ Phẩm, Túi đựng Đồ dùng cá nhân đi du lịch - Túi sức chứa lớn, không để lại vết hằn khi bị uốn cong",23.0,1145433435804,9000,16200,7200,44,0,balo-va-vali
260919952,Túi bảo vệ máy tính bảng 10.8 và 13inch lót dày chống sốc cực tốt,9.0,4748849947199,256500,270000,13500,5,0,balo-va-vali
257781384,"Balo ulzzang Hàn Quốc, Balo nam nữ đi học cho học sinh sinh viên đựng laptop nhiều ngăn tiện dụng",3.0,1000918878892,169000,169000,0,0,1,balo-va-vali
253329551,Balo nữ thời trang công sở đa năng cao cấp phong cách mới,11.0,8968346329951,332500,350000,17500,5,1,balo-va-vali
212562080,"Túi đựng đồ lót đi du lịch, Túi Đựng áo ngực, Đồ Lót Đi Du Lịch Nhiều Ngăn Nhỏ Gọn Không Thấm Nước Tiện Dụng, túi du lịch tiện lợi, hộp vải đựng đồ đa năng, tủ vải quần áo, hộp vải chia ngăn - Hãng dododios",24.0,6978221535315,113000,113000,0,0,3,balo-va-vali
208269538,Túi xách du lịch thể thao DA BÒ phong cách mới BEE GEE T1033,6.0,9754343542089,620000,1240000,620000,50,2,balo-va-vali
205694412,"Dây Quai Đeo Cặp, Túi Xách Bản Rộng SAKOS",16.0,4887382779788,174000,290000,116000,40,4,balo-va-vali
198192808,Balo Thời Trang Tiện Lợi SAKOS MELODY - Hàng Chính Hãng,30.0,7105913211307,1090000,1090000,0,0,8,balo-va-vali
196727913,Balo nữ sinh đi học đi làm đi chơi – BEE GEE BLTT1007,12.0,1425772759385,340000,680000,340000,50,7,balo-va-vali
190707423,Balo Yuumy ( Thời trang nữ cỡ trung - Balo da Liberal YBA55 ),42.0,1349351965944,245000,490000,245000,50,10,balo-va-vali
182301408,"Túi chống sốc bảo vệ cho Macbook, Laptop 13.3 inch, 14.1-15.4 inch và 15.6 inch có 2 ngăn riêng biệt, chống thấm nước, chống mài mòn phù hợp cho cả nam và nữ FitsAll TCS02",213.0,7925067579542,109000,109000,0,0,31,balo-va-vali
181787698,"Balo cặp xách đa năng, cặp sách học sinh cao cấp, cặp laptop Xbags Simple",1.0,5094896179264,399000,480000,81000,17,0,balo-va-vali
148549607,"Túi Đeo Wiwu Pioneer Handle Bag Dành Cho Laptop, Ultrabook Chất Liệu Vải Cao Cấp, Độ Bền Cao - Hàng Chính Hãng ",1.0,7803109392860,600000,600000,0,0,0,balo-va-vali
145627017,MTS3 - 26.5x18 cm - 25 Túi chống sốc bọc bóng khí,466.0,3365303365419,63000,63000,0,0,5,balo-va-vali
137128040,Túi chống sốc laptop - túi đựng laptop 14inch - 15.6in 0133,90.0,8158315887803,99000,198000,99000,50,15,balo-va-vali
110290360,Túi chống sốc bao da laptop macbook kiêm giá đỡ tản nhiệt kèm ví đựng sạc chuột,334.0,6733598510321,350000,350000,0,0,91,balo-va-vali
78551394,Túi Du Lịch Chống Thấm Mr Vui 105 ,145.0,7633903876032,382500,425000,42500,10,51,balo-va-vali
75759447,Balo Túi Xách Du Lịch KhoNCC Hàng Chính Hãng - Loại Cỡ Lớn Nhiều Ngăn Bằng Vải Dù Cho Du Lịch – Phượt Thủ – KKT-BL-1833D (Nhiều màu),26.0,4213478048986,249000,328000,79000,24,12,balo-va-vali
50910665,Balo laptop 11.4 inch Simplecarry B2b03 - Màu đen - Chất liệu Polyester trượt nước cao cấp,3.0,3751336149631,590000,590000,0,0,1,balo-va-vali
42406981,Túi bọc bảo vệ vali -Áo vỏ bọc vali - Chuột Hoạt Hình H111 Size S M L XL HPValiOEM,3.0,7454912458580,169000,250000,81000,32,0,balo-va-vali
10317836,Túi Xách Du Lịch Thời Trang Cao Cấp SAKOS VIGOR,24.0,2687159680864,1344000,1700000,356000,21,4,balo-va-vali
7459871,Túi bọc bảo vệ vali -Áo vỏ bọc vali - 3 Con Gấu Đứng,158.0,2577050786775,169000,232000,63000,27,14,balo-va-vali
521639,Vali Du Lịch Macat D-ONE (47 x 33 x 23 cm) - Đỏ,29.0,5103100552440,1005000,1005000,0,0,8,balo-va-vali
276919588,[QUÀ TẶNG KHÔNG BÁN] Thẻ Tên Vali Hành Lý,1.0,1795699866271,200000,399000,199000,50,0,balo-va-vali
276824516,Balo laptop nam 17.3 inh đa chức năng cao cấp phong cách mới,2.0,8578830651432,503500,530000,26500,5,0,balo-va-vali
276808731,"Cặp Đựng Tài Liệu, Cặp Đựng Laptop 15.6 Inch, Túi Đeo Vai Công Sở Cao Cấp, Thời Trang Lịch Lãm ",2.0,4796101541607,190000,190000,0,0,0,balo-va-vali
276069411,Túi xách tay đi du lịch đựng chống thấm đa năng đựng mỹ phẩm nhỏ gọn cao cấp có móc treo tiện lợi,22.0,5714416188911,55000,55000,0,0,0,balo-va-vali
275320295,"Đai Chạy Bộ , Túi Chạy Đeo Hông Phản Quang, Túi Đựng Điện Thoai, Bao Điện Thoại Để Nước Giao Màu Ngẫu Nhiên",0.0,5546212366285,54000,54000,0,0,0,balo-va-vali
275287541," Túi trống du lịch thể thao cỡ nhỡ đựng đồ đi chơi, đi làm, đi dã ngoại",5.0,6557762321339,135000,135000,0,0,1,balo-va-vali
275113481,"[CHÍNH HÃNG] Balo laptop 15.6 inch Kingbag Sofia thiết kế thời trang nắp gập hiện đại, phong cách thể thao cá tính phù hợp nam nữ unisex",2.0,8438999924090,595000,595000,0,0,0,balo-va-vali
273851730,"Vali nhựa Mr Vui VLC208 size 20 inch, vali xách tay (54 x 24 x 36 cm)",1.0,6167072706879,1450000,1450000,0,0,0,balo-va-vali
273450882,Balo nam DA BÒ THẬT – BEE GEE BLND9085,2.0,6783949806822,1570000,3140000,1570000,50,0,balo-va-vali
272273299,BA LÔ CÓ CẦN KÉO Z9T siêu nhẹ,6.0,4146939431706,635000,635000,0,0,0,balo-va-vali
272123789,"Túi chống sốc da cặp da chống sốc cho macbook, laptop, surface đeo chéo cute tặng kèm gấu bông",2.0,7285769644773,390000,390000,0,0,0,balo-va-vali
271369550,"Túi đựng mỹ phẩm nhiều ngăn chuyên dụng, túi nữ xách tay đựng đồ vệ sinh cá nhân mang theo du lịch IDIGO FB2-1232",4.0,8320965523841,300000,300000,0,0,1,balo-va-vali
203146673,Túi Xách Du Lịch Size Lớn Rộng Rãi Thoải Mái Cao Cấp PRAZA - TXTK095,4.0,2527580470160,229000,397000,168000,42,1,balo-va-vali
200032482,Balo nam da tự nhiên cao cấp phong cách mới,5.0,8060543314719,375250,395000,19750,5,1,balo-va-vali
197587595,Balo Yuumy ( Thời trang nữ tiện lợi cỡ trung - Balo da Seasand YBA64 ),20.0,3287739997622,275000,550000,275000,50,5,balo-va-vali
196522487,Túi đeo hông chạy bộ AOLIKES A-3310,2.0,2728728978252,179000,259000,80000,31,0,balo-va-vali
191465787,Ba lô du lịch thể thao nam công suất lớn phong cách hiện đại – BLLN1001,3.0,2225478242919,920000,1840000,920000,50,0,balo-va-vali
190319412,"Túi đựng giày bóng đá 2 ngăn, túi thể thao cực chất TN Bags TN.B 9002",1.0,8406779821717,229000,229000,0,0,0,balo-va-vali
187636738,"Balo Laptop 15.6 Inch Mr Vui 990 vải trượt nước, chống bám bụi - Hàng Chính Hãng",192.0,5744068125420,445500,495000,49500,10,77,balo-va-vali
185908379,"Balo laptop đa chức năng cao cấp phong cách cá tính mới 15.6""",7.0,6570435263914,465500,490000,24500,5,1,balo-va-vali
163103225,"Balo đựng laptop nam, balo chống sốc tiện ích đi học, đi làm Xbags Xb 2004",3.0,6167542535099,359000,450000,91000,20,1,balo-va-vali
153978993,Túi chống sốc Laptop 13 inch AGVA Urban Denim - Kích thước Ngang 34 x Rộng 1.5 x Cao 25 cm - Mã LTB262GRE (Xám) - Túi chính hãng bảo hành 2 năm,3.0,9770197132091,420000,420000,0,0,1,balo-va-vali
145619638,MTS0 - 16x11 cm - 25 Túi chống sốc bọc bóng khí,380.0,1735030823524,38000,38000,0,0,6,balo-va-vali
139234157,"Bao da, Túi đựng Nillkin Versatile Laptop Sleeve Water Ripple 14inch 16inch dành cho Macbook Air / Macbook Pro 13 / Surface Laptop / Laptop 13.3inch / Macbook Pro 16 / Laptop 16inch / Laptop Asus / Dell XPS  - Hàng Nhập Khẩu",9.0,7480008687013,579999,579999,0,0,2,balo-va-vali
74488873,"Set 3 túi unisex du lịch đựng đồ dùng cá nhân thẻ tiền, túi đựng mỹ phẩm cho nam nữ đa năng- Hàng chính hãng",405.0,4917353019176,145000,145000,0,0,85,balo-va-vali
72130801,"túi xách du lịch thể thao nam kiêm balo du lịch cao cấp phong cách mới(15,6"")",20.0,9817208231638,949050,999000,49950,5,13,balo-va-vali
57183413,"Balo, Cặp, Túi đựng laptop Chống sốc Lót Lông mềm mịn - Chống nước - Chống xước - Cao cấp , Kích cỡ 15.6 inch",9.0,1490998543938,220500,220500,0,0,5,balo-va-vali
56531302,Ba lô da bò nam công suất lớn phong cách châu âu,12.0,9014794180597,470000,470000,0,0,5,balo-va-vali
50393221,Ba lô da nam công suất lớn phong cách châu âu,45.0,8645237845615,456000,480000,24000,5,13,balo-va-vali
49109898,Balo Laptop Nam Kim Long KL018 Chính Hãng,16.0,5340616557235,360000,360000,0,0,6,balo-va-vali
44270098,Túi Du Lịch Mr Vui DL100 thời trang,24.0,5472198186098,449100,499000,49900,10,9,balo-va-vali
42832894,"Bao đeo tay điện thoại chạy bộ, thể thao Rimix RM5506",578.0,3124513245998,139000,194600,55600,29,147,balo-va-vali
32429472,Bộ 3 món balo thời trang + túi đeo chéo + ví nhỏ love love (xanh trời),3.0,8105714860482,79000,79000,0,0,1,balo-va-vali
32215972,Vali du lịch kéo tay TN 20 inch Đỏ,100.0,8662830062515,268000,268000,0,0,30,balo-va-vali
19741042,"Balo Laptop Du Lịch Thời Trang Cao Cấp SAKOS ZEN Dành Cho Laptop 14 Inch (14"")",35.0,9026936629314,944000,1200000,256000,21,9,balo-va-vali
17956340,Balo Laptop 13 inch chính hãng SimpleCarry M-City,10.0,8351955203216,519200,519200,0,0,4,balo-va-vali
11109562,"Túi chống sốc Tomtoc đựng Máy tính bảng, Surface 10,5-11 inch ",26.0,2304816341882,620000,620000,0,0,4,balo-va-vali
10230706,Balo anello Unisex Vải Polyester 10 Ngăn Đeo 2 Kiểu AT-C1225 (38 x 37 cm),2.0,9679349669349,2130000,2130000,0,0,1,balo-va-vali
10230652,Balo anello Unisex Da PU Cỡ Nhỏ AT-B1212 (24 x 35 cm),1.0,7893417953259,2070000,2070000,0,0,0,balo-va-vali
10169434,Balo laptop Kim Long KL025,7.0,3957369065157,669000,669000,0,0,3,balo-va-vali
277608248,"Túi chống sốc WI WU Alpha Slim Sleeve Túi xách chống sốc có quai xách nhỏ gọn cho Mac book , Laptop 13, 14, 16 inch - Hàng chính hãng",1.0,3806336505421,379000,379000,0,0,0,balo-va-vali
276625247,Vali Nhôm Nguyên Khối Khóa Sập NiceVilla 20inch & 24inch $ 29inch,1.0,5701606752051,1638000,2100000,462000,22,0,balo-va-vali
276625220,Vali Size 24inch Tổng Hợp Nhiều Loại Cho Bạn Chọn Lựa,0.0,6696620687598,262080,336000,73920,22,0,balo-va-vali
276085434,"Bàn Chải Chà Lưng Đa Năng Tháo Ráp Có Tay Cầm, Cây Chà Lưng Tắm Tạo Bọt Cực Sạch Loại Bỏ Bụi Bẩn B122",1.0,1905541421651,37000,37000,0,0,1,balo-va-vali
275888481,"Balo cầu lông thể thao NATOLI đựng giày, đựng vợt cầu lông, chống nước cao cấp BST ProSport Backpack B26",6.0,2013455444252,499100,713000,213900,30,2,balo-va-vali
275507562," Vali Kéo Khung Nhôm Khóa Sập Chống Bể Vỡ, Chống Trầy Xước Size 20inch & 24inch & 28inch",4.0,7979421258277,595000,1190000,595000,50,3,balo-va-vali
275503873,"Balo dây rút thể thao đen Xbags Wisdom Xb 6004, Chất liệu chống thấm nước hiệu quả",1.0,3512890453802,269000,269000,0,0,0,balo-va-vali
275413955,"Túi xách du lịch gấp gọn có bánh xe Thương hiệu Natoli Túi trống du lịch cỡ lớn, to đa năng BST Utility Bag T18",4.0,5287091610414,210000,300000,90000,30,0,balo-va-vali
275001208,"[CHÍNH HÃNG] Balo laptop thể thao du lịch Kingbag Ponos thiết kế sang trọng, thời trang nam nữ unisex, phong cách thể thao, chất vải chống thấm nước tốt, độ bền cao, nhiều ngăn rộng rãi ",1.0,9828582031255,495000,495000,0,0,0,balo-va-vali
274952869,Balo thời trang SAKOS ARMORE,16.0,9668824910899,1490000,1490000,0,0,8,balo-va-vali
274837187," Vali Du Lịch LUG Lusetti MF001 S20/S25/S29 Nhựa PC Chịu Lực Va Đập Tốt, Khóa TSA Chuẩn An Ninh Quốc Tế",1.0,9941403271453,3840000,9085000,5245000,58,0,balo-va-vali
273356242,Balo Laptop Du Lịch Thời Trang Uniex STARGO AKTIF 14Inch,1.0,5166988693466,394000,499000,105000,21,0,balo-va-vali
271378396,"Túi xách da chống sốc laptop máy tính, túi công sở nữ cặp đựng laptop cute dễ thương",2.0,1307888438264,225000,225000,0,0,0,balo-va-vali
252560964,Balo da nam đi học đi làm đi chơi chống thấm nước hàng cao cấp phong cách mới,1.0,8494883776512,503500,530000,26500,5,0,balo-va-vali
252398599,"Balo laptop 15.6"" Runner Pro  WENGER - THỤY SĨ :Ngăn chứa bảo vệ laptop 15.6"" Nội thất tổ chức phong phú, tinh tế, tiện dụng",6.0,2290028737392,1650000,3300000,1650000,50,1,balo-va-vali
251266775,Balo du lịch kiêm túi xách du lịch đa chức năng hàng siêu cao cấp phong cách cá tính mới,2.0,1854799117271,1282500,1350000,67500,5,0,balo-va-vali
249006059,"TÚI ĐỰNG GIÀY DÉP DU LỊCH, THỂ THAO TIỆN DỤNG 3 NGĂN CHỐNG NƯỚC",12.0,5435217932208,96000,96000,0,0,0,balo-va-vali
216113804,Vali nhựa Pc + Abs 16 Inch Gọn Nhẹ ,59.0,7956041970314,262000,262000,0,0,14,balo-va-vali
214502048,Túi đeo hông Nam Nữ AOLIKES A-CW002,1.0,2549686861005,89000,159000,70000,44,0,balo-va-vali
196382113,Túi Bịch Chiết Đựng Mỹ Phẩm Kem Dầu Gội Xả Sữa Tắm Nhỏ Gọn Đi Du Lịch 30ml 50ml 100ml Legaxi,36.0,2936287582169,5500,5500,0,0,0,balo-va-vali
192810384,"Túi Chống Sốc Laptop, Cặp Đựng Laptop, Túi Xách Nam Nữ 13 inch, 14 inch, 15.6 inch Cao Cấp Chống Thấm Nước - Hàng Chính Hãng Besti",172.0,7508981238572,360000,360000,0,0,41,balo-va-vali
184249588,Bộ Vali Nhựa Cao Cấp Doma DH844 - Cam,1.0,8977439351822,3290000,3290000,0,0,0,balo-va-vali
178096213,"Balo Laptop công sở nam nữ cao cấp, đựng máy tính, laptop, macbook 15.6 inch chống sốc, chống nước – BEE GEE BLLT9009",2.0,8733371853874,900000,900000,0,0,0,balo-va-vali
175647431,Túi Đeo Hông Unisex Thể Thao Đeo Thắt Lưng,10.0,1807635220877,65000,65000,0,0,1,balo-va-vali
164240670,Balo Laptop Mikkor The Gibson,1.0,9936551417303,1290000,1290000,0,0,1,balo-va-vali
115240244,"Vali Kéo LUG Lusetti Nolan S20/S24/S28 LS802 Nhựa PP Chống Bể vỡ, Hạn Chế Trầy Xước, Khóa Số TSA Bảo Mật Cao",750.0,3800795959073,1229000,3425000,2196000,64,274,balo-va-vali
77059244,Balo nam thông minh đa chức năng thời trang cao cấp phong cách mới,63.0,3926249191003,450000,450000,0,0,28,balo-va-vali
57127803,"Balo laptop cao cấp 15.6 inch (Macbook 17inch) Mikkor The Eli Backpack chống thấm nước, ngăn đựng rộng rãi, ngăn đựng laptop riêng biệt, chống sốc, quai đeo vai được đệm foam PE dày êm thoải mái",16.0,6051372814768,649000,649000,0,0,7,balo-va-vali
55665984,"Túi xách, cặp xách chống sốc cho laptop, macbook, surface có dây đeo, siêu chống nước",31.0,8107779265806,249000,249000,0,0,5,balo-va-vali
54480206,Ba lô du lịch thể thao nam công suất lớn phong cách châu âu hiện đại đã tích hợp công nghệ 4.0,33.0,8153098434966,949050,999000,49950,5,16,balo-va-vali
51421798, Balo Thời Trang HARAS HRTK008 (45 x 33 cm),4803.0,9435296334316,180000,180000,0,0,75,balo-va-vali
49251991,Balo Thời Trang Phong Cách Hàn Quốc HARAS HR262,41.0,1732353173009,198000,198000,0,0,11,balo-va-vali
48288618,Cặp Xách Công Sở Thời Trang Cao Cấp SAKOS BORIS 14 Inch,12.0,5403318741309,1020000,1020000,0,0,4,balo-va-vali
34237014,Balo laptop 15.6 inch Mikkor Kalino Backpack Mouse Grey,47.0,4969346194308,649000,649000,0,0,14,balo-va-vali
31698289,Túi thể thao du lịch Mikkor The Sporty Gear,5.0,5432584556645,649000,649000,0,0,3,balo-va-vali
16932501,Balo Laptop chính hãng SimpleCarry ISSAC 3,0.0,2028764849374,520000,520000,0,0,0,balo-va-vali
4209859,Balo laptop Simplecarry B2B02,14.0,6009396682092,590000,590000,0,0,3,balo-va-vali
3491735,Balo Laptop Hasun HS 654 (48 x 33 x 18 cm),14.0,3703464650091,469000,469000,0,0,8,balo-va-vali
2809369,"Balo Laptop Mikkor The Ives Backpack (15.6"")",6.0,2009775813141,649000,649000,0,0,1,balo-va-vali
2698837,Balo Laptop Mikkor The Ralph,3.0,3976144464343,599000,599000,0,0,0,balo-va-vali
277822948,Youtube Premium Add Mail Chính Chủ - 1 Năm,1.0,8797777309038,522000,900000,378000,42,0,voucher-dich-vu
276399590,"KEY ĐIỆN TỬ Phần mềm Office Home 2024 (EP2-06796) | Dùng vĩnh viễn | Dành cho 1 thiết bị | Word, Excel, PowerPoint",35.0,2185142649518,2400000,2990000,590000,20,2,voucher-dich-vu
276346430,Key office pro plus - Hàng Nhập Khẩu - Evoucher,9.0,1941366593922,250000,250000,0,0,1,voucher-dich-vu
275986528,OFFICE 365 FAMILY ADD MAILL -  1 Tài Khoản 5 Thiết bị 1 Năm + 1TB Lưu Trữ,24.0,2633173461224,399000,399000,0,0,4,voucher-dich-vu
274957846,KEY ĐIỆN TỬ Phần mềm Microsoft Windows Home 11 64bit (KW9-00664) | Dùng vĩnh viễn | Dành cho 1 thiết bị,1.0,6702732776178,3290000,3290000,0,0,1,voucher-dich-vu
274957845,KEY ĐIỆN TỬ Phần mềm Microsoft Windows Pro 11 64bit (FQC-10572) | Dùng vĩnh viễn | Dành cho 1 thiết bị,1.0,5060165716515,4890000,5990000,1100000,18,0,voucher-dich-vu
274957842,KEY ĐIỆN TỬ Phần mềm Microsoft 365 Bus (KLQ-00209) | 12 tháng | Dành cho doanh nghiệp,1.0,9308548145419,3190000,3290000,100000,3,0,voucher-dich-vu
274770492,"KEY ĐIỆN TỬ Phần mềm Microsoft Office 365 Family (6GQ-00083) | 12 tháng | Dành cho tối đa 6 người | 5 thiết bị/tài khoản| Word, Excel, PowerPoint | 1TB OneDrive",662.0,8438656606796,1700000,2590000,890000,34,59,voucher-dich-vu
274770491,"KEY ĐIỆN TỬ Phần mềm Microsoft Office 365 Personal (QQ2-00003) | 12 tháng | Dành cho 1 người | 5 thiết bị/tài khoản | Word, Excel, PowerPoint | 1TB OneDrive",192.0,5479029828190,1390000,2090000,700000,33,32,voucher-dich-vu
274067694,Mã Key online Hệ Điều Hành  Windows Pro bản 32/64 bit- Hàng Nhập Khẩu,0.0,8728399166733,250000,250000,0,0,0,voucher-dich-vu
253392319,Vé vào cổng điện tử tiNiWorld PREMIUM CUỐI TUẦN/LỄ áp dụng tại các trung tâm tiNiWorld có giá vé vào cổng 180.000 VNĐ,235.0,9368742016324,171000,180000,9000,5,7,voucher-dich-vu
253392284,Vé cổng điện tử tiNiWorld EXPRESS CUỐI TUẦN/LỄ áp dụng tại các trung tâm tiNiWorld có giá vé vào cổng 150.000 VNĐ,163.0,3879150370248,142500,150000,7500,5,3,voucher-dich-vu
252078283,Sách - Tổ chức hoạt động giáo dục theo hướng trải nghiệm cho trẻ ở trường mầm non,1.0,2797386650567,75000,75000,0,0,0,voucher-dich-vu
248400316,Phiếu Quà Tặng - Dịch Vụ Sinh Trắc Vân Tay - Phân Tích Sở Trường Năng Lực - Sự kiện Quà tặng hướng nghiệp Việt Talents tháng 5/2023,14.0,7650998238087,2000,2000,0,0,0,voucher-dich-vu
192665872,VOUCHER COMBO CUA CÀ MAU 3 CON,0.0,3556654833399,455000,455000,0,0,0,voucher-dich-vu
179219184,Liệu pháp giữ gìn tuổi thanh xuân,0.0,8124217973936,2000000,2000000,0,0,0,voucher-dich-vu
164551723,Phiếu Quà Tặng Việt Talents 200.000đ ,16.0,8876691113343,200000,200000,0,0,1,voucher-dich-vu
164551501,Phiếu Quà Tặng Việt Talents 300.000đ ,1.0,4747548394302,300000,300000,0,0,0,voucher-dich-vu
164543556,Phiếu Quà Tặng Việt Talents 500.000đ ,3.0,6207633099655,500000,500000,0,0,0,voucher-dich-vu
164535576,Phiếu Quà Tặng Việt Talents 1.000.000đ ,4.0,6317572978458,1000000,1000000,0,0,0,voucher-dich-vu
164500491,Phiếu Quà Tặng Việt Talents 3.000.000đ Zin QR,7.0,3920311258946,3000000,3000000,0,0,0,voucher-dich-vu
114587130,Quà Tặng Sách Nói: Tiền Kiếp Và Luân Hồi Có Thật Không - Kèm Dịch Vụ Sinh Trắc Vân Tay – Phân Tích Tính Cách Hành Vi Cơ Bản,18.0,4843916731761,40000,40000,0,0,2,voucher-dich-vu
113837649,Sách Nói: Muôn Kiếp Nhân Sinh,43.0,7143777810522,40000,40000,0,0,8,voucher-dich-vu
113032111,Quà Tặng Sách Nói: Không Bao Giờ Là Thất Bại! Tất Cả Là Thử Thách - Kèm Dịch Vụ Sinh Trắc Vân Tay – Phân Tích Tính Cách Hành Vi Cơ Bản,6.0,8374595099066,40000,40000,0,0,1,voucher-dich-vu
99336173,Sinh Trắc Vân Tay Gen Talents - Bài báo cáo đầy đủ 4 module,2.0,4417586556727,3850000,3850000,0,0,2,voucher-dich-vu
59321599,Gói đọc sách điện tử Waka 03 tháng,78.0,8283656252364,99000,99000,0,0,7,voucher-dich-vu
24382188,Phiếu Quà Tặng 4.000.000đ,9344.0,6757558787603,4000000,4000000,0,0,10,voucher-dich-vu
24376736,Phiếu Quà Tặng 1.500.000đ,14021.0,7391989374194,1500000,1500000,0,0,8,voucher-dich-vu
9672465,Phiếu Quà Tặng 800.000đ,5749.0,7857825640071,800000,800000,0,0,0,voucher-dich-vu
7322123,Phiếu Quà Tặng 10.000.000đ,23154.0,3251473784820,10000000,10000000,0,0,17,voucher-dich-vu
7322047,Phiếu Quà Tặng 400.000đ,8996.0,8875313719046,400000,400000,0,0,10,voucher-dich-vu
7321979,Phiếu Quà Tặng 300.000đ,131089.0,9605572683753,300000,300000,0,0,133,voucher-dich-vu
2648565,Phiếu Quà Tặng 3.000.000đ,28701.0,9290085447451,3000000,3000000,0,0,15,voucher-dich-vu
1559601,Phiếu Quà Tặng 5.000.000đ,23491.0,6261182597861,5000000,5000000,0,0,9,voucher-dich-vu
1559593,Phiếu Quà Tặng 2.000.000đ,27311.0,5882730467200,2000000,2000000,0,0,14,voucher-dich-vu
1559589,Phiếu Quà Tặng 1.000.000đ,73447.0,4030643189417,1000000,1000000,0,0,53,voucher-dich-vu
1559585,Phiếu Quà Tặng 500.000đ,57167.0,9574787097887,500000,500000,0,0,81,voucher-dich-vu
1559581,Phiếu Quà Tặng 200.000đ,122116.0,8726154182103,200000,200000,0,0,172,voucher-dich-vu
1559415,Phiếu Quà Tặng 100.000đ,816034.0,9407540143913,100000,100000,0,0,373,voucher-dich-vu
1559411,Phiếu Quà Tặng 50.000đ,1048543.0,6951651845776,50000,50000,0,0,426,voucher-dich-vu
277466428,kaspersky Plus - VPN Không Giới Hạn - Hàng Chính Hãng -  [ Evoucher ],1.0,6016627500668,180000,300000,120000,40,1,voucher-dich-vu
277406382,Copilot AI Pro - Trợ Lý AI Đa Năng Từ Microsoft-  Loại cấp sẵn tài khoản,0.0,4276394222794,510000,510000,0,0,0,voucher-dich-vu
276699305,Phần mềm diệt virus - Kaspersky Premium Cao Cấp - VPN Không Giới Hạn - Hàng Chính Hãng - Tài khoản 1 MÁY Evoucher,6.0,1262414989680,185000,185000,0,0,3,voucher-dich-vu
276696706,Key office  Professional Plus 1User Bind Windows Add mail- Hàng Nhập Khẩu - Evoucher,0.0,1884458752472,1100000,1100000,0,0,0,voucher-dich-vu
276284311,Phần mềm diệt virus - kaspersky Premium cao cấp 10 Thiết Bị -  10 Thiết Bị VPN Không Giới Hạn  -  1 Năm - Hàng Chính Hãng,0.0,6370907438348,1650000,1650000,0,0,0,voucher-dich-vu
276275648,Winserver - Vĩnh Viễn,0.0,8175108538441,550000,550000,0,0,0,voucher-dich-vu
276275570,SQL Server 2019 Standard - Vĩnh Viễn,0.0,6620679188219,550000,550000,0,0,0,voucher-dich-vu
276275486,Visual Studio 2022 Professional - Vĩnh Viễn,0.0,3221758283916,550000,550000,0,0,0,voucher-dich-vu
276271536,Autocad Add Mail chính chủ - 1 Năm,0.0,9616744361300,550000,550000,0,0,0,voucher-dich-vu
275736595,[Key gia hạn điện tử] Phần mềm diệt Virus BKAV Profressional 1PC 12 tháng - Hàng Chính Hãng,2.0,9222287307968,169000,169000,0,0,1,voucher-dich-vu
274063497,Key-online Office Home & Business  Vĩnh Viễn - MACBOOK - Hàng Nhập Khẩu,0.0,3181142580078,900000,900000,0,0,0,voucher-dich-vu
274060925,KEY IDM VĨNH VIỄN 1 THIẾT BỊ - Hàng Chính Hãng,2.0,7481474181812,599000,599000,0,0,1,voucher-dich-vu
272858140,Gội Đầu Thư Giãn Cao Cấp - Ưu Đãi Soi Da & Phân Tích 10 Chỉ Số Da,0.0,5278203947125,199000,199000,0,0,0,voucher-dich-vu
270694735,Liệu trình Gội đầu kết hợp massage cổ vai gáy thư giãn,0.0,2581998206447,239000,239000,0,0,0,voucher-dich-vu
270694224,Dịch vụ massage body thư giãn với đá nóng,0.0,1601182885075,599000,599000,0,0,0,voucher-dich-vu
270320044,Bộ video hướng dẫn phòng tránh chấn thương và phục hồi sau chấn thương chạy bộ,0.0,1629744453276,899000,899000,0,0,0,voucher-dich-vu
270273530,Khóa học chạy bộ 6 tháng mục tiêu HM sub 2h cho người pace 7-8,0.0,2139047546169,5600000,5600000,0,0,0,voucher-dich-vu
253392281,Vé cổng điện tử tiNiWorld PREMIUM NGÀY THƯỜNG áp dụng tại các trung tâm tiNiWorld có giá vé vào cổng 150.000 VNĐ,41.0,7744789514358,142500,150000,7500,5,3,voucher-dich-vu
253392276,Vé cổng điện tử tiNiWorld STANDARD CUỐI TUẦN/LỄ áp dụng tại các trung tâm tiNiWorld có giá vé vào cổng 120.000 VNĐ,160.0,9556392762225,114000,120000,6000,5,5,voucher-dich-vu
253392266,Vé cổng điện tử tiNiWorld EXPRESS NGÀY THƯỜNG áp dụng tại các trung tâm tiNiWorld có giá vé vào cổng 120.000 VNĐ,6.0,2112302178988,114000,120000,6000,5,0,voucher-dich-vu
253392247,Vé cổng điện tử tiNiWorld STANDARD NGÀY THƯỜNG áp dụng tại các trung tâm tiNiWorld có giá vé vào cổng 100.000 VNĐ,12.0,9425456452236,95000,100000,5000,5,0,voucher-dich-vu
247692526,"Bảng lối thoát hiểm, bảng exit, bảng chỉ dẫn, biển hướng dẫn exit, bảng exit in uv trên alu inox đẹp",0.0,5884611421599,75000,75000,0,0,0,voucher-dich-vu
215700111,Mã Key Phần Mềm Diệt Virus Bkav Pro Internet Security AI 1 PC 12 Tháng - Hàng Chính Hãng,0.0,3606151665898,235000,235000,0,0,0,voucher-dich-vu
215613179,[Chính Hãng] Mã key Phần mềm diệt virus ĐT Bkav Pro Mobile - Bản quyền 1 năm - Nhận mã ngay sau khi đặt,8.0,3150851191895,80000,80000,0,0,4,voucher-dich-vu
210425692,Thiết bị đuổi chuột công nghiệp Tần số cao hiệu quả gấp 16 lần Sensology 300m2 - hàng cao cấp,0.0,4865486810453,1716000,1716000,0,0,0,voucher-dich-vu
206205812,Combo Hải sản Cajun,0.0,4505247591717,463000,463000,0,0,0,voucher-dich-vu
196559813,"[Toàn Quốc] - Giftcode Thẻ Quà Tặng tiNi 500.000VND - Dùng trong hệ thống tiNiWorld, tiNiStore, tiNiPark",16.0,6526077915403,500000,500000,0,0,1,voucher-dich-vu
195520775,"Trụ La Lan can, cầu thang",0.0,3465256287191,185000,185000,0,0,0,voucher-dich-vu
186394996,Chăm sóc da mụn đầy đủ,0.0,4351212936371,475000,475000,0,0,0,voucher-dich-vu
186392820,Dịch Vụ Triệt Lông Nách Công Nghệ IPL,0.0,7252071749427,125000,125000,0,0,0,voucher-dich-vu
186392616,Trị Mụn Lấy Nhân,0.0,5851121521208,250000,250000,0,0,0,voucher-dich-vu
181267144,Tada Việt Nam - Cho Thuê Bộ Phát Wifi Di Động Không Giới Hạn Tại Hà Nội Và Hồ Chí Minh - 1 Ngày,0.0,8497315571771,50000,50000,0,0,0,voucher-dich-vu
179397020,Liệu pháp trẻ hóa thư giãn chống lão hóa,0.0,1198804948956,1000000,1000000,0,0,0,voucher-dich-vu
164535255,Phiếu Quà Tặng Việt Talents 2.000.000đ ,0.0,3811083007864,2000000,2000000,0,0,0,voucher-dich-vu
160901190,Sinh Trắc Vân Tay Gen Talents – Dịch Vụ Tư Vấn Sinh Trắc Vân Tay Gia Đình – Gói Phân Tích Demo – Tặng Sách Nhà Giả Kim,0.0,1606144677900,600000,600000,0,0,0,voucher-dich-vu
124166329,Trend Micro Internet Security 3 PC 1 Năm,0.0,6937345781305,390000,390000,0,0,0,voucher-dich-vu
116392881,Quà Tặng Sách Nói: Chuyện Tình Qua Nhiều Kiếp Luân Hồi - Kèm Dịch Vụ Sinh Trắc Vân Tay – Phân Tích Tính Cách Hành Vi Cơ Bản,6.0,5288282595624,40000,40000,0,0,0,voucher-dich-vu
110743094,Sinh Trắc Vân Tay Gen Talents – Dịch Vụ Tham Vấn Chuyên Sâu Báo Cáo Sinh Trắc Vân Tay,0.0,6552575190231,700000,700000,0,0,0,voucher-dich-vu
95268080,"[Toàn Quốc] - Giftcode Thẻ Quà Tặng tiNi 300.000VND - Dùng trong hệ thống tiNiWorld, tiNiStore, tiNiPark",22.0,3192434879629,300000,300000,0,0,2,voucher-dich-vu
15412112,Gói khám tiêu chuẩn toàn diện cho nữ tại phòng khám đa khoa quốc tế Golden Healthcare,3.0,2865589734092,2520000,2520000,0,0,1,voucher-dich-vu
276699570,Phần mềm Kaspersky Safe Kids - Hàng Chính Hãng,2.0,3185164165534,200000,200000,0,0,0,voucher-dich-vu
276492371,Gói VieON VIP  1 Năm - Chính chủ,1.0,9964495634912,599000,599000,0,0,0,voucher-dich-vu
273899267,Sách nói Fonos: Charlie Munger – Nhà Đầu Tư Thông Minh Trên Thị Trường Chứng Khoán [e-voucher],0.0,2070350729445,139000,139000,0,0,0,voucher-dich-vu
273610828,Thần Số Học – Giải Mã Hành Trình Năm Cá Nhân,2.0,5598537997763,10000,10000,0,0,2,voucher-dich-vu
272858815,Massage Body Với Đá Nóng ĐƯỢC TẶNG Soi da & Liệu Trình Chăm Sóc Da Mặt 45p,0.0,2322226636476,489000,489000,0,0,0,voucher-dich-vu
270275974,Khóa học 3 tháng tập chạy 21km Techcombank Hồ Chí Minh Marathon,0.0,9418801321296,2800000,2800000,0,0,0,voucher-dich-vu
270275948,Khóa học 3 tháng tập chạy 42km giải Tiền Phong Marathon TPM,0.0,3267945999094,3000000,3000000,0,0,0,voucher-dich-vu
270275837,Khóa học 3 tháng tập chạy trail 42km giải VMM,0.0,2514381017077,2900000,2900000,0,0,0,voucher-dich-vu
270275600,Khóa học chạy bộ 3 tháng 21km giải Long Biên Marathon,0.0,4854384021287,2800000,2800000,0,0,0,voucher-dich-vu
263453652,"Combo 2 lần chăm sóc da mụn thuần hữu cơ gồm soi da, nặn mụn và làm dịu da ",0.0,6088038067385,800000,800000,0,0,0,voucher-dich-vu
248773992,Sách - Lĩnh Nam chích quái - Kim Đồng,0.0,1044888897437,350000,350000,0,0,0,voucher-dich-vu
216029420,Sinh Trắc Vân Tay – Phân Tích Xu Hướng Nghề Nghiệp Theo Tính Cách ,0.0,6070180882608,500000,500000,0,0,0,voucher-dich-vu
215978070,Quà Tặng Sách Nói: Muôn Kiếp Nhân Sinh Tập 2 - Kèm Dịch Vụ Sinh Trắc Vân Tay – Phân Tích Tính Cách Hành Vi Cơ Bản,1.0,3532818230524,40000,40000,0,0,0,voucher-dich-vu
204643488,[The Open Space Hoa Lan] Workshop làm bánh,0.0,6375744667892,490000,490000,0,0,0,voucher-dich-vu
204640437,[Carol & Jazz] Workshop vẽ tranh sơn dầu,0.0,9031185484436,600000,600000,0,0,0,voucher-dich-vu
204639526,[LemLab] Workshop Làm Gốm,0.0,5250595552618,450000,450000,0,0,0,voucher-dich-vu
199630798,Trò chơi vận động 3in1 Game Bull Track Cả Nhà Cùng Vui (Full Option) ,0.0,6013428704501,468000,468000,0,0,0,voucher-dich-vu
199629248,_Bảng vẽ điện tử bút vẽ độ nhạy cao VEIKK A30 5080LPI - AsiaMart,0.0,5324137062789,1752000,1752000,0,0,0,voucher-dich-vu
194109747,Sen cây nhiệt độ cao cấp Bravat phong cách tân cổ điển F651199CP-A-ENG,0.0,2904002780597,24523398,24523398,0,0,0,voucher-dich-vu
186392567,"PEEL ACNE Trị Mụn, Giảm Thâm Mụn",0.0,9857878083842,980000,980000,0,0,0,voucher-dich-vu
183551706,Sách nói: Thế giới Alibaba của Jack Ma,0.0,9779284865916,94500,105000,10500,10,0,voucher-dich-vu
181266533,Tada Việt Nam - Cho Thuê Bộ Phát Wifi Đi Du Lịch Hàn Quốc Không Giới Hạn Tại Hà Nội Và Hồ Chí Minh - 1 Ngày,0.0,5164228104502,120000,120000,0,0,0,voucher-dich-vu
181266174,Tada Việt Nam - Cho Thuê Bộ Phát Wifi Đi Du Lịch Nhật Bản Không Giới Hạn Tại Hà Nội Và Hồ Chí Minh - 1 Ngày,0.0,7325605732160,120000,120000,0,0,0,voucher-dich-vu
161025036,"Sinh Trắc Vân Tay Gen Talents – Dịch Vụ Tư Vấn Sinh Trắc Vân Tay Gia Đình – Gói Phân Tích Demo – Tặng Sách Nóng Giận Là Bản Năng, Tĩnh Lặng Là Bản Lĩnh",0.0,6673652774553,600000,600000,0,0,0,voucher-dich-vu
161024513,Sinh Trắc Vân Tay Gen Talents – Dịch Vụ Tư Vấn Sinh Trắc Vân Tay Gia Đình – Gói Phân Tích Demo – Tặng Sách Những Tù Nhân Của Địa Lý,0.0,8566020549808,600000,600000,0,0,0,voucher-dich-vu
161018221,Sinh Trắc Vân Tay Gen Talents – Dịch Vụ Tư Vấn Sinh Trắc Vân Tay Gia Đình – Gói Phân Tích Demo – Tặng Sách Luật Tâm Thức - Giải Mã Ma Trận Vũ Trụ,0.0,3064246486397,600000,600000,0,0,0,voucher-dich-vu
160895445,Sinh Trắc Vân Tay Gen Talents – Dịch Vụ Tư Vấn Sinh Trắc Vân Tay Gia Đình – Gói Phân Tích Demo – Tặng Sách Muôn Kiếp Nhân Sinh Tập 2,0.0,7094505416957,600000,600000,0,0,0,voucher-dich-vu
116393168,Quà Tặng Sách Nói: Lời Ngỏ Từ Cõi Tâm Linh - Kèm Dịch Vụ Sinh Trắc Vân Tay – Phân Tích Tính Cách Hành Vi Cơ Bản,11.0,3571689875555,40000,40000,0,0,2,voucher-dich-vu
114820626,Quà Tặng Sách Nói: Minh Triết Trong Đời Sống - Kèm Dịch Vụ Sinh Trắc Vân Tay – Phân Tích Tính Cách Hành Vi Cơ Bản,2.0,5925460204466,40000,40000,0,0,1,voucher-dich-vu
114203102,"Sinh Trắc Vân Tay – Phân Tích Đặc Trưng Tính Cách, Phong Cách Học Tập, Xu Hướng Nghề Nghiệp Theo Tính Cách",0.0,6381249979427,500000,500000,0,0,0,voucher-dich-vu
110595698,Sinh Trắc Vân Tay Gen Talents – Combo 25 Bài Báo Cáo Đầy Đủ 4 Module,0.0,6012931755590,27500000,27500000,0,0,0,voucher-dich-vu
104613657,Sinh Trắc Vân Tay Gen Talents – Module Nâng Cao Năng Lực Học Tập,3.0,3753460784737,1870000,1870000,0,0,1,voucher-dich-vu
95274129,"[Toàn Quốc] - Giftcode Thẻ Quà Tặng tiNi 1.000.000VND - Dùng trong hệ thống tiNiWorld, tiNiStore, tiNiPark",10.0,8098484172813,1000000,1000000,0,0,2,voucher-dich-vu
23842672,Lập trình Ứng Dụng (App) trên điện thoại Android và iOS,0.0,8504715283496,20000000,20000000,0,0,0,voucher-dich-vu
22968485,Thiết kế - Lập trình Website,0.0,6987358026378,20000000,20000000,0,0,0,voucher-dich-vu
15416546,Gói Khám Toàn Diện Cho Trẻ Em Từ 5 - 9 Tuổi Tại Phòng Khám Đa Khoa Quốc Tế Golden Healthcare,0.0,6268258896460,1860000,1860000,0,0,0,voucher-dich-vu
15052581,Gói Khám Tầm Soát Ung Thư Cho Nữ Tại Phòng Khám Đa Khoa Quốc Tế Golden Healthcare,0.0,5003805057359,9500000,9500000,0,0,0,voucher-dich-vu
15051465,Gói Khám Tiền Hôn Nhân Cho Nữ Tại Phòng Khám Đa Khoa Quốc Tế Golden Healthcare,4.0,4537495385863,2500000,2500000,0,0,0,voucher-dich-vu
14996483,Gói Khám Tiền Mang Thai Cho Nữ Tại Phòng Khám Đa Khoa Quốc Tế Golden Healthcare,0.0,9354200335754,4100000,4100000,0,0,0,voucher-dich-vu
14986660,Gói khám tầm soát bệnh tiểu đường tại phòng khám đa khoa quốc tế Golden Healthcare,0.0,6211281535189,720000,720000,0,0,0,voucher-dich-vu
275200104,Sách nói: Khúc Tráng Ca Về Những Vết Thương,0.0,1517610218406,158400,158400,0,0,0,voucher-dich-vu
270275936,Khóa học 3 tháng tập chạy 21km giải Tiền Phong Marathon TPM,0.0,7172786284063,2800000,2800000,0,0,0,voucher-dich-vu
270275684,Khóa học chạy bộ 3 tháng 42km giải Long Biên Marathon,0.0,5296689532935,3100000,3100000,0,0,0,voucher-dich-vu
270273656,Khóa học chạy bộ 3 tháng mục tiêu FM sub 4h,0.0,7433928944623,3000000,3000000,0,0,0,voucher-dich-vu
270273616,Khóa học chạy bộ 3 tháng mục tiêu HM sub 2h ,0.0,2093116368634,2800000,2800000,0,0,0,voucher-dich-vu
270273571,Khóa học chạy bộ 6 tháng mục tiêu FM sub 4h cho người pace 7-8,0.0,7859967905400,6500000,6500000,0,0,0,voucher-dich-vu
270253914,Khóa học chạy bộ 3 tháng dành cho người mới bắt đầu chạy những km đầu tiên,0.0,2650968601246,2800000,2800000,0,0,0,voucher-dich-vu
217103814,Quà Tặng Sách Nói: Dấu Chân Trên Cát – Kèm Dịch Vụ Sinh Trắc Vân Tay – Phân Tích Tính Cách Hành Vi Cơ Bản ,0.0,1792886288971,40000,40000,0,0,0,voucher-dich-vu
215979036,Quà Tặng Sách Nói: Muôn Kiếp Nhân Sinh Tập 1 - Kèm Dịch Vụ Sinh Trắc Vân Tay – Phân Tích Tính Cách Hành Vi Cơ Bản,1.0,5612232226734,40000,40000,0,0,0,voucher-dich-vu
205614547,Kịch: TÍA ƠI! CON LẤY CHỒNG - 5B Võ Văn Tần,0.0,2429016135232,200000,200000,0,0,0,voucher-dich-vu
204645741,Kirakira Workshop: WORKSHOP MỪNG NGÀY TRI ÂN THẦY CÔ 20.11,0.0,3457993310593,300000,300000,0,0,0,voucher-dich-vu
204643325,[HCM] Tắm âm thanh với Chuông Xoay Tây Tạng,0.0,5727013620198,400000,400000,0,0,0,voucher-dich-vu
204643072,[SUP-rise SaiGon] Tour chèo thuyền SURPRISE YOURSELF,0.0,5678098559735,450000,450000,0,0,0,voucher-dich-vu
204641096,[Măm Măm Studio] Workshop Tự tay làm bánh,0.0,3430786888975,550000,550000,0,0,0,voucher-dich-vu
204640684,Amazing Show: TRUNG QUÂN IDOL - VĂN MAI HƯƠNG,0.0,3542186438847,800000,800000,0,0,0,voucher-dich-vu
204639900,ILIZA SHLESINGER - Back In Action Tour - Standup Comedy in HCMC,0.0,9677999190065,550000,550000,0,0,0,voucher-dich-vu
204636366,[TPHCM] SỰ KIỆN CHẠY BỘ GÂY QUỸ TỪ THIỆN - BRITCHAM CHARITY FUN RUN 2022,0.0,6651333254324,120000,120000,0,0,0,voucher-dich-vu
204636080,[HÀ NỘI] SỰ KIỆN CHẠY BỘ GÂY QUỸ TỪ THIỆN - BRITCHAM CHARITY FUN RUN 2022,0.0,2437480896869,120000,120000,0,0,0,voucher-dich-vu
204636032,HỘI AN MEMORIES MUSIC SHOW - Đêm nhạc THIÊN THẦN,0.0,9316802962452,500000,500000,0,0,0,voucher-dich-vu
204627604,[HBSO] PIANO RECITAL,0.0,4282375701803,400000,400000,0,0,0,voucher-dich-vu
194566163,(5 mét) dây dệt ngũ sắc (dây mè ) GIAO MÀU NGẪU NHIÊN ,0.0,6845229713187,12000,12000,0,0,0,voucher-dich-vu
177679019,Sách nói: Đến Sahara Mở Quán Trà Đá - Bí Quyết Tìm Kiếm Mặt Bằng Kinh Doanh,0.0,4919426348667,153230,199000,45770,23,0,voucher-dich-vu
161255655,Sinh Trắc Vân Tay Gen Talents – Dịch Vụ Tư Vấn Sinh Trắc Vân Tay Gia Đình – Gói Phân Tích Demo – Tặng Sách Người Đua Diều (Tái Bản),0.0,9422664274959,600000,600000,0,0,0,voucher-dich-vu
161026807,Sinh Trắc Vân Tay Gen Talents – Dịch Vụ Tư Vấn Sinh Trắc Vân Tay Gia Đình – Gói Phân Tích Demo – Tặng Sách Điều Kỳ Diệu Của Tiệm Tạp Hóa NAMIYA (Tái Bản),0.0,3967171659763,600000,600000,0,0,0,voucher-dich-vu
161024760,Sinh Trắc Vân Tay Gen Talents – Dịch Vụ Tư Vấn Sinh Trắc Vân Tay Gia Đình – Gói Phân Tích Demo – Tặng Sách Tâm Lý Học - Phác Họa Chân Dung Kẻ Phạm Tội,0.0,5864743763658,600000,600000,0,0,0,voucher-dich-vu
161018456,Sinh Trắc Vân Tay Gen Talents – Dịch Vụ Tư Vấn Sinh Trắc Vân Tay Gia Đình – Gói Phân Tích Demo – Tặng Sách How Psychology Works - Hiểu Hết Về Tâm Lý Học,0.0,9832068463176,600000,600000,0,0,0,voucher-dich-vu
160946427,Sinh Trắc Vân Tay Gen Talents – Dịch Vụ Tư Vấn Sinh Trắc Vân Tay Gia Đình – Gói Phân Tích Demo – Tặng Sách Trở Về Từ Cõi Sáng,0.0,8675036642281,600000,600000,0,0,0,voucher-dich-vu
160946307,Sinh Trắc Vân Tay Gen Talents – Dịch Vụ Tư Vấn Sinh Trắc Vân Tay Gia Đình – Gói Phân Tích Demo – Tặng Sách Hoa Sen Trên Tuyết,0.0,6376990527937,600000,600000,0,0,0,voucher-dich-vu
160942914,Sinh Trắc Vân Tay Gen Talents – Dịch Vụ Tư Vấn Sinh Trắc Vân Tay Gia Đình – Gói Phân Tích Demo – Tặng Sách Bên Rặng Tuyết Sơn,0.0,3034663977532,600000,600000,0,0,0,voucher-dich-vu
160759443,Sinh Trắc Vân Tay Gen Talents – Combo Gia đình 4 – 4 Bài Báo Cáo Đầy Đủ 4 Module – Tặng Bảo Hiểm Bệnh Hiểm Nghèo PRU-VUI SỐNG Cho Cả Gia Đình,0.0,5813345170839,15400000,15400000,0,0,0,voucher-dich-vu
115288375,Quà Tặng Sách Nói: Bàn Về Hạnh Phúc - Kèm Dịch Vụ Sinh Trắc Vân Tay – Phân Tích Tính Cách Hành Vi Cơ Bản,1.0,1120393354362,40000,40000,0,0,0,voucher-dich-vu
114035787,Quà Tặng Sách Nói: Hoa Sen Trên Tuyết - Kèm Dịch Vụ Sinh Trắc Vân Tay – Phân Tích Tính Cách Hành Vi Cơ Bản,1.0,7373739119964,40000,40000,0,0,1,voucher-dich-vu
113352657,Quà Tặng Sách Nói: Trở Về Từ Cõi Sáng - Kèm Dịch Vụ Sinh Trắc Vân Tay – Phân Tích Tính Cách Hành Vi Cơ Bản,3.0,6095259448847,40000,40000,0,0,0,voucher-dich-vu
113302211,Sách Nói: Bên Rặng Tuyết Sơn,1.0,9504556142644,40000,40000,0,0,1,voucher-dich-vu
104881301,Sinh Trắc Vân Tay Gen Talents – Module Nghề Nghiệp Và Xu Thế Phát Triển Kỹ Năng,1.0,6879401292332,1320000,1320000,0,0,1,voucher-dich-vu
54893199,Dịch Vụ Tẩy Trắng Răng Chỉ Sau 30 Phút Với Công Nghệ FLASH-WHITESMILE Tại Nha Khoa Kim Xuân,0.0,9501008231218,4000000,4000000,0,0,0,voucher-dich-vu
15649850,Gói Khám Chuyên Sâu Toàn Diện Cho Nữ Tại Phòng Khám Đa Khoa Quốc Tế Golden Healthcare,0.0,8567029665204,6050000,6050000,0,0,0,voucher-dich-vu
15604112,Gói Khám Nâng Cao Toàn Diện Cho Nam Tại Phòng Khám Đa Khoa Quốc Tế Golden Healthcare,0.0,6154612002168,3260000,3260000,0,0,0,voucher-dich-vu
14998341,Gói Khám Tầm Soát Rối Loạn Mỡ Máu Tại Phòng Khám đa Khoa Quốc Tế Golden Healthcare,0.0,2737608306057,540000,540000,0,0,0,voucher-dich-vu
14996401,Gói Khám Tiền Mang Thai Cho Nam Tại Phòng Khám Đa Khoa Quốc Tế Golden Healthcare,0.0,8827583124174,1980000,1980000,0,0,0,voucher-dich-vu
277851652,Capcut Pro - 1 Năm 2 Thiết Bị,0.0,7162795510547,650000,650000,0,0,0,voucher-dich-vu
277744234,CCleaner Professional 1 Thiết Bị 1 Năm - Hàng Chính Hãng,0.0,8067327918753,390000,650000,260000,40,0,voucher-dich-vu
275512496,Sách nói Fonos: Siêu Tổ Chức Con Người ,0.0,5194938575961,176000,176000,0,0,0,voucher-dich-vu
270823215,Combo gội đầu và massage body với đá nóng - Làm đẹp và thư giãn trong 115 phút,0.0,3730364226715,489000,489000,0,0,0,voucher-dich-vu
270275881,Khóa học 3 tháng tập chạy trail 70km giải VMM,0.0,2658197510312,3200000,3200000,0,0,0,voucher-dich-vu
263974602,Trải nghiệm triệt lông vùng Nách cao cấp - Không gây đau rát khó chịu,0.0,8871038339493,99000,99000,0,0,0,voucher-dich-vu
263453939,Liệu trình Thải độc da mặt kèm Massage chân thư giãn thanh lọc cơ thể 90 phút,0.0,4951386263915,999000,999000,0,0,0,voucher-dich-vu
262569105,Gói đọc/nghe sách điện tử Waka,5.0,2992286229701,85000,99000,14000,14,0,voucher-dich-vu
255299189,"Hoa sen trên tuyết - Nguyên Phong, Bìa mềm",0.0,5586566329221,83300,98000,14700,15,0,voucher-dich-vu
244331886,Combo 3 Liệu Trình Soi Da + Chăm Sóc Da Mặt Vàng 24K + Massage Chân Ấn Huyệt 75 Phút ,0.0,5332504452441,5000000,5000000,0,0,0,voucher-dich-vu
216343989,Quà Tặng Sách Nói: Nhà Giả Kim - Kèm Dịch Vụ Sinh Trắc Vân Tay – Phân Tích Tính Cách Hành Vi Cơ Bản,1.0,8579430820754,40000,40000,0,0,0,voucher-dich-vu
216030951,Sinh Trắc Vân Tay – Phân Tích Phong Cách Học Tập Theo Tính Cách ,0.0,9687187168058,500000,500000,0,0,0,voucher-dich-vu
205614773,Kịch: BỘ LẠC NÀNH TRẮNG - 5B Võ Văn Tần,0.0,8089635994538,70000,70000,0,0,0,voucher-dich-vu
204643348,[What SUP] Chèo Sup Chill,0.0,6477598685540,280000,280000,0,0,0,voucher-dich-vu
204643172,[FLOWER 1969’s] WORKSHOP CANDLE - HỌC LÀM NẾN THƠM,0.0,2690854140844,270000,270000,0,0,0,voucher-dich-vu
204641801,KỊCH THIẾU NHI: LÂU ĐÀI PHÉP THUẬT,0.0,7210071395875,150000,150000,0,0,0,voucher-dich-vu
204640435,Những Thành Phố Mơ Màng 2022,0.0,7316867297314,499000,499000,0,0,0,voucher-dich-vu
204640372,GIN FESTIVAL SAIGON 2022,0.0,3829434308229,1500000,1500000,0,0,0,voucher-dich-vu
204640154,[Thị Thơm] Workshop Làm Nail,0.0,4072112879754,390000,390000,0,0,0,voucher-dich-vu
204637716,Growl of Clown: Live in Saigon,0.0,4586393700945,250000,250000,0,0,0,voucher-dich-vu
200929566,Sách nói Tín hiệu và độ nhiễu,0.0,4874543437145,229000,229000,0,0,0,voucher-dich-vu
199630769,THiết bị nóng lạnh Pencil-Box hiển thị nhiệt EuroTech (kèm Vòi Sen Nano),0.0,7074022467526,1501200,1501200,0,0,0,voucher-dich-vu
181266479,Tada Việt Nam - Cho Thuê Bộ Phát Wifi Đi Du Lịch Mỹ Không Giới Hạn Tại Hà Nội Và Hồ Chí Minh - 1 Ngày,0.0,4901345852532,200000,200000,0,0,0,voucher-dich-vu
181266191,Tada Việt Nam - Cho Thuê Bộ Phát Wifi Đi Du Lịch Thái Lan Không Giới Hạn Tại Hà Nội Và Hồ Chí Minh - 1 Ngày,0.0,1853667721495,120000,120000,0,0,0,voucher-dich-vu
180303945,Tada Việt Nam - Cho Thuê Bộ Phát Wifi Đi Du Lịch Singapore Không Giới Hạn Tại Hà Nội Và Hồ Chí Minh - 1 Ngày,0.0,3409626420293,120000,120000,0,0,0,voucher-dich-vu
179988631,Tada Việt Nam - Cho Thuê Bộ Phát Wifi Đi Du Lịch Châu Âu Không Giới Hạn Tại Hà Nội Và Hồ Chí Minh - 1 Ngày,0.0,9197305993205,200000,200000,0,0,0,voucher-dich-vu
179219012,Liệu Trình Chăm Sóc Da Mụn Chuyên Sâu,0.0,4456935757841,1400000,1400000,0,0,0,voucher-dich-vu
161026921,Sinh Trắc Vân Tay Gen Talents – Dịch Vụ Tư Vấn Sinh Trắc Vân Tay Gia Đình – Gói Phân Tích Demo – Tặng Sách Những Giấc Mơ Ở Hiệu Sách Morisaki,0.0,7493134676607,600000,600000,0,0,0,voucher-dich-vu
161018269,Sinh Trắc Vân Tay Gen Talents – Dịch Vụ Tư Vấn Sinh Trắc Vân Tay Gia Đình – Gói Phân Tích Demo – Tặng Sách Ba Người Thầy Vĩ Đại (Tái Bản),0.0,9499373126522,600000,600000,0,0,0,voucher-dich-vu
160906726,Sinh Trắc Vân Tay Gen Talents – Dịch Vụ Tư Vấn Sinh Trắc Vân Tay Gia Đình – Gói Phân Tích Demo – Tặng Sách Cà Phê Cùng Tony,0.0,9789225301207,600000,600000,0,0,0,voucher-dich-vu
160890896,Sinh Trắc Vân Tay Gen Talents – Dịch Vụ Tư Vấn Sinh Trắc Vân Tay Gia Đình – Gói Phân Tích Demo – Tặng Sách Muôn Kiếp Nhân Sinh Tập 1,0.0,9269960038058,600000,600000,0,0,0,voucher-dich-vu
160149123,Sinh Trắc Vân Tay Gen Talents – Combo Gia đình 2 – 3 Bài Báo Cáo Đầy Đủ 4 Module – Tặng Hợp Đồng Bảo Hiểm Nhân Thọ,0.0,8712846747151,11550000,11550000,0,0,0,voucher-dich-vu
119988727,Trend Micro Maximum Security 1 PC 1 Năm,1.0,4186482771604,290000,290000,0,0,0,voucher-dich-vu
76369965,Chữ Ký Số Điện Tử FastCA - Gói 3 năm - Hàng Chính Hãng,0.0,6528622153026,3110000,3110000,0,0,0,voucher-dich-vu
76200722,Chữ Ký Số Điện Tử FastCA - Gói 2 năm - Hàng Chính Hãng,0.0,9579769677200,2740000,2740000,0,0,0,voucher-dich-vu
73570304,COMBO USB Chữ ký số Newca gói 3 năm + Hóa đơn điện tử Cyberbill 300 số,0.0,2152062524357,1760000,1760000,0,0,0,voucher-dich-vu
15051646,Gói Khám Tầm Soát Ung Thư Cho Nam Tại Phòng Khám Đa Khoa Quốc Tế Golden Healthcare,1.0,4254666523045,8000000,8000000,0,0,0,voucher-dich-vu
14998848,Gói Khám Dành Cho Nữ Có Gia Đình Tại Phòng Khám Đa Khoa Quốc Tế Golden Healthcare,0.0,4055427202502,2800000,2800000,0,0,0,voucher-dich-vu
14986657,Gói khám tầm soát biến chứng bệnh tiểu đường tại phòng khám đa khoa quốc tế Golden Healthcare,0.0,1002122542535,1720000,1720000,0,0,0,voucher-dich-vu
14986653,Gói khám tầm soát bệnh gan tại phòng khám đa khoa quốc tế Golden Healthcare,2.0,3619089470078,1350000,1350000,0,0,0,voucher-dich-vu
275495216,Sách nói Fonos: Digital Marketing Cho Nhà Quản Lý,0.0,8147050324592,153230,199000,45770,23,0,voucher-dich-vu
275257659,2024 SUPER JUNIOR <SUPER SHOW SPIN-OFF: Halftime> in HO CHI MINH,0.0,8312575575910,3000000,3000000,0,0,0,voucher-dich-vu
270280657,Khóa học 3 tháng phát triển thể lực trẻ em 14-16 tuổi,0.0,3017490247484,2900000,2900000,0,0,0,voucher-dich-vu
270278429,Khóa học 3 tháng tập chạy 42km giải Techcombank Hồ Chí Minh Marathon,0.0,4410878712280,3000000,3000000,0,0,0,voucher-dich-vu
216725545,Quà Tặng Sách Nói: Huyền Thuật Và Các Đạo Sĩ Tây Tạng – Kèm Dịch Vụ Sinh Trắc Vân Tay – Phân Tích Tính Cách Hành Vi Cơ Bản ,0.0,3679293226374,40000,40000,0,0,0,voucher-dich-vu
215975871,Quà Tặng Sách Nói: Cà Phê Cùng Tony - Kèm Dịch Vụ Sinh Trắc Vân Tay – Phân Tích Tính Cách Hành Vi Cơ Bản,0.0,9041119236557,40000,40000,0,0,0,voucher-dich-vu
207718933,Mạch đảo trần Điện Cơ Vinawind,0.0,1413176018510,106920,106920,0,0,0,voucher-dich-vu
206952624,Sách nói: An Toàn Thông Tin - Gián Điệp Mạng,0.0,4486742427331,160300,229000,68700,30,0,voucher-dich-vu
204643432,[Hoi Hoi Project] Workshop làm nến bánh gato béo,0.0,5154701198424,290000,290000,0,0,0,voucher-dich-vu
204642107,[Jannie's Tea] Workshop TRÀ HOA,0.0,1813752348479,126000,126000,0,0,0,voucher-dich-vu
204640726,Amazing Show: TRỊNH THĂNG BÌNH - LIZ KIM CƯƠNG - QUANG HÙNG MASTERD,0.0,2327886184382,600000,600000,0,0,0,voucher-dich-vu
204640178,ETHVIETNAM BUIDLATHON 2022,0.0,5399109367778,4800000,4800000,0,0,0,voucher-dich-vu
204639798,SSC Interclub Muay Thai 6,0.0,6840025001702,300000,300000,0,0,0,voucher-dich-vu
161026760,Sinh Trắc Vân Tay Gen Talents – Dịch Vụ Tư Vấn Sinh Trắc Vân Tay Gia Đình – Gói Phân Tích Demo – Tặng Sách Rèn Luyện Tư Duy Phản Biện,0.0,2236216969246,600000,600000,0,0,0,voucher-dich-vu
161018189,Sinh Trắc Vân Tay Gen Talents – Dịch Vụ Tư Vấn Sinh Trắc Vân Tay Gia Đình – Gói Phân Tích Demo – Tặng Sách Cây Cam Ngọt Của Tôi,0.0,2282417498351,600000,600000,0,0,0,voucher-dich-vu
160907220,Sinh Trắc Vân Tay Gen Talents – Dịch Vụ Tư Vấn Sinh Trắc Vân Tay Gia Đình – Gói Phân Tích Demo – Tặng Sách Hành Trình Về Phương Đông,0.0,5887586622160,600000,600000,0,0,0,voucher-dich-vu
160849927,Sinh Trắc Vân Tay Gen Talents – Combo Học Sinh 2 – 4 Bài Báo Cáo Đầy Đủ 4 Module – Tặng Bộ Truyện Who? Chuyện Kể Về Danh Nhân Thế Giới (20 Cuốn Ngẫu Nhiên),0.0,3155117170691,15400000,15400000,0,0,0,voucher-dich-vu
160849852,Sinh Trắc Vân Tay Gen Talents – Combo Học Sinh 1 – 2 Bài Báo Cáo Đầy Đủ 4 Module – Tặng Bộ Truyện Who? Chuyện Kể Về Danh Nhân Thế Giới (10 Cuốn Ngẫu Nhiên),0.0,1601402938046,7700000,7700000,0,0,0,voucher-dich-vu
160692435,Sinh Trắc Vân Tay Gen Talents – Combo Gia đình 3 – 4 Bài Báo Cáo Đầy Đủ 4 Module – Tặng Bảo Hiểm Tai Nạn PRU-BẢO VỆ 24/7 Cho Cả Gia Đình,0.0,8649051262506,15400000,15400000,0,0,0,voucher-dich-vu
152868715,Sinh Trắc Vân Tay Gen Talents – Combo Gia đình 1 – 4 Bài Báo Cáo,0.0,5796310919626,10340000,10340000,0,0,0,voucher-dich-vu
114271304,USB - CHỮ KÝ SỐ VIETTEL-CA (Gói 2 năm),0.0,8825976006082,2741000,2741000,0,0,0,voucher-dich-vu
114263505,Chữ ký số EasyCa 3 năm,0.0,8495158977456,1800000,1800000,0,0,0,voucher-dich-vu
113760282,Quà Tặng Sách Nói: Chiến Thắng Trò Chơi Cuộc Sống - Kèm Dịch Vụ Sinh Trắc Vân Tay – Phân Tích Tính Cách Hành Vi Cơ Bản,3.0,3712523567538,40000,40000,0,0,1,voucher-dich-vu
112694411,Quà Tặng Sách Nói: Hành Trình Về Phương Đông - Kèm Dịch Vụ Sinh Trắc Vân Tay – Phân Tích Tính Cách Hành Vi Cơ Bản,18.0,2808943419522,40000,40000,0,0,8,voucher-dich-vu
104885199,Sinh Trắc Vân Tay Gen Talents – Module Khám Phá Tính Cách Và Hành Vi,0.0,4836000203809,1320000,1320000,0,0,0,voucher-dich-vu
104541837,Sinh Trắc Vân Tay Gen Talents - Module Xu Hướng Năng Lực Bẩm Sinh ,1.0,7282768869838,1870000,1870000,0,0,1,voucher-dich-vu
76151435,Chữ Ký Số Điện Tử FastCA - Gói 1 năm - Hàng Chính Hãng,0.0,1102168235634,1527000,1527000,0,0,0,voucher-dich-vu
15649640,Gói Khám Chuyên Sâu Toàn Diện Cho Nam Tại Phòng Khám Đa Khoa Quốc Tế Golden Healthcare,0.0,2475759338915,5650000,5650000,0,0,0,voucher-dich-vu
15605110,Gói Khám Nâng Cao Toàn Diện Cho Nữ Tại Phòng Khám Đa Khoa Quốc Tế Golden Healthcare,0.0,7593817087843,3650000,3650000,0,0,0,voucher-dich-vu
15418718,Gói Khám Toàn Diện Cho Trẻ Em Từ 10 - 16 Tuổi Tại Phòng Khám Đa Khoa Quốc Tế Golden Healthcare,0.0,6020958824521,2100000,2100000,0,0,0,voucher-dich-vu
15412110,Gói khám tiêu chuẩn toàn diện cho nam tại phòng khám đa khoa quốc tế Golden Healthcare,3.0,1687287735765,2150000,2150000,0,0,0,voucher-dich-vu
14998668,Gói Khám Dành Cho Nữ Độc Thân Tại Phòng Khám Đa Khoa Quốc Tế Golden Healthcare,0.0,6352975400601,1800000,1800000,0,0,0,voucher-dich-vu
14996565,Gói Khám Tiền Hôn Nhân Cho Nam Tại Phòng Khám Đa Khoa Quốc Tế Golden Healthcare,5.0,8592001012561,1950000,1950000,0,0,0,voucher-dich-vu
14986655,Gói khám tầm soát bệnh tim mạch tại phòng khám đa khoa quốc tế Golden Healthcare,0.0,4214770606690,1650000,1650000,0,0,0,voucher-dich-vu
193044379,Túi xách nữ thời trang công sở cao cấp phong cách mới,10.0,9677644784492,503500,530000,26500,5,5,tui-vi-nu
190355521,Túi xách nữ da thật thời trang cao cấp phong cách mới,48.0,6866742594207,568100,598000,29900,5,13,tui-vi-nu
162024663,Túi xách nữ thời trang công sở cao cấp phong cách mới,34.0,9071450714998,473100,498000,24900,5,10,tui-vi-nu
90531483,Túi xách nữ thời trang cao cấp ,56.0,9080235880411,344565,362700,18135,5,17,tui-vi-nu
186650070,Túi xách nữ thời trang cong sở cao cấp,30.0,9074115909831,408500,430000,21500,5,8,tui-vi-nu
277477569,"Túi vải dạ đựng đồ, nhãn hiệu Eveline màu xanh",1.0,1591135183509,75000,75000,0,0,0,tui-vi-nu
277403037,Túi Yuumy ( Thời trang nữ nhấn khóa kim loại - Túi đeo vai da Seasand YN268 ),1.0,4563242553189,219000,360000,141000,39,0,tui-vi-nu
277294409,COMBO 10 BAO ĐỰNG THẺ CĂN CƯỚC CMND - ATM - NHÂN VIÊN - SINH VIÊN - BẰNG LÁI XE,1.0,5741121882139,60000,60000,0,0,0,tui-vi-nu
276462046,COMBO 5 Vỏ bao hộ chiếu (passport) dẻo trong có khe đựng vé máy bay và các thoại thẻ hiệu Vỏ Bọc Hộ Chiếu,12.0,8984135586749,100000,100000,0,0,2,tui-vi-nu
276422170,Túi Cói Thời Trang Đi Chơi Đi Du Lịch Hàng Cao Cấp ,6.0,5068293602189,338000,338000,0,0,0,tui-vi-nu
167599223,Túi xách nữ thời trang cao cấp,13.0,1228676862238,332500,350000,17500,5,2,tui-vi-nu
54430952,Túi xách nữ cao cấp phong cách châu âu hiện đại mới,94.0,5834660398802,370500,390000,19500,5,43,tui-vi-nu
185964455,Túi xách nữ vải canvas thời trang cao cấp phong cách cá tính mới,9.0,6469124248703,332500,350000,17500,5,3,tui-vi-nu
247371623,Túi xách túi đeo vai mini nữ thời trang cao cấp phong cách mới,4.0,4440455601262,370500,390000,19500,5,0,tui-vi-nu
276375505,"Hộp Đựng Phụ Kiện / Sạc Dự Phòng/ Ổ Cứng Di Động/ Thẻ Nhớ/ Tai Nghe / Cáp Sạc / USB Đa Năng Cao Cấp HPK2 | Chống Nước, Chống Sốc Hiệu Quả",3.0,3092435580569,59400,99000,39600,40,0,tui-vi-nu
276354233,Túi Yuumy ( Thời trang nữ thiết kế kiểu nhún - Túi đeo vai da Seasand YN253 ),7.0,9157340915959,199000,340000,141000,41,1,tui-vi-nu
276271374,Túi Yuumy ( Thời trang nữ mini dáng đứng nắp gập thanh lịch - Túi đeo chéo da Seasand YN258 ),2.0,5055750830664,119000,210000,91000,43,0,tui-vi-nu
276253662,Bóp ví nữ mini gấp gọn cầm tay nút bấm chữ nhật cách điệu thời trang - Hàng cao cấp,5.0,9644615195140,65000,80000,15000,19,1,tui-vi-nu
276075684,[Quà Tặng Không Bán] Túi Tote Canvas Zenyum Phong Cách Nhật Hàn MỚI,11.0,4774784416590,250000,250000,0,0,0,tui-vi-nu
244170100,Túi xách nữ thời trang công sở cao cấp phong cách cá tính mới,2.0,8643891508652,503500,530000,26500,5,0,tui-vi-nu
177060582,Túi xách nữ thời trang cao cấp,26.0,7219601789796,465500,490000,24500,5,13,tui-vi-nu
103660156,Túi xách nữ thời trang cao cấp phong cách châu âu,76.0,3513962021119,370500,390000,19500,5,25,tui-vi-nu
177169142,Túi xách nữ thời trang cao cấp,21.0,2675009610152,374300,394000,19700,5,7,tui-vi-nu
198883501,Túi xách nữ thời trang công sở cao cấp phong cách mới,22.0,7030493597395,408500,430000,21500,5,4,tui-vi-nu
276060378,AS - TÚI CANVAS THỜI TRANG,1670.0,6727445352688,156000,156000,0,0,0,tui-vi-nu
275889738,"Túi Tote Nữ Thời Trang Hàn Quốc Vải Bố Canvas Màu Kem Dạng Đeo Vai Có Khóa Kéo Ngăn Phụ Trong Đựng Macbook, Laptop. Phụ Kiện Đi Làm Văn Phòng Đi Học Chơi Du Lịch Dã Ngoại Phượt",3.0,9068760353649,160000,160000,0,0,0,tui-vi-nu
274643468,Ví Yuumy ( Thời trang nữ dáng ngắn cầm tay khóa kéo - Ví da Seasand YV99 ),10.0,6944876524058,95000,190000,95000,50,4,tui-vi-nu
274614658,Túi Yuumy ( Thời trang nữ dáng cong chần chỉ size 25 - Túi đeo vai da Seasand YN173 ),2.0,2775086786693,219000,420000,201000,48,0,tui-vi-nu
273746696,Túi Yuumy ( Thời trang nữ dự tiệc size 28 - Túi đeo chéo da Seasand YN188 ),3.0,7551969446862,209000,390000,181000,46,0,tui-vi-nu
273388727,Túi ba gang - Mang tri thức - Happy Live,16.0,6760598708976,199000,199000,0,0,0,tui-vi-nu
271301693,Túi Yuumy ( Thời trang nữ đi chơi size 23 - Túi đeo chéo da Seasand YN170 ),12.0,8152246625539,199000,340000,141000,41,4,tui-vi-nu
216435182,Dây xích túi xách xích chuỗi dẹp 8mm chắc chắn,5.0,2676312040817,27000,27000,0,0,0,tui-vi-nu
216160038,"Túi Tote Đeo Vai Nữ Grepaco Vải Bố Canvas Màu Đen Nhiều Ngăn Có Khóa Kéo Đeo Chéo Hoặc Xách Tay Đựng Laptop Phụ Kiện Đi Làm, Đi Học, Đi Du Lịch Thời Trang Hàn Quốc - Hàng Chính Hãng",91.0,8483560531691,99000,99000,0,0,23,tui-vi-nu
207652768,Túi Yuumy ( Thời trang nữ hình bán nguyệt - Túi đeo vai da Seasand YN156 ),69.0,8103456936898,199000,390000,191000,49,13,tui-vi-nu
206715235,"Túi xách tote, Move fast and break things, mã G96. Quà tặng cao cấp cho gia đình, nam nữ cặp đôi, hội nhóm, doanh nghiệp",1.0,4562347959727,109000,109000,0,0,0,tui-vi-nu
203897907,Ví Yuumy ( Thời trang nữ nắp gập cách điệu cỡ nhỏ - Ví móc khóa da Seasand YV81 ),98.0,7438860447755,75000,150000,75000,50,3,tui-vi-nu
202878752,Túi Yuumy ( Thời trang nữ đựng laptop - Túi xách da Seasand YTX28 ),78.0,8234956092838,290000,580000,290000,50,28,tui-vi-nu
200624228,Túi Yuumy ( Thời trang nữ nắp gập phối quai xách size 20 - Túi đeo chéo da Seasand YN128 ),112.0,2881610423468,335000,650000,315000,48,29,tui-vi-nu
177822630,VÍ SEN 4 - CHÍNH HÃNG KHACTEN.COM,114.0,9893360232295,600000,600000,0,0,46,tui-vi-nu
159725474,Túi xách đa năng May 10 (giao màu ngẫu nhiên),31.0,3980955852021,35000,35000,0,0,3,tui-vi-nu
153262523,"Combo 5 Túi Ví Đựng Bảo Vệ Chống Xước Thẻ ATM, Card Visit, CMND, Driver License Bằng Lái Xe Trong Suốt - Loại 1 Chính Hãng MINIIN",211.0,9333990381266,1900,1900,0,0,28,tui-vi-nu
147832125,"Túi xách nữ công sở đeo vai kiểu dáng đơn giản, thanh lịch phong cách Hàn Quốc",12.0,2538138977455,199000,199000,0,0,3,tui-vi-nu
143292607,Túi xách đeo chéo nữ tặng dây chuyền ngọc trai dạo phố thời trang phong cách Hàn Quốc,83.0,4085997156472,159000,159000,0,0,23,tui-vi-nu
117084931,Túi xách đeo chéo nữ tặng dây chuyền ngọc trai dạo phố,205.0,3136381522856,159000,159000,0,0,72,tui-vi-nu
116388009,"Túi Tote Nữ Grepaco Xách Vải Bố Canvas Cao Cấp In Chữ Đẹp Đeo Chéo Vai Có Khóa Kéo Nhiều Ngăn Dùng Đi Học, Làm Công Sở, Du Lịch Phong Cách Thời Trang Hàn Quốc - Tặng Túi Đựng Mỹ Phẩm",380.0,3965179948139,119000,119000,0,0,102,tui-vi-nu
108967754,"Túi đeo chéo nữ YUUMY YN65 nhiều màu, tiện dụng đi chơi đi làm.",499.0,8648503948558,125000,250000,125000,50,143,tui-vi-nu
89135102,"túi xách ,túi đeo vai, đeo chéo nữ vải canvas cao cấp phong cách mới",141.0,6887896207438,283100,298000,14900,5,49,tui-vi-nu
84263039,Túi xách nữ túi công sở nữ đính đá thanh lịch sang trọng phong cách Hàn Quốc TN82,34.0,4751349964318,219000,219000,0,0,14,tui-vi-nu
84229853,Túi xách nữ thêu hoa túi xách công sở thanh lịch sang trọng phong cách Hàn Quốc,52.0,3846373869502,219000,219000,0,0,22,tui-vi-nu
79965375,Túi đeo chéo nữ thời trang kiểu dáng Hàn Quốc chất vải mềm mại chống nước TN131,111.0,1220364865220,99000,99000,0,0,39,tui-vi-nu
68349508,Ví cầm tay thời trang đa năng YUUMY YMK2 nhiều màu,829.0,8577984975362,25000,50000,25000,50,144,tui-vi-nu
56992965,Túi xách nữ thời trang công sở cao cấp kiểu dáng đơn giản,35.0,1043321485674,199000,199000,0,0,16,tui-vi-nu
277591342,Túi Đeo Vai Hoạt Hình Mickey Thời Trang Đa Năng Dung Tích Lớn - Túi Tote Nữ Lớp Học Sinh Mới - HÀNG CHÍNH HÃNG MINIIN,2.0,5366586730181,89000,89000,0,0,0,tui-vi-nu
277439291,Vascara Ví Cầm Tay Nhấn Khóa Gài Trang Trí - WAL 0321,1.0,1556446742234,633000,633000,0,0,1,tui-vi-nu
277365495,"Túi cavas GIADO, túi vải bố mẫu xe máy",2.0,1677337803754,58000,58000,0,0,1,tui-vi-nu
277356517,Ví nữ phong cách dễ thương - BEE GEE VNU1056,1.0,4811735071638,180000,360000,180000,50,0,tui-vi-nu
277319386,Túi Yuumy ( Thời trang nữ thiết kế dáng xô - Túi đeo chéo da Bergen YN281 ),1.0,4410018311235,145000,250000,105000,42,0,tui-vi-nu
252185174,"Ví Nữ Đựng Thẻ ATM Nhỏ Gọn SUPPLE, Da Đà Điểu Tự Nhiên Mềm Mại, Chống Xước - Chống Nhăn Tốt, Thiết Kế Hiện Đại, Ngăn Súp Lê Rộng, Đựng Được Nhiều Thẻ Ngân Hàng, Card Danh Thiếp, Căn Cước Công Dân, Dáng Đứng - Gập 2 - Hàng Chính Hãng SAIGIO",10.0,3300227532995,699000,699000,0,0,1,tui-vi-nu
276473281,Túi Yuumy ( Thời trang nữ kiểu đám mây size 22  - Túi đeo chéo da Seasand YN257 ),1.0,1480161122492,179000,320000,141000,44,1,tui-vi-nu
276069550,Túi Đeo Chéo Nữ Nhỏ Gọn Đựng Điện Thoại Đồ Dùng Đa Năng Nhỏ Gọn Thời Trang Hàn Quốc Cao Cấp (Có Hàng Sẵn),3.0,4016823778475,49000,49000,0,0,0,tui-vi-nu
275723136,AS - TÚI VẢI CANVAS,452.0,4478195483836,41000,41000,0,0,0,tui-vi-nu
275484643,Vascara Túi Đeo Vai Y2K Nhấn Quai Bản Cá Tính - SHO 0253,1.0,6312622458243,792000,879000,87000,10,1,tui-vi-nu
274358815,Túi Lata ( Thời trang nữ đi chơi size 21 - Túi đeo chéo da HN119 ),2.0,1923940047872,290000,290000,0,0,0,tui-vi-nu
274027195,"Ví Nữ Mini, Ví Đựng Thẻ, Bóp Nữ, Nhiều Màu, Hàng Chính Hãng, Ví Nữ 100% Da Thật Cao Cấp Phong Trẻ Chung",3.0,3942147080824,199000,199000,0,0,0,tui-vi-nu
262876989,Túi xách nữ thời trang ELLY – EL246,4.0,4959122475094,1019150,1199000,179850,15,1,tui-vi-nu
258848679,Túi Yuumy ( Thời trang nữ dạo phố size 18 - Túi đeo chéo da Seasand YN164 ),30.0,6291816716357,199000,390000,191000,49,10,tui-vi-nu
257779934,"Túi đeo chéo nữ nhiều ngăn tiện dụng phong cách Hàn Quốc vải dày dặn, mềm mại",2.0,7877552644990,89000,89000,0,0,0,tui-vi-nu
255612915,"Túi đeo chéo nữ đi làm, đi chơi phong cách Hàn Quốc nhiều ngăn tiện dụng",2.0,8009572059325,139000,139000,0,0,0,tui-vi-nu
219152741,Túi Yuumy ( Thời trang nữ công sở - Túi xách da YTX36 ),37.0,8726983012263,245000,490000,245000,50,11,tui-vi-nu
206230674,Túi Lata ( Thời trang nữ đi chơi size 20 - Túi đeo chéo da  HN100 ),9.0,8530117334357,329000,520000,191000,37,1,tui-vi-nu
204057189,Túi Yuumy ( Thời trang nữ đi tiệc size 19 - Túi xách da Seasand YTX24 ),60.0,4418263311595,299000,490000,191000,39,19,tui-vi-nu
203583356,Ví Da Bò Cầm Tay Dáng Dài Thời Trang cao cấp Cho Nữ phong cách mới,15.0,9934775088826,465500,490000,24500,5,3,tui-vi-nu
198511611,"Túi đeo chéo da bò Mercury Bụi Leather - DC107 Da bò Nappa cao cấp, bảo hành 12 tháng",7.0,7199430340078,565000,715000,150000,21,2,tui-vi-nu
184223381,Túi xách túi đeo vai nữ vải canvas thời trang cao cấp phong cách mới,17.0,9606265354912,351500,370000,18500,5,5,tui-vi-nu
178302279,Túi phụ kiện RINGKE Pouch đựng đồ cá nhân 5 ngăn kháng nước,2.0,3048132729937,250000,250000,0,0,1,tui-vi-nu
160314498,Ví Nữ Mini Cầm Tay Hàng Hiệu TAILIAN Đựng Tiền Đựng Thẻ Da Cao Cấp Nhiều Ngăn Tiện Dụng Đẹp Giá Rẻ TL04 - Micocah Mall,16.0,7035785671636,99000,99000,0,0,5,tui-vi-nu
160224067,Túi đeo chéo da nữ mini YUUMY YN118,71.0,2581201273463,159000,290000,131000,45,19,tui-vi-nu
159946692,Túi Yuumy ( Thời trang nữ tote - Túi xách da YTX18 ),530.0,1812554493834,260000,520000,260000,50,151,tui-vi-nu
158815530,Ví cầm tay nữ nắp gập cách điệu YUUMY Seasand YV55,45.0,3515100422013,165000,330000,165000,50,21,tui-vi-nu
152446331,Túi xách nữ đeo chéo da mềm thời trang phong cách Hàn Quốc,43.0,1670364670814,99000,99000,0,0,17,tui-vi-nu
147942984,Túi Đeo Chéo Nữ Đựng Điện Thoại FOREVER YOUNG Da Mềm Nhiều Ngăn Tiện Dụng Chất Cực Đẹp FY02 - Tukado,82.0,1515055914756,159000,159000,0,0,24,tui-vi-nu
112086372,"Túi đeo vai Blake AMERICAN TOURISTER - MỸ: Hai ngăn chính đa năng Ngăn trước dễ truy cập,Vải và khóa kéo chống thấm nước",46.0,1936483732028,700000,1000000,300000,30,21,tui-vi-nu
90116888,5 Túi đựng giày tiện ích size to - 00057,2.0,3096219177354,95000,95000,0,0,0,tui-vi-nu
81363674,Túi đeo chéo nữ thời trang cao cấp Hàn Quốc TN120,42.0,7482585704458,79000,79000,0,0,8,tui-vi-nu
81322798,Túi đeo chéo nữ  túi xách nữ công sở thêu hoa thời trang sang trọng phong cách Hàn Quốc TN125,90.0,6890699192222,219000,219000,0,0,30,tui-vi-nu
73384998,COMBO 20 BAO ĐỰNG THẺ CĂN CƯỚC CMND - ATM - NHÂN VIÊN - SINH VIÊN - BẰNG LÁI XE HIỆU HIER,507.0,7022988110871,22500,22500,0,0,124,tui-vi-nu
53769045,Túi đeo chéo nam nữ thời trang Hàn quốc BEE GEE 085 chống thấm nước,26.0,8282711304482,55000,110000,55000,50,9,tui-vi-nu
16100203,Túi Đeo Chéo Nữ Da Bò Nhỏ Gọn - BHW8363,10.0,8570529987387,445000,445000,0,0,0,tui-vi-nu
277578523,Túi tote trơn và hoạ tiết hình dễ thương xinh xắn nhiều size 3B,9.0,7314171801648,19000,19000,0,0,1,tui-vi-nu
277366040,"Túi cavas GIADO, túi vải bố mẫu Sài Gòn nhà thờ đức Bà Cathédrale Notre-Dame",1.0,7278501376995,58000,58000,0,0,1,tui-vi-nu
277361934,Túi đeo chéo nữ phong cách dễ thương – BEE GEE DCNU1053,1.0,2722420345864,280000,560000,280000,50,0,tui-vi-nu
277002466,Túi Yuumy ( Thời trang nữ công sở classic - Túi xách da Bergen YTX60 ),0.0,6264585392966,279000,490000,211000,43,0,tui-vi-nu
276815467,"Ví da  ngắn mini cầm tay nữ nhiều ngăn da PU cao cấp, chất da mềm mịn .dùng đựng thẻ , giấy tờ xe , đựng tiền nhỏ gọn và tiện lợi phong cách nữ tính, trẻ trung , hiện đại  ",2.0,3496969950056,75050,79000,3950,5,0,tui-vi-nu
276500243,Túi Yuumy ( Thời trang nữ công sở dáng vuông - Túi xách da Seasand YTX56 ),0.0,4908668128037,299000,520000,221000,43,0,tui-vi-nu
276486505,Túi Yuumy ( Thời trang nữ công sở cỡ lớn - Túi xách da Seasand YTX50 ),0.0,3364924753656,319000,520000,201000,39,0,tui-vi-nu
276085930,Ví Bóp Nữ Đẹp Cầm Tay Mini Nhỏ Gọn Thời Trang Hàn Quốc Cao Cấp,1.0,9514690091650,26000,26000,0,0,2,tui-vi-nu
275724240,AS - TÚI CÓI SỐNG ĐẦY,228.0,8670674211904,122000,122000,0,0,0,tui-vi-nu
275615027,Ví nữ DA BÒ THẬT phong cách mới  - BEE GEE VNU1026,2.0,8104920810366,320000,640000,320000,50,1,tui-vi-nu
275602770,Túi Yuumy ( Thời trang nữ vân nhám cá tính size 21 - Túi đeo chéo da Bergen YN242 ),1.0,9604593646811,160000,320000,160000,50,0,tui-vi-nu
275478084,"Ví nữ Marrant - BHM8608 Ví mini, Vi đựng thẻ. Da bò thật, hàng chính hãng",3.0,2515235993036,300000,300000,0,0,3,tui-vi-nu
275140420,Túi cói MEDiCARE natural,2.0,4690396982796,45000,45000,0,0,1,tui-vi-nu
274468094,TÚI XÁCH NỮ THỜI TRANG ELLY – EL289,0.0,4045967415656,839300,1199000,359700,30,0,tui-vi-nu
273894677,"Túi xách nữ dự tiệc, Clutch nữ cầm tay dự tiệc đính kim tuyến thời trang cao cấp kiểu dáng thanh lịch, sang trọng",0.0,4292852198616,169000,169000,0,0,0,tui-vi-nu
273631504,Túi xách nữ cao cấp phong cách châu âu hiện đại mới Hàng Chính Hãng,0.0,3733087530546,329000,329000,0,0,0,tui-vi-nu
273080764,"Móc khóa gấu bông hình đám mây treo balo, túi xách, điện thoại",1.0,6222430091403,15000,15000,0,0,0,tui-vi-nu
270658748,"Ví Nữ Mini Đựng Thẻ ATM SLIM, Da Bò Mềm Mại PEBBLE, Kiểu Dáng Nhỏ Gọn - Tiện Dụng, Gồm 8 Ngăn Để Thẻ Và Tiền, Phong Cách Hiện Đại - Trẻ Trung – Hàng Chính Hãng SAIGIO",11.0,3346346174174,299000,299000,0,0,0,tui-vi-nu
261801334,Khăn lụa Yuumy ( Thời trang nữ trang trí túi xách - Khăn vải YK1 ),50.0,1076279103393,9000,15000,6000,40,2,tui-vi-nu
258820505,Túi Yuumy ( Thời trang nữ đi tiệc - Túi đeo chéo da Seasand YN162 ),21.0,3970275433504,229000,450000,221000,49,7,tui-vi-nu
252099917,"Túi Xách Nữ Cầm Tay, Đeo chéo Da Thật Cao Cấp Hiệu HADATI - Túi Xách Có 2 Mặt 2 Kiểu Dây Size 23c",1.0,8511295360816,764400,764400,0,0,0,tui-vi-nu
217176247,Ví Yuumy ( Thời trang nữ cầm tay - Ví da Verein YV82 ),6.0,7219795630122,199000,390000,191000,49,3,tui-vi-nu
214598403,Ví Yuumy ( Thời trang nữ họa tiết caro - Ví da Seasand YV74 ),18.0,9103427882473,199000,390000,191000,49,4,tui-vi-nu
211946959,Dây xích túi xách phụ kiện dây đeo chéo túi xách ,10.0,8790499542627,28000,28000,0,0,2,tui-vi-nu
206237827,Túi Yuumy ( Thời trang nữ nắp gập dạng hộp size 21 - Túi đeo chéo da Seasand YN155 ),42.0,1441846610217,209000,390000,181000,46,12,tui-vi-nu
200762492,"Túi Đeo Vai Nữ Grepaco Vải Tote Bố Canvas Cao Cấp Màu Đen Nhiều Ngăn Có Khóa Kéo Đeo Chéo Hoặc Xách Tay Đựng Phụ Kiện Đi Làm, Đi Du Lịch Thời Trang Hàn Quốc - Hàng Chính Hãng",42.0,5983483539264,99000,99000,0,0,19,tui-vi-nu
199557161,Túi Lata ( Thời trang nữ đi chơi size 18 - Túi đeo chéo da HN94 ),4.0,8798237876779,409000,590000,181000,31,1,tui-vi-nu
173986171,Túi Yuumy ( Bao vải đựng sản phẩm YBV ),200.0,3301586927935,20000,20000,0,0,3,tui-vi-nu
160314770,Ví Nữ Mini Cầm Tay PERFECT FOR YOU Đựng Tiền Gập 3 Nhỏ Gọn Nhiều Ngăn Tiện Dụng Da Xước Cực Đẹp PFY04 - Micocah Mall,11.0,6924886389953,149000,149000,0,0,3,tui-vi-nu
160058433,Túi tote thời trang May 10,6.0,5723010715122,189000,189000,0,0,1,tui-vi-nu
155287323,Túi xách nữ công sở cỡ lớn YUUMY YTX20 ,380.0,7495055138606,260000,520000,260000,50,117,tui-vi-nu
147941995,Túi Xách Nữ Đeo Chéo Chính Hãng FOREVER YOUNG Dáng Công Sở Thời Trang Da Cao Cấp Cực Đẹp FY13 - TUKADO,9.0,3396021775490,239000,239000,0,0,5,tui-vi-nu
135321546,Túi đeo chéo da nữ Yuumy Seasand YN110,86.0,2493114695077,145000,290000,145000,50,26,tui-vi-nu
104091538,"Ví nữ cầm tay dáng dài YUUMY Seasand YUUMY YV47 phong cách hiện đại nhiều ngăn đựng tiền, thẻ card",194.0,9946173214608,110000,220000,110000,50,63,tui-vi-nu
90163542,Túi xách nữ công sở HOTTREND  Túi đeo chéo nữ Hàn Quốc  Deli TN46,3.0,6700390786644,219000,219000,0,0,0,tui-vi-nu
80077435,"Túi đeo chéo da dù chống nước, ngăn túi rộng dãi đựng được nhiều đồ TN150",5.0,9147225601690,99000,99000,0,0,3,tui-vi-nu
67613416,Túi vải Tote Túi Đeo Chéo Hàn Quốc dễ thương ,12.0,8182020019667,59000,59000,0,0,7,tui-vi-nu
56993030,Túi đeo chéo nữ Hàn Quốc cao cấp họa tiết kẻ caro,20.0,6368629880323,149000,149000,0,0,8,tui-vi-nu
46166280,Túi xách nữ thời trang kiểu dáng công sở Châu Âu,18.0,9232104234444,189000,189000,0,0,7,tui-vi-nu
20803932,Túi Mini Dạng Cói Dây Rút Mùa Hè Siêu Xinh NEVENKA N333,6.0,6672775680233,99000,99000,0,0,0,tui-vi-nu
277735863,"Túi Xách Sọc Đen Nữ Vải Nylon – Túi Đeo Vai Dây Kéo 3 Lớp, Phong Cách Hàn Quốc - HÀNG CHÍNH HÃNG MINIIN",1.0,8949722336332,99000,99000,0,0,0,tui-vi-nu
277366074,"Túi cavas GIADO, túi vải bố mẫu Sài Gòn toà đô chánh",1.0,7564744260771,58000,58000,0,0,0,tui-vi-nu
277366051,"Túi cavas GIADO, túi vải bố mẫu bãi biển Vũng Tàu",1.0,9226417472728,58000,58000,0,0,0,tui-vi-nu
277366009,"Túi cavas GIADO, túi vải bố mẫu Huế trường Quốc Học",1.0,2064300265338,58000,58000,0,0,0,tui-vi-nu
277365773,"Túi cavas GIADO, túi vải bố mẫu Hội An phố cổ",1.0,5990987609153,58000,58000,0,0,0,tui-vi-nu
277365424,"Túi cavas GIADO, túi vải bố mẫu Đà Nẵng cầu Vàng pixel",1.0,1453455300832,58000,58000,0,0,0,tui-vi-nu
277364339,Túi đeo chéo nữ phong cách dễ thương – BEE GEE DCNU1054,1.0,5677421945686,280000,560000,280000,50,0,tui-vi-nu
277353234,Túi đeo chéo nữ phong cách dễ thương – BEE GEE DCNU1079,0.0,7847489019232,240000,480000,240000,50,0,tui-vi-nu
277311006,"Túi nữ họa tiết vải da cao cấp ,chống thấm nước ,trẻ trung cá tính ,phù hợp mọi độ tuổi có thể đeo nhiều kiểu dáng , dễ dàng phối với các loại trang phục khác nhau ,là phụ kiện  thời trang  của phái đẹp",0.0,6256694740555,113050,119000,5950,5,0,tui-vi-nu
276622688,Túi Yuumy ( Thời trang nữ thiết kế dây rút - Túi đeo chéo da Seasand YN265 ),2.0,7100093142093,199000,340000,141000,41,0,tui-vi-nu
276523314,Túi Yuumy ( Thời trang nữ thiết dây rút - Túi xách da Seasand YTX58 ),0.0,6652622058249,209000,360000,151000,42,0,tui-vi-nu
276387614,Túi xách tay nữ Aldo CARAEVER,1.0,4832379066272,1750000,1750000,0,0,0,tui-vi-nu
276344037,Ví bóp nữ mini cầm tay sang trọng VI-005 - Xanh dương ,0.0,7465558774479,99000,99000,0,0,0,tui-vi-nu
276304315,Túi đeo chéo nữ Aldo GOLSPIE,0.0,2032837166283,1750000,1750000,0,0,0,tui-vi-nu
275991260,Túi xách tay nữ Aldo BAELI,0.0,2338304844662,2150000,2150000,0,0,0,tui-vi-nu
275991189,Túi đeo vai nữ Aldo ALEXANDRA,0.0,7372562781525,1550000,1550000,0,0,0,tui-vi-nu
275599376,"Túi tote nữ có khóa kéo Thương hiệu NATOLI, đựng laptop, đeo vai cao cấp BST Elegant Shockproof Tote Bag T17",0.0,5081769709643,412000,412000,0,0,0,tui-vi-nu
275271540,Túi đeo chéo nữ vải dù chống trượt nước thời trang hàn quốc kiểu hộp ngang đáng yêu DRU - Hàng Chính Hãng,1.0,7444688779336,199680,249600,49920,20,0,tui-vi-nu
275195207,Túi xách nữ thời trang công sở cao cấp phong cách dễ thương – BEE GEE TN1113,0.0,6659631024412,450000,900000,450000,50,0,tui-vi-nu
274970571,Túi xách túi đeo vai nữ thời trang cao cấp phong cách mới,1.0,2184317212332,503500,530000,26500,5,1,tui-vi-nu
274377951,Túi Yuumy ( Thời trang nữ chần chỉ trang trí size 21 - Túi đeo chéo da Seasand YN207 ),7.0,9631575856901,189000,280000,91000,33,2,tui-vi-nu
273794180,"Túi xách tay công sở, túi đeo chéo nữ chần trám dạo phố phong cách hàn quốc IDIGO FB2-5054",0.0,3232252192490,800000,800000,0,0,0,tui-vi-nu
262516198,Túi Yuumy ( Thời trang nữ công sở dáng đứng cỡ trung - Túi xách da Seasand YTX35 ),21.0,7389861386435,290000,580000,290000,50,5,tui-vi-nu
247865755,Túi xách nữ thời trang công sở cao cấp phong cách mới – BEE GEE TN1038,1.0,5776466166741,540000,1080000,540000,50,0,tui-vi-nu
227717719,Ví Yuumy ( Thời trang nữ nắp gập cỡ nhỏ - Ví móc khóa da YMK10 ),2.0,6117356819875,25000,50000,25000,50,0,tui-vi-nu
213891365,Dây quai thay thế túi xách cỏ bốn lá sang chảnh có mix màu nhiều kích cỡ tuỳ chọn thời trang,8.0,9974139506460,105000,105000,0,0,0,tui-vi-nu
208045731,Túi xách nữ thời trang công sở BG – TN1028,0.0,2984085839232,320000,640000,320000,50,0,tui-vi-nu
207281562,Ví da nữ thời trang cao cấp ELLY – EV96,3.0,1265404028767,539100,599000,59900,10,1,tui-vi-nu
206253766,Túi điện thoại handmade đan móc thủ công NHÀ MỊ - Fishbone minibag,0.0,6058793870386,560000,560000,0,0,0,tui-vi-nu
190320302,Túi xách túi đeo vai nữ thời trang cao cấp phong cách mới,5.0,1627470733202,370500,390000,19500,5,3,tui-vi-nu
183692171,Dây ngọc trai thay thế đeo túi xách dây làm phụ kiện túi xách DIY,0.0,5282748032754,105000,105000,0,0,0,tui-vi-nu
183343138,Túi đeo chéo unisex Street Crossbag chính hãng NATOLI chất vải canvas đi học đi chơi nhiều ngăn cá tính đơn giản nhỏ gọn,4.0,5894939241106,249900,357000,107100,30,0,tui-vi-nu
174445639,Ví Nữ Ngắn Mini Cầm Tay Chính Hãng TAILIAN Thời Trang Nhiều Ngăn Đựng Tiền Vân Da Rắn Cao Cấp  TL34,1.0,8974664376529,119000,119000,0,0,1,tui-vi-nu
108696888,"Túi tote đeo vai Micocah 2021 thiết kế dây rút, vải thêu hoa (FSF518) (M428)",0.0,5049397353364,450000,450000,0,0,0,tui-vi-nu
90163531,Túi Vải Canvas Đeo Chéo Nhật Bản ️ HOTTREND ️ Túi đeo chéo kẻ caro mini nữ thời trang tặng sticker TN76,1.0,1353114119470,69000,69000,0,0,1,tui-vi-nu
86134461,Túi xách nữ da dù chống nước túi xách công sở túi đeo vai thời trang phong cách Hàn Quốc TN67,48.0,8404546415020,139000,139000,0,0,10,tui-vi-nu
74892729,Ví Lata ( Thời trang nữ cầm tay dáng dài - Ví da VN49 ),16.0,2564917081784,179000,290000,111000,38,5,tui-vi-nu
68238372,"Bóp ví nữ dài cầm tay kiểu dáng thanh lịch, thời trang, đựng vừa điện thoại màn hình lớn, thêm chức năng chống quét thẻ cực đặc biệt",940.0,1949795645401,269000,269000,0,0,463,tui-vi-nu
43694442,Túi đeo chéo nữ thời trang phong cách Hàn Quốc Đồ Da Thành Long TLG 208188,0.0,7381897273092,63000,63000,0,0,0,tui-vi-nu
8280862,Túi Vải Canvas - Collect Moments,70.0,3122571570557,169000,169000,0,0,13,tui-vi-nu
277359592,Ví nữ phong cách dễ thương - BEE GEE VNU1034,3.0,3651494251980,340000,680000,340000,50,1,tui-vi-nu
276928539,Túi Xách DirtyCoins Mini Bowler Bag Patches ‘Y’ Logo,0.0,5270785249400,899000,899000,0,0,0,tui-vi-nu
276916689,Vascara Túi Cầm Tay Nắp Gập Nhấn Khóa Chữ Nhật - SAT 0336,0.0,2721064315926,957000,957000,0,0,0,tui-vi-nu
276839908,Túi đeo chéo nữ phong cách dễ thương – BEE GEE DCNU1083,0.0,5277603425154,170000,340000,170000,50,0,tui-vi-nu
276815485,"Ví  ngắn cầm tay  nữ nhiều  ngăn da PU cao cấp, chất da mềm mịn .dùng đựng thẻ , giấy tờ xe , đựng tiền nhỏ gọn và tiện lợi ,phong cách nữ tính, trẻ trung , hiện đại ",0.0,7306751229631,75050,79000,3950,5,0,tui-vi-nu
276796854,"Túi xách nữ  đeo hoặc cầm tay  ,da PU họa tiết da cá sấu,phong cách thời trang sôi động trẻ trung cho phái nữ ",0.0,1409868945473,109000,109000,0,0,0,tui-vi-nu
276629431,Túi Tote Size Lớn Isla Bonita,1.0,5365547553245,900000,900000,0,0,0,tui-vi-nu
276601452,Ví Yuumy ( Thời trang nữ cầm tay nhiều ngăn - Ví da Seasand YV110 ),2.0,8196223341281,89000,150000,61000,41,1,tui-vi-nu
276152908,Túi Yuumy ( Thời trang nữ công sở dáng đứng - Túi xách da Bergen YTX55 ),0.0,2287478654194,259000,460000,201000,44,0,tui-vi-nu
276147072,Túi đeo chéo nữ phong cách dễ thương – BEE GEE DCNU1049,0.0,7989205441921,390000,780000,390000,50,0,tui-vi-nu
275151325,Túi xách nữ thời trang công sở cao cấp phong cách dễ thương – BEE GEE TN1108,6.0,3847023128485,155000,310000,155000,50,0,tui-vi-nu
275134002,Túi Đeo Vai Phom Rũ - TOT 0164,0.0,4797450437908,745000,908000,163000,18,0,tui-vi-nu
274870182,Túi Yuumy ( Thời trang nữ dây đeo phối xích cá tính size 23 - Túi đeo chéo da Seasand YN212 ),1.0,2220397799689,289000,480000,191000,40,0,tui-vi-nu
274458984,Túi Yuumy ( Thời trang nữ sành điệu phối phụ kiện - Túi đeo vai da Seasand YN210 ),2.0,3642073379228,249000,440000,191000,43,1,tui-vi-nu
274175309,TÚI XÁCH NỮ THỜI TRANG ELLY – EL274,0.0,2801870642392,839300,1199000,359700,30,0,tui-vi-nu
274052712,Túi Yuumy ( Thời trang nữ mềm mại phối xích - Túi đeo chéo da Seasand YN185 ),6.0,2209036674784,239000,390000,151000,39,2,tui-vi-nu
273962663,Túi đeo chéo cho bé phong cách dễ thương – BEE GEE DCTE73,0.0,1039450402414,130000,260000,130000,50,0,tui-vi-nu
273707036,Túi Yuumy ( Thời trang nữ đi tiệc size 20 - Túi đeo chéo da Verein YN183 ),3.0,1178310197456,345000,520000,175000,34,0,tui-vi-nu
273405785,Túi xách nữ thời trang công sở cao cấp phong cách mới,2.0,4242985280678,503500,530000,26500,5,0,tui-vi-nu
272243344,Túi Lata ( Thời trang nữ basic - Túi đeo chéo da HN111 ),6.0,1741296098835,420000,420000,0,0,1,tui-vi-nu
263113789,Túi xách nữ thời trang cao cấp ELLY – EL261,2.0,5601004852283,974250,1299000,324750,25,1,tui-vi-nu
262454935,Ví nữ DA BÒ THẬT phong cách mới  - BEE GEE VNU1012,0.0,6681634883055,205000,410000,205000,50,0,tui-vi-nu
253189664,Túi xách nữ thời trang công sở cao cấp phong cách châu âu,5.0,3189164240155,503500,530000,26500,5,0,tui-vi-nu
252296384,"Ví Nữ Đựng Thẻ ATM Nhỏ Gọn MULTI, Da Bò Mềm Mại, Thiết Kế Hiện Đại Với 2 Ngăn Đựng Tiền Và 6 Ngăn Đựng Thẻ Rất Tiện Dụng, Đựng Thẻ Ngân Hàng, Danh Thiếp, Căn Cước, Hình Lưu Niệm, Dáng Đứng - Gập 2 - Hàng Chính Hãng SAIGIO",19.0,8985024668111,599000,599000,0,0,8,tui-vi-nu
207281456,Ví da nữ thời trang cao cấp ELLY – EV94,0.0,1544940347182,449100,499000,49900,10,0,tui-vi-nu
203183632,Túi Tote Nam Nữ Thời Trang Cao Cấp GADINO - TXTK096,6.0,4189442731281,179000,249000,70000,28,1,tui-vi-nu
198918508,Ví Yuumy ( Thời trang nữ kiểu cầm tay dáng dài - Ví da Verein YV80 ),2.0,7692619945361,110000,220000,110000,50,0,tui-vi-nu
193186934,Ví Nữ Thời Trang cao cấp phong cách mới – VNU1001,9.0,2929218116205,200000,400000,200000,50,5,tui-vi-nu
193002797,Túi Xách Nữ Kẹp Nách Chính Hãng MICOCAH Dáng Công Sở Thời Trang Chất Da Lộn Cao Cấp Phối Màu Vintage Sang Trọng MC141 - Tukado,1.0,1793549143700,449000,449000,0,0,0,tui-vi-nu
173220421,Túi Vải Tote Deckey Phong Cách Năng Động (Có Nhiều Màu),2.0,8024866296570,60000,120000,60000,50,0,tui-vi-nu
162029783,Túi xách nữ thời trang công sở cao cấp phong cách mới,37.0,6469661547881,494000,520000,26000,5,13,tui-vi-nu
159004219,Túi Vải Canvas UAG - Hàng Chính Hãng,15.0,1902127213762,120000,200000,80000,40,1,tui-vi-nu
147941376,Túi Xách Nữ Kẹp Nách Hàng Hiệu MICOCAH Dáng Công Sở Thời Trang Phối Da Lộn Sang Trọng Da Cao Cấp Cực Đẹp MC41 - Tukado,4.0,1845224399843,449000,449000,0,0,1,tui-vi-nu
85564887,Túi xách nữ đeo vai thời trang thanh lịch họa tiết hình thoi siêu đẹp 2021 VTX026,1.0,8159092280216,160000,160000,0,0,0,tui-vi-nu
81499508,Ví Lata ( Thời trang nữ kiểu cầm tay dáng dài - Ví da VN52 ),7.0,8547651291046,209000,350000,141000,40,1,tui-vi-nu
74463160,Ví Đựng Thời Trang Tiện Ich HARAS V268,173.0,4351602608306,35000,35000,0,0,58,tui-vi-nu
71965924,"Túi xách vải bố canvas, thiết kế thời trang in hình họa tiết, đựng được giấy tờ A4 (Nhiều mẫu mã để lựa)",179.0,1226914658185,130000,200000,70000,35,53,tui-vi-nu
43694942,"Túi Xách Nữ, Túi Xách Thời Trang 208082",0.0,3661079833691,101400,101400,0,0,0,tui-vi-nu
8280980,Túi Vải Canvas - Pink,80.0,2473394992165,169000,169000,0,0,6,tui-vi-nu
277439052,Vascara Túi Leather Kiểu Hobo Nắp Gập - SAT 0338,0.0,4294721144700,1664000,1664000,0,0,0,tui-vi-nu
277173959,Vascara Túi Đeo Chéo Ngăn Đôi Basic - SHO 0270,0.0,9308868481417,810000,810000,0,0,0,tui-vi-nu
276796833,"Túi xách  nữ mini  ,  túi đeo vai , có quai cầm ngọc trai ,da bóng đẹp xinh xắn đáng yêu cho phái nữ dạo phố ",0.0,5519504867483,79000,79000,0,0,0,tui-vi-nu
276523300,Túi Tote Chính Hãng Dincox Vải canvas,0.0,2706319846304,120000,120000,0,0,0,tui-vi-nu
275791436,Túi đeo chéo nữ Aldo ENOBRENA,0.0,8694566905700,1850000,1850000,0,0,0,tui-vi-nu
275043024,Túi xách nữ thời trang công sở cao cấp phong cách dễ thương – BEE GEE TN1090,2.0,8527844647045,540000,1080000,540000,50,0,tui-vi-nu
275031831,Túi xách nữ thời trang công sở cao cấp phong cách dễ thương – BEE GEE TN1085,7.0,2801077409183,300000,600000,300000,50,1,tui-vi-nu
274376514,Túi đeo chéo chần bông cá tính - SHO 0248,0.0,5688074848868,651000,879000,228000,26,0,tui-vi-nu
274363638,Túi Yuumy ( Thời trang nữ cói phối màu dáng ngang - Túi xách da Seasand YTX46 ),2.0,1434853512135,219000,360000,141000,39,1,tui-vi-nu
274136604,Túi đeo chéo nữ dáng vuông nắp gập IDIGO FB2-126,2.0,8688770114859,330000,330000,0,0,0,tui-vi-nu
274108158,Túi đeo chéo chần bông - SHO 0247,0.0,6236579983159,633000,879000,246000,28,0,tui-vi-nu
274097493,Ví Yuumy ( Thời trang nữ dáng ngắn nắp gập - Ví da Seasand YV100 ),33.0,5754714803863,75000,150000,75000,50,2,tui-vi-nu
273899257,Túi Yuumy ( Thời trang nữ dáng cong mini - Túi đeo chéo da Seasand YN200 ),3.0,7604460918446,175000,290000,115000,40,1,tui-vi-nu
273794389,"Túi đeo vai đi tiệc, túi đeo chéo nữ đi chơi chần trám phối dây xích IDIGO FB2-4320",0.0,8478359481225,680000,680000,0,0,0,tui-vi-nu
273255822,Clutch cầm tay nữ  Aldo BAMANA,1.0,9456149047322,1550000,1550000,0,0,0,tui-vi-nu
270700537,Túi Vải Conan,3.0,5646178944985,170000,179000,9000,5,0,tui-vi-nu
270242780,"Túi đeo chéo,túi đeo vai cho nữ thời trang mèo cute sức chứa lớn LALUNA",0.0,5643805416002,199000,199000,0,0,0,tui-vi-nu
258857853,Túi đeo vai/Shiny Bookbag with Gusset 30 Years Rose - Lilac - 1089233,0.0,1088677297087,899000,899000,0,0,0,tui-vi-nu
252989225,"Túi nữ đeo chéo nhỏ BHM003 Nhỏ gọn,tiện lợi, nhiều màu",5.0,4030371294696,400000,400000,0,0,1,tui-vi-nu
251540681,Túi xách nữ thời trang ELLY – EL249,0.0,8865559901523,1499000,1499000,0,0,0,tui-vi-nu
247942511,Túi đeo chéo unisex thương hiệu NATOLI BST FLEX  CROSS BAG T15 chất vải canvas chống nước tốt,2.0,4537955824719,256200,366000,109800,30,2,tui-vi-nu
246889416,Túi Yuumy ( Thời trang nữ đi chơi nắp gập size 22 - Túi đeo chéo da Seasand YN138 ),8.0,2665130754523,325000,650000,325000,50,1,tui-vi-nu
246117878,Túi xách nữ thời trang ELLY – EL239,2.0,6533700713191,1124250,1499000,374750,25,1,tui-vi-nu
243087346,Túi đeo chéo nữ ALDO LUXSAVANE,1.0,5983534900525,1950000,1950000,0,0,0,tui-vi-nu
217728396,Ví Yuumy (  Thời trang nữ kiểu cầm tay dáng dài - Ví da Seasand YV72 ),4.0,1191143608480,199000,390000,191000,49,2,tui-vi-nu
183566596,Dây ngọc trai đeo túi xách 40cm dây thay thế đeo túi đeo vai DIY phong cách phụ kiện túi xách,0.0,7188488976910,125000,125000,0,0,0,tui-vi-nu
178096394,Túi Yuumy ( Thời trang nữ đi dạo phố size 17 - Túi đeo chéo da Seasand YN129 ),125.0,6643029618176,195000,390000,195000,50,35,tui-vi-nu
143112660,Ví Vải Modern Fabric Vertical Wallet HAVIAS,3.0,2280012082321,350000,350000,0,0,0,tui-vi-nu
120538425,Túi đeo nữ da cá sấu Huy Hoàng 2 gai màu đỏ HC6270,0.0,4632946347701,2999000,2999000,0,0,0,tui-vi-nu
120504947,"Bóp nữ da thật cao cấp Huy Hoàng 3 gấp màu da, đen, đỏ, hồng, nâu, xanh, xanh dương, đỏ tươi, xanh biển HC3111-12-13-14-15-24-58-62-63",0.0,7978623902112,599000,599000,0,0,0,tui-vi-nu
120035875,"HP6401-02-03-04 - Túi xách da đà điểu Huy Hoàng màu đen, nâu đỏ, vàng bò, nâu đất",0.0,3632108784431,8999000,8999000,0,0,0,tui-vi-nu
120035742,HP6433 - Túi xách nữ da đà điểu Huy Hoàng đeo chéo màu nâu đất,0.0,3609056682356,2999000,2999000,0,0,0,tui-vi-nu
106948689,Túi xách  túi đeo vai nữ thời trang cao cấp phong cách mới,33.0,1720673366492,332500,350000,17500,5,5,tui-vi-nu
75600848,"Túi đeo chéo ,đeo ngực nam phong cách mới",91.0,4621104842233,427500,450000,22500,5,28,tui-vi-nu
72008110,"Móc khóa thời trang YUUMY YMK3 - Màu sắc trẻ trung - Thiết kế hiện đại - Đa chức năng sử dụng - Đựng thẻ ngân hàng, thẻ xe, chìa khóa xe - Tiên dụng mang theo bên người (Dài 10cm x Cao 8cm )",452.0,4906733702852,25000,50000,25000,50,149,tui-vi-nu
44573566,Túi xách nữ da đà điểu Huy Hoàng đeo chéo màu đỏ HT6434,0.0,5962921891752,2999000,2999000,0,0,0,tui-vi-nu
43694663,Túi xách nữ thời trang phong cách Hàn Quốc 208083,0.0,4839414058255,122300,122300,0,0,0,tui-vi-nu
40750699,Túi xách nữ công sở A4 phong cách Châu Âu,89.0,8320713537016,199000,199000,0,0,22,tui-vi-nu
35573460,Túi đeo chéo nam nữ - túi bao tử thời trang BEE GEE 028a ( Trơn ) vải dù,264.0,7880773927802,40000,80000,40000,50,26,tui-vi-nu
277498669,Túi đeo chéo nữ nhiều ngăn FADODA FN19 hình bán nguyệt,1.0,2641876283864,219000,420000,201000,48,0,tui-vi-nu
277440557,Túi Yuumy ( Thời trang nữ túi đeo chéo da + ví mini -  Bộ quà tặng túi xách Rạng Rỡ YHQ02 ),0.0,8700468355490,860000,890000,30000,3,0,tui-vi-nu
277377873,Túi xách nữ thời trang công sở cao cấp phong cách cá tính mới,0.0,5060934275503,446500,470000,23500,5,0,tui-vi-nu
277370098,Túi xách nữ công sở dáng ngang cao cấp BEE GEE TN1141,0.0,2391146462978,470000,940000,470000,50,0,tui-vi-nu
277019826,[QUÀ TẶNG - MÀU NGẪU NHIÊN] Móc chìa khoá đa năng IDIGO FW2-004,0.0,6198749288676,120000,120000,0,0,0,tui-vi-nu
276476282,Túi Yuumy ( Thời trang nữ công sở thanh lịch - Túi xách da Seasand YTX51 ),0.0,8703690139083,309000,520000,211000,41,0,tui-vi-nu
276286537,Túi Yuumy ( Thời trang nữ mini dáng đứng - Túi đeo chéo da Seasand YN259 ),1.0,5792952112432,119000,210000,91000,43,1,tui-vi-nu
276069438,"Ví đựng tiền nhỏ gọn cho nữ đẹp cầm tay, ví ngắn cho nữ bỏ túi thời trang giá rẻ (Xả Hàng)",2.0,3142843499017,35000,35000,0,0,1,tui-vi-nu
276068195,(New) Ví nữ dài cầm tay dây đeo chéo thời trang nhiều ngăn tiện dụng (Có Sẵn Hàng) (được chọn mẫu) Loại Tốt,0.0,7106357080984,35000,35000,0,0,0,tui-vi-nu
276059175,Vascara Túi Tote Đeo Vai Phong Cách Cổ Điển - TOT 0172,0.0,4126193506873,928000,928000,0,0,0,tui-vi-nu
276007048,Túi Yuumy ( Thời trang nữ dáng tròn bầu viền chỉ size 20 - Túi đeo chéo da Seasand YN246 ),0.0,3562035642713,209000,360000,151000,42,0,tui-vi-nu
275991314,Túi đeo chéo nữ Aldo HELENISA,1.0,4234567146472,1450000,1450000,0,0,0,tui-vi-nu
275947397,Ví kiêm đế Magsafe Spigen Caseology Nano Pop Card Holder - Hàng chính hãng,0.0,5188925490738,949000,1190000,241000,20,0,tui-vi-nu
275583855,Túi Yuumy ( Thời trang nữ hình chữ nhật khóa cài kim loại size 23 - Túi đeo vai da Seasand YN234 ),1.0,4632707877843,269000,520000,251000,48,1,tui-vi-nu
275356813,Túi Yuumy ( Thời trang nữ kiểu dáng trẻ trung size 21 - Túi đeo chéo da Seasand YN231 ),0.0,8447380480891,215000,360000,145000,40,0,tui-vi-nu
274507003,Túi xách balo nữ 2 trong 1 thông minh đa chức năng thời trang cao cấp phong cách mới,3.0,1542356582533,465500,490000,24500,5,1,tui-vi-nu
274058044,Túi Lata ( Thời trang nữ dự tiệc - Túi đeo chéo da HN113 ),3.0,5301322906337,420000,420000,0,0,1,tui-vi-nu
273836591,"Túi đeo vai đi tiệc, túi đeo chéo nữ đi chơi hình thang thanh lịch IDIGO FB2-4321",0.0,1394967042739,720000,720000,0,0,0,tui-vi-nu
263992201,Túi xách túi đeo vai nữ thời trang công sở cao cấp phong cách châu âu,2.0,8474558757232,503500,530000,26500,5,0,tui-vi-nu
263696207,Túi Lata ( Thời trang nữ dự tiệc size 24- Túi đeo chéo da HN108 ),1.0,7538560620177,590000,590000,0,0,1,tui-vi-nu
255295657,Túi Yuumy ( Thời trang nữ đi chơi nắp gập size 22 - Túi đeo chéo da Seasand YN140 ),4.0,5172130928770,349000,650000,301000,46,1,tui-vi-nu
216168839,Túi xách nữ mini đeo chéo dây xích phong cách Hàn Quốc da mềm mại,0.0,7172038464400,109000,109000,0,0,0,tui-vi-nu
207925713,Túi xách nữ da thật thời trang cao cấp phong cách mới,12.0,7485269281118,351500,370000,18500,5,2,tui-vi-nu
207311568,Túi vải tote thời trang nữ phong cách dễ thương – BEE GEE TV1013,1.0,3006102875876,60000,120000,60000,50,1,tui-vi-nu
199593588,Túi Lata ( Thời trang nữ đi làm cỡ trung - Túi xách da TX14 ),17.0,7346301951494,310000,620000,310000,50,1,tui-vi-nu
196603272,Túi Lata ( Thời trang nữ đi chơi size 21- Túi đeo chéo da HN104 ),41.0,2356449007518,325000,650000,325000,50,21,tui-vi-nu
183507101,Dây đeo túi xách titan chain xích dây thay thế túi xách làm túi xách DIY sành điệu nhiều size,3.0,9629956364824,105000,105000,0,0,0,tui-vi-nu
172366798,Ví Yuumy (  Thời trang nữ dáng cầm tay nhỏ gọn - Ví da Seasand YV58 ),72.0,3629153320521,75000,150000,75000,50,23,tui-vi-nu
143112894,Túi Tote Oxford HAVIAS,9.0,3365771050748,520000,520000,0,0,4,tui-vi-nu
120524824,HC3220 - Ví nữ da cá sấu Huy Hoàng ngăn thụt cầm tay màu xanh lá,0.0,7650145548393,2999000,2999000,0,0,0,tui-vi-nu
109479028,Túi đeo chéo nam cao cấp phong cách mới,23.0,7166690407785,378100,398000,19900,5,8,tui-vi-nu
89119829,Túi đeo chéo đeo vai nữ cao cấp phong cách mới,21.0,8169338323207,283100,298000,14900,5,8,tui-vi-nu
53934661,Túi xách nữ đeo chéo phong cách châu âu hiện đại ,48.0,5839899043684,237500,250000,12500,5,23,tui-vi-nu
48506730,Túi Lata ( Thời trang nữ thanh lịch - Túi xách da TX08 ),12.0,7938067083243,409000,690000,281000,41,6,tui-vi-nu
12134983,Túi đeo chéo ANELLO đeo 2 kiểu vải polyester cỡ nhỏ AT-C1223,6.0,5805706656200,1490000,1490000,0,0,1,tui-vi-nu
11506821,Ví Da Mini Cầm Tay TM-Purse H86 (KT: 12x10x4 cm) Cá Tính Nữ,178.0,2041126204192,159000,159000,0,0,16,tui-vi-nu
11248591, Túi tote ANELLO tay cầm chữ O đeo 2 kiểu AU-S0061,1.0,7442487450283,2000000,2000000,0,0,0,tui-vi-nu
277807630,Túi Yuumy ( Thời trang nữ họa tiết bông hoa - Túi xách da Seasand YTX66 ),0.0,5151671569349,189000,340000,151000,44,0,tui-vi-nu
277537999,TÚI TOTE THAIYEN CAFE (Chất liệu vải Canvas cao cấp),0.0,1841456480168,250000,250000,0,0,0,tui-vi-nu
277380194,Túi xách nữ thời trang công sở cao cấp phong cách mới,1.0,8077662590867,351500,370000,18500,5,0,tui-vi-nu
277359733,Ví nữ phong cách dễ thương - BEE GEE VNU1033,1.0,9712195855330,160000,320000,160000,50,0,tui-vi-nu
277174613,Túi Yuumy ( Thời trang nữ thiết kế đơn giản size 25 - Túi đeo vai da Seasand YN266 ),0.0,8541305398130,179000,290000,111000,38,0,tui-vi-nu
276985096,Túi Yuumy ( Thời trang nữ phối khóa kim loại size 24 - Túi đeo vai da Seasand YN263 ),0.0,4785004317863,209000,360000,151000,42,0,tui-vi-nu
276744097,Túi Yuumy ( Thời trang nữ thiết kế nhún dáng tròn size 19 - Túi đeo chéo da Seasand YN264 ),0.0,7527609241997,169000,290000,121000,42,0,tui-vi-nu
276706786,Túi Yuumy ( Thời trang nữ đựng điện thoại - Túi đeo chéo da Seasand YN244 ),1.0,9169707679491,209000,370000,161000,44,0,tui-vi-nu
276676123,Ví Yuumy ( Thời trang nữ cầm tay mini - Ví da Seasand YV114 ),1.0,1888559480675,65000,130000,65000,50,0,tui-vi-nu
276272065,Túi Yuumy ( Thời trang nữ phối quai xách - Túi đeo chéo da Seasand YN238 ),2.0,9213890181983,259000,450000,191000,42,1,tui-vi-nu
276132975,Túi xách nữ công sở dáng ngang cao cấp BEE GEE TN1118,0.0,4207596622534,480000,960000,480000,50,0,tui-vi-nu
276069623,"Ví cầm tay cho nữ, Ví bóp nữ ngắn đẹp cầm tay mini ngắn nhỏ gọn bỏ túi thời trang hàng tốt (có hàng sẵn giao ngay)",0.0,1721934038271,35000,35000,0,0,0,tui-vi-nu
275243675,Túi Yuumy ( Thời trang nữ đựng điện thoại - Túi đeo chéo da Seasand YN237 ),3.0,1193051736351,149000,250000,101000,40,2,tui-vi-nu
275068566,"Túi đeo chéo đi chơi, túi đeo vai nữ messenger kèm huy hiệu hoạt hình dễ thương IDIGO FF6 - 2017",2.0,5831552392511,380000,380000,0,0,1,tui-vi-nu
275068123,"Túi xách nữ đi chơi, túi đeo chéo phom mềm nhiều ngăn dây đeo vải họa tiết IDIGO FB2 - 4323",2.0,7322140939138,700000,700000,0,0,0,tui-vi-nu
275064048,Túi xách nữ thời trang công sở cao cấp phong cách dễ thương – BEE GEE TN1099,0.0,6536719596844,350000,700000,350000,50,0,tui-vi-nu
274500957,Túi xách tay nữ Aldo TAFARN,0.0,3923069085618,2100000,2100000,0,0,0,tui-vi-nu
274500003,Túi xách tay nữ Aldo EILE,1.0,2413756117370,1950000,1950000,0,0,0,tui-vi-nu
274499924,Túi đeo chéo nữ Aldo DIVINITY,0.0,4551762250826,2100000,2100000,0,0,0,tui-vi-nu
274359137,Túi Yuumy ( Thời trang nữ thiết kế trần trám size 22 - Túi đeo chéo da Seasand YN136 ),4.0,4882650018230,379000,620000,241000,39,1,tui-vi-nu
274358691,Túi Lata ( Thời trang nữ đựng điện thoại mini - Túi đeo chéo da HN117 ),6.0,6295610847803,280000,280000,0,0,1,tui-vi-nu
274108831,Túi Yuumy ( Thời trang nữ thiết kế hiện đại size 25 - Túi đeo chéo da Seasand YN206 ),2.0,4957383351819,329000,560000,231000,41,1,tui-vi-nu
273522956,Túi xách nữ đeo chéo da bò cao cấp BHM025 Túi đeo vai nữ,0.0,6886804996348,909000,909000,0,0,0,tui-vi-nu
273457591,Móc khóa Yuumy ( Thời trang nữ trang trí túi xách - Móc khóa da Seasand YMK20 ),3.0,9222122839258,10000,20000,10000,50,0,tui-vi-nu
271296041,Túi Yuumy ( Thời trang nữ công sở cỡ trung - Túi xách da Seasand YTX41 ),1.0,4666888277700,279000,480000,201000,42,0,tui-vi-nu
270811237,Túi xách nữ thời trang công sở cao cấp phong cách dễ thương – BEE GEE TN1068,1.0,4706057619020,230000,460000,230000,50,1,tui-vi-nu
270472864,Túi Tote Nữ Vải Bố Canvas Cao Cấp In Họa Tiết Hoạt Hình 2 Ngăn Dùng Đi Du Lịch -Phong Cách Thời Trang Hàn Quốc,1.0,6302240829054,89000,89000,0,0,0,tui-vi-nu
263114676,Túi xách nữ thời trang ELLY – EL248,2.0,4215748681487,1349100,1499000,149900,10,1,tui-vi-nu
207893584,Ví Yuumy ( Thời trang nữ nắp gập cỡ nhỏ - Ví móc khóa da Seasand YMK16 ),71.0,2607069122203,25000,50000,25000,50,6,tui-vi-nu
205819383,Túi xách nữ cao cấp thời trang da mềm phong cách Hàn Quốc thanh lịch và sang trọng,8.0,9721918603897,219000,219000,0,0,0,tui-vi-nu
204463536,Túi xách nữ thời trang công sở cao cấp phong cách mới,18.0,9149622376140,408500,430000,21500,5,3,tui-vi-nu
199978511,Túi xách nữ 100% da thật thời trang công sở cao cấp phong cách mới,5.0,8028079757930,390000,390000,0,0,2,tui-vi-nu
196409306,Túi Lata ( Thời trang nữ đi chơi size 19 - Túi đeo chéo da HN96 ),11.0,4677532572905,590000,590000,0,0,4,tui-vi-nu
147264971,"Ví Đựng Thẻ ATM Cao Cấp Slim CITIZEN, Da Bò Tự Nhiên Cao Cấp, Da Thuộc Thảo Mộc, Nhập Khẩu Từ Châu Âu, Nhỏ Gọn - Hiện Đại - Chuyên Nghiệp, Đựng Tiền, Thẻ Ngân Hàng, Card Danh Thiếp - Hàng Chính Hãng SAIGIO",1.0,9228827142125,2099000,2099000,0,0,0,tui-vi-nu
146223397,"Túi đeo chéo nam Da bò thật Bụi Leather DC106 - Nhiều ngăn tiện dụng, Unisex - Bảo hành 12 tháng",58.0,5991150650408,495000,530000,35000,7,26,tui-vi-nu
107709968,"Túi đeo điện thoại, chất liệu vải dù chống nước siêu bền, nhiều màu. Mã N100BON",0.0,7226629630980,175000,175000,0,0,0,tui-vi-nu
102576041,Túi Đeo Chéo Thời Trang Hàn Quốc HARAS HR281,8.0,4762017144614,100000,100000,0,0,2,tui-vi-nu
57946797,Ví nữ cầm tay mini thời trang Phong cách Hàn  nhiều ngăn tiện dụng,17.0,5442185447136,99000,99000,0,0,4,tui-vi-nu
43694590,Túi đeo chéo đeo vai nữ thời trang 208247,0.0,7334134235674,56000,56000,0,0,0,tui-vi-nu
277359708,Ví nữ phong cách dễ thương - BEE GEE VNU1032,0.0,3444081262474,160000,320000,160000,50,0,tui-vi-nu
277353196,Túi đeo chéo nữ phong cách dễ thương – BEE GEE DCNU1075,0.0,4917253653974,270000,540000,270000,50,0,tui-vi-nu
276839876,Đeo chéo nữ Thời Trang công sở cao cấp – DCNU1084,0.0,1222116562530,140000,280000,140000,50,0,tui-vi-nu
276732430,Túi đeo chéo nữ mini đựng điện thoại Fadoda- FN45,1.0,7581567771380,189000,360000,171000,48,0,tui-vi-nu
276682664,Vascara Túi Đeo Vai Nhấn Viền Bombe Nổi Khối - SHO 0272,0.0,8649036802691,879000,879000,0,0,0,tui-vi-nu
276671670,Túi xách nữ thời trang công sở cao cấp phong cách dễ thương – BEE GEE TN1008A,0.0,3468745177508,320000,640000,320000,50,0,tui-vi-nu
276229795,Túi xách nữ túi tote chất liệu vải họa tiết hoạt hình labubu kích thước 38 * 32cm đi chơi tiện lợi,0.0,2044867172307,53800,53800,0,0,0,tui-vi-nu
276088080,Túi Vải Đựng Giày Dép Dây Rút Chống Bẩn Chống Thấm Nước Du Lịch Dây Rút Size To 43x32 cm (Hàng Chính Hãng),0.0,8226931081326,10000,10000,0,0,0,tui-vi-nu
276069678,Ví Bóp Nữ Đẹp Cầm Tay Mini Nhỏ Gọn Thời Trang Hàn Quốc Cao Cấp,6.0,1174456500037,26000,26000,0,0,1,tui-vi-nu
275226742,Túi Yuumy ( Thời trang nữ đi làm nhiều ngăn đa năng xinh xắn - Túi xách da Seasand YTX48 ),1.0,5364172095362,279000,470000,191000,41,1,tui-vi-nu
274664558,Túi đeo chéo nữ Aldo ZEINAH,0.0,2239890318733,2450000,2450000,0,0,0,tui-vi-nu
274617519,"Túi đeo chéo đi chơi hoạ tiết chần trám, túi đeo vai công sở nữ IDIGO FB2-3396",1.0,6956155236660,520000,520000,0,0,0,tui-vi-nu
274585497,Túi Yuumy ( Thời trang nữ hình chữ nhật họa tiết chần chỉ size 21 - Túi đeo vai da Seasand YN211 ),4.0,9123009134119,259000,420000,161000,38,3,tui-vi-nu
274499905,Túi xách tay nữ Aldo BAELI,0.0,2075909217728,2100000,2100000,0,0,0,tui-vi-nu
273385489,Túi Yuumy ( Thời trang nữ đi chơi sành điệu size 11 - Túi đeo chéo da Verein YN180 ),4.0,4293629187464,145000,290000,145000,50,1,tui-vi-nu
273273349,Túi đeo chéo cho bé phong cách dễ thương – BEE GEE DCTE58,0.0,6277839933728,110000,220000,110000,50,0,tui-vi-nu
272044174,Túi xách nữ thời trang ELLY – EL282,0.0,3364060445167,979300,1399000,419700,30,0,tui-vi-nu
271924712,Túi Lata ( Thời trang nữ đi chơi size 22 - Túi đeo chéo da HN109 ),2.0,1300157758264,399000,590000,191000,32,1,tui-vi-nu
270884062,"Túi đeo chéo đi học đựng vừa A4, túi đeo vai nữ du lịch vải Polyester hoạ tiết hoạt hình dễ thương IDIGO FF6-2012",0.0,1733410941291,440000,440000,0,0,0,tui-vi-nu
270058101,Túi xách nữ thời trang ELLY – EL268,0.0,6250329236530,979300,1399000,419700,30,0,tui-vi-nu
248778635,Túi đeo chéo nữ phong cách dễ thương – BEE GEE DCNU1021,0.0,6694950698418,200000,400000,200000,50,0,tui-vi-nu
243244943,Túi Yuumy ( Thời trang nữ công sở dáng ngang cỡ trung - Túi xách da YTX33 ),6.0,8196218416653,275000,550000,275000,50,1,tui-vi-nu
224707515,Ví nữ 100% da bò thật cao cấp phong cách mới,3.0,5591300017887,446500,470000,23500,5,2,tui-vi-nu
207356594,Ví nữ ngắn mini cầm tay đựng tiền chính hãng TAILIAN da mềm cao cấp khoá đồng xu cực đẹp TL43 - Micocah Mall,4.0,8599509028407,119000,119000,0,0,0,tui-vi-nu
207280555,Ví da nữ thời trang cao cấp ELLY – EV93,4.0,2884086480859,399200,499000,99800,20,1,tui-vi-nu
206835974,Ví Lata ( Thời trang nữ dáng cầm tay dáng dài - Ví da VN71 ),3.0,9434437882934,219000,350000,131000,37,1,tui-vi-nu
204806100,Túi đeo chéo da bò Mesa2 HAVIAS,0.0,1240241798663,980000,980000,0,0,0,tui-vi-nu
203583390,Ví nữ 100% da thật cao cấp phong cách mới,27.0,3389699564294,375250,395000,19750,5,6,tui-vi-nu
187588694,"Túi tote đựng đồ tập thời trang nam nữ Hibi Sports A004, chất liệu Canvas cao cấp, có khóa kéo và túi trong",7.0,7834072543737,290000,290000,0,0,0,tui-vi-nu
185955256,Túi xách nữ vải canvas thời trang cao cấp phong cách cá tính mới,4.0,7600940054965,304000,320000,16000,5,1,tui-vi-nu
174531694,"Ví nữ  EFORA Gaia 3726-BL clutch , ví dài nữ cầm tay thời trang, da thật có quai đeo khoác vai đi chơi, đi làm, đi tiệc",0.0,1467065851139,1980000,1980000,0,0,0,tui-vi-nu
173983400,BAO VẢI YUUMY ( LOẠI TRUNG YBVLT ),101.0,1735617268656,15000,15000,0,0,5,tui-vi-nu
171668670,Túi Vải Canvas Trung Nguyên Legend,10.0,3336903172532,65000,65000,0,0,1,tui-vi-nu
160315171,Ví Nữ Mini Cầm Tay PERFECT FOR YOU Đựng Tiền Dáng Vuông Xinh Xắn Da Cao Cấp Cực Đẹp PFY01 - Micocah Mall,7.0,3354230512035,99000,99000,0,0,3,tui-vi-nu
126705832,Túi xách nữ da bò thật cao cấp FREYA 24.5,0.0,5761699776002,3490000,3490000,0,0,0,tui-vi-nu
97707630,Túi xách nữ thời trang công sở cao cấp phong cách mới,48.0,5565959394109,465500,490000,24500,5,18,tui-vi-nu
44572993,Ví nữ da bò cao cấp Huy Hoàng 3 gấp màu đỏ tươi HT3164,1.0,6204824706665,599000,599000,0,0,1,tui-vi-nu
40897415,Túi đeo chéo dạo phố hình thú New4all Canvas NC37 - Cún con,4.0,3888454116822,139000,139000,0,0,1,tui-vi-nu
35936786,Bộ balo túi xách nữ 3 món thời trang,23.0,6534778577715,79000,79000,0,0,2,tui-vi-nu
23476066,Túi đeo bao tử thời trang cao cấp,1.0,1338525243633,359000,359000,0,0,0,tui-vi-nu
124966188,"Ví nam, bóp nam da bò sáp Mexico Bụi Leather V102 - Bảo hành 12 tháng",668.0,1497458006871,289000,370000,81000,22,261,tui-thoi-trang-nam
125290044,"Ví nam, bóp nam da bò Saffiano Bụi Leather V141 - Bảo hành 12 tháng",1280.0,8540014049475,275000,275000,0,0,465,tui-thoi-trang-nam
125289842,"Ví nam, bóp nam da bò Saffiano Bụi Leather V140 - Bảo hành 12 tháng",154.0,7220883358018,269000,269000,0,0,64,tui-thoi-trang-nam
95446218,Túi xách nam công sở cao cấp siêu bền đẹp,42.0,6262771662847,418000,440000,22000,5,6,tui-thoi-trang-nam
253111702,Túi đeo chéo đeo vai nam thông minh đa chức năng thời trang cao cấp phong cách châu âu,22.0,7733204510294,408500,430000,21500,5,9,tui-thoi-trang-nam
277480682,"Túi đeo chéo mini, túi đi bộ chạy bộ, túi đeo hông, túi đeo ngực, túi bao tử, balo mini nam nữ nhỏ gọn chống nước",3.0,1210937197783,149000,149000,0,0,0,tui-thoi-trang-nam
277470920,Ví nam da bò Trita ( Thời trang nam cao cấp - Ví da RVN03 ),2.0,6228523068696,189000,350000,161000,46,0,tui-thoi-trang-nam
276762351,"Ví Đựng Card Visit, ID, CCCD, Thẻ Ngân Hàng nhỏ gọn, sang trọng",12.0,2560742007580,74200,82000,7800,10,2,tui-thoi-trang-nam
275739351,Túi đeo chéo nam phong cách mới  - BEE GEE DCN9362,1.0,5938801793816,240000,480000,240000,50,0,tui-thoi-trang-nam
275712041,AS - TÚI ĐEO CHÉO BÁN NGUYỆT,358.0,5941689558637,122000,122000,0,0,1,tui-thoi-trang-nam
253111810,Túi đeo chéo đeo vai nam đa chức năng thời trang cao cấp phong cách hàn quốc,25.0,6306095429439,332500,350000,17500,5,6,tui-thoi-trang-nam
190860890,Ví nam da bò cao cấp phong cách mới,156.0,1192839564440,188100,198000,9900,5,32,tui-thoi-trang-nam
56404583,Túi đeo chéo nam đa năng phong cách châu âu ,43.0,3358725585805,99999,99999,0,0,14,tui-thoi-trang-nam
207920164,Túi xách nam công sở da thật cao cấp phong cách mới,34.0,6914399840164,465500,490000,24500,5,7,tui-thoi-trang-nam
75554891,Túi xách nam da thật cao cấp phong cách mới,29.0,9402292353726,408500,430000,21500,5,11,tui-thoi-trang-nam
274825454,"Túi Đeo Chéo Fashion Thời Trang, Túi Đeo Chéo Nam Nữ Tiện Lợi - Hàng chính hãng ",24.0,6598685803550,49000,49000,0,0,5,tui-thoi-trang-nam
274779167,Ví nam MenBense đựng card - Chính hãng ,7.0,7370806828093,69000,138000,69000,50,2,tui-thoi-trang-nam
271959259,Ví Nam Đựng Card Gianni Conti Italy 1817192BLA - Đen,1.0,2579850821637,650000,650000,0,0,0,tui-thoi-trang-nam
261988277,Ví Da Thời Trang Nam Biti's Gosto GOPM00100VAD (Vàng Đậm),2.0,3535601197400,228000,259000,31000,12,0,tui-thoi-trang-nam
51299189,Túi xách da bò nam công sở cao cấp phong cách châu âu,23.0,9097339230339,560500,590000,29500,5,5,tui-thoi-trang-nam
50263298,Túi đeo ngực đeo chéo nam phong cách mới,28.0,2472304106999,446500,470000,23500,5,9,tui-thoi-trang-nam
52528468,Túi đeo chéo nam phong cách châu âu,98.0,1228170457946,237500,250000,12500,5,44,tui-thoi-trang-nam
199650081,Túi đeo chéo nam phong cách mới – DCN9086,1.0,6061705398471,620000,1240000,620000,50,0,tui-thoi-trang-nam
273162055,Túi xách nam thời trang công sở chống thấm nước cao cấp phong cách mới,9.0,7422961316097,503500,530000,26500,5,2,tui-thoi-trang-nam
201914581,"Ví nam Huy Hoàng vân cá sấu màu vàng bò, đen, nâu đất, nâu đỏ HT2116-17-18-48",1.0,7411401299459,489000,489000,0,0,0,tui-thoi-trang-nam
198224201,"Túi Đeo Chéo Grepaco Nam Nữ Unisex Vải Bố Canvas Thời Trang Hàn Quốc Đa Năng Đựng Điện Thoại Máy Tính Bảng Mini Chống Thấm Xước Nhiều Ngăn Khóa Kéo YKK, Phù Hợp Nhiều Kiểu Xách Đeo Khác Nhau - Hàng Chính Hãng",88.0,2352736112272,99000,99000,0,0,20,tui-thoi-trang-nam
192128365,Túi xách da nam công sở da PU cao cấp hàng hiệu chính hãng YVan F80166-5,2.0,1647244173757,650000,650000,0,0,0,tui-thoi-trang-nam
190845667,ví nam ví nam clutch cầm tay cao cấp,37.0,9661565290335,379050,399000,19950,5,7,tui-thoi-trang-nam
189268061,Túi xách nam da PU thời trang công sở cao cấp thanh lịch YVan 6616-5,8.0,3107891990655,650000,650000,0,0,3,tui-thoi-trang-nam
187860014,"Bóp Nam Da Bò Mềm Mại STRIPE, Size Lớn, 10 Ngăn Để Thẻ, 3 Ngăn Đựng Tiền, Dáng Ngang - Gập 2, Có Khóa Kéo, Để Vừa Các Giấy Tờ Chuyên Dụng Như Giấy Tờ Xe Máy, Bảo Hiểm",48.0,1439715870029,799000,799000,0,0,15,tui-thoi-trang-nam
183079588,Ví nam da cá sấu dạng đứng 2 mặt thương hiệu FA FCW02 cao cấp làm từ vân gù sang trọng,1.0,9696383820187,1660000,1660000,0,0,1,tui-thoi-trang-nam
155495937,"Ví namecard da bò V131, ví đựng thẻ card holder da thật nhỏ gọn, thương hiệu Bụi leather chuyên đồ da thật",299.0,2420276590682,69000,84000,15000,18,25,tui-thoi-trang-nam
155339338,"Ví đựng thẻ da bò sáp ngựa điên Crazyhorse V117 cao cấp, card holder da thật, đường chỉ may tinh tế, ví mini nam nhỏ gọn, đựng thẻ tiện lợi, fullbox, thương hiệu Bụi leather chuyên đồ da thật",66.0,4066312780882,203000,203000,0,0,19,tui-thoi-trang-nam
153912766,"Túi Đeo Chéo Nam Nữ U968 US ARMY, Túi Đeo Hông Tiện Dụng Chống Nước Vải Canvas Cao Cấp Phong Cách Lính -HÀNG CHÍNH HÃNG",374.0,6117320283032,89000,178000,89000,50,113,tui-thoi-trang-nam
145394214,Túi Lata ( Thời trang nam đi chơi cỡ nhỏ - Túi đeo chéo da TN20 ),14.0,6387539232629,279000,400000,121000,30,7,tui-thoi-trang-nam
134040370,Túi đeo chéo nam nữ thời trang BEE GEE 0127 để điện thoại ipad chống thấm nước đẹp chất lượng tốt,145.0,8964405772979,54500,109000,54500,50,48,tui-thoi-trang-nam
130070007,Balo đeo chéo chiến thuật phong cách quân đội,7.0,1744240917836,129000,129000,0,0,3,tui-thoi-trang-nam
122391985,"Bóp Nam Mini Nhỏ Gọn, Da Bò NAPA Mềm Mại - Vân Tự Nhiên, Thiết Kế Cổ Điển, Đơn Giản - Mỏng Nhẹ, Dáng Ngang - Gập 2, Đựng Tiền và Thẻ ATM Tiện Dụng - Hàng Chính Hãng SAIGIO",40.0,2380033541767,799000,799000,0,0,13,tui-thoi-trang-nam
103079576,Ví Da Epsom Dáng Đứng Handmade Lealux Epsom Wallet 3,7.0,6026975723777,689000,689000,0,0,2,tui-thoi-trang-nam
93151621,"Túi Đeo Chéo Nam Thời Trang Vải Bố Canvas Cao Cấp Dạng Hộp Chống Thấm Nước, Du Lịch, Đi Học, Đi Chơi",131.0,8747650524401,69000,69000,0,0,49,tui-thoi-trang-nam
77040654,Ví vải Modern Fabric Wallet HAVIAS,3.0,8731828973356,399000,399000,0,0,0,tui-thoi-trang-nam
75418303,"Bóp Ví Dài Nam Nữ KEIO NIPPON Da Bò Mill Cao Cấp Nhập Khẩu, Kích Thước 18x9x2cm VID-GAP001",125.0,3685124460670,299000,299000,0,0,51,tui-thoi-trang-nam
49076743,[ KEIO NIPPON ] Ví Đứng Nam Nữ Da Bò Cao Cấp ,474.0,6888006389824,199000,199000,0,0,188,tui-thoi-trang-nam
15816508,Ví Móc Chìa Khóa K0006 Màu Xanh Đen,3.0,6608779223954,95000,95000,0,0,1,tui-thoi-trang-nam
910662,Ví Nam HARAS V05 (12 x 2 cm) - Đen,2681.0,7109805981316,90000,90000,0,0,116,tui-thoi-trang-nam
270625708,Túi đeo chéo đeo ngực nam đa năng cao cấp phong cách mới,19.0,1717571957858,275500,290000,14500,5,5,tui-thoi-trang-nam
155339755,"Ví sen 3 PLUS da bò Pullup V123, bóp mini nam nhỏ gọn hai màu đen và nâu, đường chỉ may tinh tế, đựng thẻ kẹp tiền tiện lợi, fullbox, thương hiệu Bụi leather chuyên đồ da thật",64.0,7218830990280,215000,278000,63000,23,22,tui-thoi-trang-nam
117401394,"Ví Đựng Thẻ ATM Mini, Da Bò Mềm Mại GENTLE, Da Thật 100%, Thiết Kế Hiện Đại, Nhiều Ngăn Tiện Dụng, Đựng Thẻ Ngân Hàng, Danh Thiếp, Căn Cước, Hình Lưu Niệm, Dáng Đứng - Gập 2 - Hàng Chính Hãng SAIGIO",73.0,1355957793121,649000,649000,0,0,33,tui-thoi-trang-nam
120469883,"Ví Nam Đứng, Da Bò Mềm Mại GENTLE, Size Lớn, Thiết Kế Cổ Điển Đơn Giản - Đẹp Mắt, Dáng Đứng - Gập 2, Ngăn Đựng Tiền Có Khóa Kéo, Nhiều Ngăn Để Giấy Tờ Tiện Dụng - Hàng Chính Hãng SAIGIO",51.0,7081270763270,799000,799000,0,0,28,tui-thoi-trang-nam
275271644,"Balo nam chống nước cao cấp - Túi đeo chéo đa năng tiện lợi Haoshuai Bag phong cách trẻ trung, năng động  DRU - Hàng Chính Hãng",2.0,4939231843961,216480,270600,54120,20,1,tui-thoi-trang-nam
274968194,Túi đeo chéo nam đa năng cao cấp phong cách mới,2.0,9286945732838,275500,290000,14500,5,0,tui-thoi-trang-nam
263395467,Túi đeo chéo nam DA BÒ THẬT phong cách mới  - BEE GEE DCN9252G,1.0,8805545815770,1140000,1140000,0,0,0,tui-thoi-trang-nam
261973996,Túi đeo chéo nam DA BÒ THẬT phong cách mới  - BEE GEE DCN9242,0.0,7287892592120,700000,700000,0,0,3,tui-thoi-trang-nam
191820415,"Túi Đeo Chéo Nam Thể Thao US ARMY, Túi Đeo Bao Tử  Đeo Bụng Lính Mỹ Phong Cách Chất Vải Kaki Cao Cấp Chồng Nước Nhẹ - HÀNG CHÍNH HÃNG",95.0,6800113854306,119000,119000,0,0,37,tui-thoi-trang-nam
196881208,Ví nam da bò cao cấp phong cách mới,57.0,2256444820365,237500,250000,12500,5,16,tui-thoi-trang-nam
193607571,Túi đeo chéo nam đa năng cao cấp phong cách mới,82.0,2236266811146,189050,199000,9950,5,19,tui-thoi-trang-nam
124965903,"Ví nam, bóp nam da bò sáp Mexico Bụi Leather V102 - Bảo hành 12 tháng",75.0,8896064498136,289000,370000,81000,22,29,tui-thoi-trang-nam
243051030,Túi đeo chéo đeo ngực nam đa năng cao cấp phong cách mới,16.0,5978599579620,180000,180000,0,0,2,tui-thoi-trang-nam
242820836,Túi đeo chéo đeo vai nam đa năng cao cấp phong cách mới,7.0,6435806819865,351500,370000,18500,5,1,tui-thoi-trang-nam
222665668,Túi đeo chéo đeo ngực nam cao cấp phong cách mới,13.0,6787767619911,304000,320000,16000,5,5,tui-thoi-trang-nam
185946011,Túi đeo chéo nam đa chức năng cao cấp phong cách cá tính mới,29.0,3438190689264,655500,690000,34500,5,12,tui-thoi-trang-nam
196704803,Túi đeo chéo nam đựng điện thoại  - BEE GEE DCN9077,8.0,7402257133785,199000,398000,199000,50,1,tui-thoi-trang-nam
181523715,"Ví Nam Cao Cấp, Da Bò NAPA Láng Mịn, Mỏng Nhẹ, Size Trung, Kiểu Cổ Điển Tinh Tế - Sang Trọng, Dáng Ngang - Gập 2, Nhiều Ngăn Để Tiền Và Giấy Tờ Tiện Dụng - Hàng Chính Hãng SAIGIO",20.0,8624158838472,1199000,1199000,0,0,9,tui-thoi-trang-nam
170501923,Ví cầm tay dài nam  BST The Long Wallet chính hãng NATOLI nhiều ngăn chống nước sang trọng thời trang,16.0,9256560991196,466200,666000,199800,30,9,tui-thoi-trang-nam
167443834,Túi đeo chéo nam 100% da bò thật cao cấp phong cách mới,47.0,5854442336135,470250,495000,24750,5,12,tui-thoi-trang-nam
155339575,"Ví sen 3 da bò Pullup V122, bóp mini nam nhỏ gọn hai màu đen và nâu, đường chỉ may tinh tế, đựng thẻ kẹp tiền tiện lợi,fullbox, thương hiệu Bụi leather chuyên đồ da thật",38.0,1941462466465,179000,227000,48000,21,11,tui-thoi-trang-nam
148811049,Ví dài cầm tay da bò Mill cao cấp Bụi Leather C107 - Bảo hành 12 tháng,25.0,4668941768468,565000,778000,213000,27,11,tui-thoi-trang-nam
145413858,Túi Lata ( Thời trang nam đi chơi cỡ nhỏ - Túi đeo chéo da TN21 ),20.0,2554981836207,299000,390000,91000,23,6,tui-thoi-trang-nam
130070341, Túi đeo chéo nam nữ phong cách lính,2.0,7684039489826,159000,159000,0,0,1,tui-thoi-trang-nam
116726545,Túi Đeo Chéo Grepaco Nam Nữ Unisex Vải Bố Canvas Tote Chống Nước Dạng Dây Đeo Vai Xách Đa Năng Đựng Điện Thoại Tiền Đi Học Du Lịch Thể Thao Size Mini Phong Cách Thời Trang Hàn Quốc,100.0,9940412260289,99000,99000,0,0,24,tui-thoi-trang-nam
116724768,"Ví Nam Mini Nhỏ Gọn, Da Bò Mềm Mại GENTLE, Thiết Kế Hiện Đại, Nhiều Ngăn Đựng Tiền và Thẻ Tiện Dụng, Dáng Ngang - Gập 2 - Hàng Chính Hãng SAIGIO",36.0,3757249447305,799000,799000,0,0,13,tui-thoi-trang-nam
111537503,Ví nam da bò cao cấp phong cách mới,123.0,7101959682749,370500,390000,19500,5,39,tui-thoi-trang-nam
110182282,Túi Đeo Chéo Nam Phong Cách Lính U448 US ARMY Vải Dệt Cao Cấp -Hàng Chính Hãng,305.0,9884193030843,130000,260000,130000,50,104,tui-thoi-trang-nam
102918773,Ví Đứng Da Sáp Đựng Giấy Tờ Cũ Handmade Lealux The Stand Wallet,11.0,9738309901813,559000,559000,0,0,6,tui-thoi-trang-nam
82372883,Túi đeo chéo nam cao cấp phong cách mới,104.0,1853384397381,313500,330000,16500,5,31,tui-thoi-trang-nam
77747266,Túi đeo chéo vải canvas cao cấp phong cách mới,103.0,9811885282450,283100,298000,14900,5,32,tui-thoi-trang-nam
75319988,Túi đeo chéo unisex thời trang HARAS HR276,40.0,8911550783867,80000,80000,0,0,7,tui-thoi-trang-nam
74896948,Ví nam da bò Trita ( Thời trang nam dáng ngang - Ví da RVN05 ),56.0,5080164905996,199000,380000,181000,48,23,tui-thoi-trang-nam
74893788,Cặp Công Sở Lata ( Thời trang nam basic đựng laptop 15 inch - Cặp da CA32 ),13.0,7437697073322,529000,720000,191000,27,3,tui-thoi-trang-nam
48256263,[ KEIO NIPPON ] Ví Nam Da Bò Cao Cấp Kiểu Ngang | Bóp Da Bò Nam Ngang Cánh Lật ,740.0,4410221655587,199000,199000,0,0,259,tui-thoi-trang-nam
13668124,Túi du lịch thời trang BEE GEE 029,40.0,5238727703835,34500,69000,34500,50,0,tui-thoi-trang-nam
924544,Túi Đeo Chéo Nam HARAS HRTK147 (26 x 17 cm) - Đen,2273.0,7102851093828,65000,65000,0,0,75,tui-thoi-trang-nam
771415,Túi Đeo Chéo Nam Haras HRTK083 (26 x 17 cm) - Xanh,2554.0,7104669639564,65000,65000,0,0,82,tui-thoi-trang-nam
710785,Túi Đeo Chéo Nam HARAS HRTK083 (26 x 16.5 cm) - Đen,19458.0,7102685326338,100000,100000,0,0,819,tui-thoi-trang-nam
277460872,Túi Trita ( Thời trang nam phối nắp gập - Túi đeo chéo da RTN14 ),1.0,7580567493416,145000,290000,145000,50,0,tui-thoi-trang-nam
277362364,Túi đeo chéo đeo ngực nam có khóa chống trộm chống nước cao cấp phong cách mới,2.0,3774234538001,465500,490000,24500,5,1,tui-thoi-trang-nam
276755754,Túi đeo chéo nam DA BÒ THẬT – BEE GEE DCN9343A,1.0,7332291581725,610000,1220000,610000,50,1,tui-thoi-trang-nam
276609410,Bóp nam da bò - Ví da Nappa cao cấp tặng kèm hộp và túi sang trọng - Alpha 001,2.0,7978663899068,405000,450000,45000,10,1,tui-thoi-trang-nam
276067137,Túi đeo chéo nam DA BÒ THẬT – BEE GEE DCN9373,1.0,8646037676236,450000,900000,450000,50,0,tui-thoi-trang-nam
275262434,Túi đeo chéo nam phong cách mới  - BEE GEE DCN9349,2.0,6164809908064,350000,700000,350000,50,0,tui-thoi-trang-nam
275210932,"Túi Chạy Bộ Kiêm Đai Đeo Hông Dã Ngoại D Danido, Có chỗ cắm tai nghe chống thấm nước, kích thước 10x85cm cao cấp D Danido",1.0,7947091677573,54000,58000,4000,7,0,tui-thoi-trang-nam
275105852,Túi Đeo Chéo Đa Năng Chống Nước Sức Chứa Lớn Mẫu Mới Dành Cho Nam M3 - Hàng chính hãng,3.0,1334720615998,259000,259000,0,0,0,tui-thoi-trang-nam
275105698,"Túi đeo chéo nam chống nước thể thao kích thước 37x15x8 cặp đeo ngực,hông Và bao tử đa năng M1 - Hàng chính hãng",2.0,4868229582592,259000,259000,0,0,0,tui-thoi-trang-nam
274666078,Túi đeo chéo da bò M2CB-05 | Anh Tho Leather,1.0,9034910146097,1499000,1550000,51000,3,0,tui-thoi-trang-nam
274566244,"Ví Da Nam, Bóp Da Nam Kim Bảo H20 Da Bò Màu Đen, Nâu, Bò",1.0,5288760506915,425000,425000,0,0,0,tui-thoi-trang-nam
274443629,Cặp nam văn phòng Marrant BHM17610 Da bò thật Túi xách công sở nam. Vừa laptop 14inch. Phom cứng.Hàng chính hãng.,18.0,7837151259239,1400000,1400000,0,0,3,tui-thoi-trang-nam
273871830,Túi Đeo MIKKOR Betty Tablet - Hàng Chính Hãng,1.0,6758854310260,174000,290000,116000,40,1,tui-thoi-trang-nam
273046209,Ví nam nữ mini thông minh thương hiệu Natoli gập 3 đựng thẻ cao cấp - Futuristic Mini Wallet V8  ,8.0,3830757164276,469000,669000,200000,30,1,tui-thoi-trang-nam
272059803,Ví nam da bò khắc tên theo yêu cầu V113 - Bụi leather,1.0,7971165147444,275000,395000,120000,30,0,tui-thoi-trang-nam
263581262,Túi đeo chéo nam đa năng cao cấp phong cách mới,4.0,1197784977852,275500,290000,14500,5,0,tui-thoi-trang-nam
258122882,Túi xách nam thời trang công sở chống thấm nước cao cấp phong cách mới,7.0,5755834091588,522500,550000,27500,5,0,tui-thoi-trang-nam
254123805,Túi đeo chéo nam DA BÒ THẬT phong cách mới  - BEE GEE DCN9208,1.0,9008247030730,720000,1440000,720000,50,0,tui-thoi-trang-nam
244299439,Túi đeo chéo nam phong cách mới  - BEE GEE DCN9182,3.0,2786532558266,200000,400000,200000,50,0,tui-thoi-trang-nam
215371146,"Ví Da Nam Mềm Mại MIDDLE LINE, Size Lớn, Da Bò Tự Nhiên 100%, Thiết Kế Nhiều Ngăn Để Giấy Tờ Tiện Dụng, Đơn Giản - Mỏng Nhẹ, Dáng Ngang - Gập 2, Ngăn Đựng Tiền Có Khóa Kéo - Hàng Chính Hãng SAIGIO",4.0,1099432851176,899000,899000,0,0,1,tui-thoi-trang-nam
208183814,Túi đeo chéo nam DA cao cấp phong cách mới – BEE GEE DCN9119,1.0,4799892857561,300000,600000,300000,50,0,tui-thoi-trang-nam
191044555,ví nam ví nam clutch cầm tay cao cấp,23.0,4684961307716,247000,260000,13000,5,5,tui-thoi-trang-nam
189641563,Ví Da Nam Nữ Đựng Thẻ Handmade Lealux Mini Handmade 3,4.0,4742842266504,419000,419000,0,0,0,tui-thoi-trang-nam
188714006,Ví da nam PANDAGO Maximus mini cao cấp làm thủ công da thật nhỏ gọn bỏ túi thời trang,4.0,2307643797882,301000,301000,0,0,1,tui-thoi-trang-nam
158610488,"CITIZEN Business Card Holder, Ví Đựng Thẻ ATM Cao Cấp Dành Cho Doanh Nhân, Thiết Kế Hiện Đại - Sang Trọng, Chất Liệu Da Bò Vachetta Thuộc Thảo Mộc, Nhập Khẩu Từ Châu Âu, Hoàn Thiện Tỉ Mỉ - Tinh Tế Từng Chi Tiết - Hàng Chính Hãng SAIGIO ",1.0,1519521999149,2499000,2499000,0,0,0,tui-thoi-trang-nam
151798450,"Túi Đeo Dọc Chéo Wiwu Pioneer Phù Hợp Macbook Air/Pro New 13,3"" Surface Pro X/7/6/5 Và Ipad 12,9 inch - Hàng Chính Hãng",9.0,6898488105233,390000,390000,0,0,5,tui-thoi-trang-nam
146618296,"Bóp Da Đựng Thẻ ATM Nhỏ Gọn, Chất Da Pull-Up Mềm Mại, Trẻ Trung - Cá Tính, Thiết Kế Hiện Đại, Nhiều Ngăn Tiện Dụng, Đựng Thẻ Ngân Hàng, Card Danh Thiếp, Căn Cước Công Dân, Hình Lưu Niệm, Dáng Đứng - Gập 2 - Hàng Chính Hãng SAIGIO",11.0,9760963000071,799000,799000,0,0,1,tui-thoi-trang-nam
111869000,"Túi đeo chéo Arctic Hunter XB00105 chất liệu Oxford chống thấm nước, unisex nam nữ,trang bị cổng sạc USB tiện dụng",39.0,7100851298180,359000,635000,276000,43,28,tui-thoi-trang-nam
79691242,"Ví Thẻ Tín Dụng, Bóp Đựng Thẻ Tín Dụng, Bóp Hộp Kim Loại Đựng Thẻ Tín Dụng Tự Động, Ví Nam Denim Có Hộp Đựng Thẻ TOPEE VNH26",477.0,1035284587605,139000,278000,139000,50,148,tui-thoi-trang-nam
77038094,Ví dài Venuta2 Handcrafted Wallet HAVIAS,3.0,8914721309616,595000,595000,0,0,0,tui-thoi-trang-nam
77037678,Ví Da Gerbera2 Handcrafted Mini Wallet HAVIAS,1.0,3689366855272,395000,395000,0,0,0,tui-thoi-trang-nam
76687028,Ví nam da bò cao cấp phong cách mới,60.0,2732776557501,378100,398000,19900,5,25,tui-thoi-trang-nam
76152029,"Ví Nam, Nữ Cầm Tay Cao Cấp VinBuy – Bóp Nam, Nữ Kiểu Dáng Sang Trọng Cao Cấp Dành Cho Doanh Nhân – Hàng Chính Hãng VinBuy",1251.0,1016081319022,125000,250000,125000,50,478,tui-thoi-trang-nam
59358594,Ví nam da bò cao cấp phong cách mới,51.0,4365341922685,370500,390000,19500,5,22,tui-thoi-trang-nam
58563135,Cặp công sở Trita ( Thời trang nam đựng vừa laptop 14.6 inch - Cặp da TCA5 ),78.0,5837205719810,359000,650000,291000,45,25,tui-thoi-trang-nam
52179955,Ví nam da bò AT Leather - R02,152.0,2549622385914,229000,290000,61000,21,58,tui-thoi-trang-nam
51733010,Túi xách da nam công sở cao cấp,2.0,8758961368388,387000,387000,0,0,0,tui-thoi-trang-nam
49549841,Ví nam da bò Lata ( Thời trang nam - Ví da thật LVN58 ),7.0,9939557434505,229000,360000,131000,36,4,tui-thoi-trang-nam
8564318,Ví Nam Da Thật LATA LVN006,466.0,4219355940817,350000,350000,0,0,68,tui-thoi-trang-nam
5762417,Túi đeo ipad thời trang HARAS HRLT226,372.0,3312508036533,89000,89000,0,0,56,tui-thoi-trang-nam
275801447,Túi Đeo Hông Chạy Bộ Thể Thao Chống Nước MFL78 ,1.0,9821748399519,139000,139000,0,0,0,tui-thoi-trang-nam
275625709,Túi đeo chéo nam thời trang cao cấp phong cách mới,9.0,8194318684379,275500,290000,14500,5,1,tui-thoi-trang-nam
275024024,"Ví Da Nam Hàng Hiệu HERITAGE Siêu Bền Bỉ, Size Trung, Thiết Kế Cổ Điển, Đơn Giản, Dáng Ngang - Gập 2, Đựng Tiền và Thẻ ATM Tiện Dụng - Hàng Chính Hãng SAIGIO",2.0,7987946140112,1399000,1399000,0,0,1,tui-thoi-trang-nam
273587768,Túi đeo chéo nam thời trang cao cấp phong cách mới,10.0,2448373056755,332500,350000,17500,5,3,tui-thoi-trang-nam
273183808,Túi Đeo Chéo Vải Canvas Bền Bỉ Phong Cách Thời Trang Unisex Nam Nữ Hàn-Hàng Chính Hãng DRU,9.0,9170561951840,100000,125000,25000,20,1,tui-thoi-trang-nam
271137089,Túi đeo chéo nam DA BÒ THẬT phong cách mới  - BEE GEE DCN9316,0.0,6849204566539,1200000,2400000,1200000,50,0,tui-thoi-trang-nam
270109987,"Ví Nam Mini Nhỏ Gọn Cao Cấp, Da Bò PEBBLE Mềm Mại - Bền Bỉ, Chống Xước - Chống Nhăn Tốt, Thiết Kế Đơn Giản, Dáng Ngang - Gập 2, Đựng Tiền và Thẻ ATM Tiện Dụng",3.0,3033202630713,1099000,1099000,0,0,0,tui-thoi-trang-nam
263594614,Ví nam ngang da bò mỏng gọn BHM6092 chống quét RFID,0.0,1519475374665,299000,299000,0,0,0,tui-thoi-trang-nam
263328420,Túi đeo chéo nam VẢI CHỐNG NƯỚC phong cách mới  - BEE GEE DCN9251,4.0,3143244440710,210000,420000,210000,50,1,tui-thoi-trang-nam
262075509,"Túi Đeo Chéo Nam Thời Trang Cao Cấp Teement ,  Thương Hiệu Hợp Thời Trang Xu Hướng Hiện Đại , Lịch Lãm , Vải Polyester Chống Thấm Nước Hiệu Quả - Hàng Chính Hãng  ",23.0,8654176900828,180000,180000,0,0,7,tui-thoi-trang-nam
253171976,Ví nam 100% da thật thông minh siêu mỏng thời trang cao cấp phong cách cá tính,16.0,2661520664122,370500,390000,19500,5,4,tui-thoi-trang-nam
249683120,"Túi Đeo Chéo Túi Bao Tử Nam Nữ Thời Trang Trẻ Trung, Túi Đựng Ipad, Túi Đeo Vai Nhiều Ngăn Kéo Đựng Đồ Rất Tiện Lợi, Vải Oxford Chống Thấm Nước - EH1001 EH1002 EH1006",14.0,1010369629629,83000,167400,84400,50,1,tui-thoi-trang-nam
203199337,Túi đeo chéo nam phong cách châu âu,8.0,1265298268304,712500,750000,37500,5,6,tui-thoi-trang-nam
197879894,"Bóp Đứng Nam Nhỏ Gọn, Chất Liệu Da Bò PULL-UP Mềm Mại, Mỏng Nhẹ, Phong Cách Hiện Đại - Cá Tính, Size Trung, Dáng Đứng - Gập 2, Nhiều Ngăn Để Tiền Và Giấy Tờ Tiện Dụng",4.0,2884023026060,999000,999000,0,0,2,tui-thoi-trang-nam
197864356,"Ví Đứng Nam Nhỏ Gọn, Da Bò SMALL PEBBLE Mềm Mại - Bền Bỉ, Size Trung, Chống Xước - Chống Nhăn Tốt, Thiết Kế Đơn Giản, Dáng Đứng - Gập 2, 3 Ngăn Lớn Đựng Tiền Và 8 Ngăn Nhỏ Để Thẻ ATM, Giấy Tờ Tùy Thân - Hàng Chính Hãng SAIGIO",3.0,6797840722963,999000,999000,0,0,0,tui-thoi-trang-nam
193413395,"Bóp Nam Da Bò SÁP - Vân Tự Nhiên, Size Lớn, Thiết Kế Cổ Điển, Đơn Giản - Mỏng Nhẹ, Dáng Ngang - Gập 2, Ngăn Đựng Tiền Có Khóa Kéo, Nhiều Ngăn Để Giấy Tờ Tiện Dụng",2.0,2338577576430,899000,899000,0,0,1,tui-thoi-trang-nam
193106908,Ví nam da bò Trita ( Thời trang nam dáng ngang cao cấp - Ví da RVN21 ),16.0,2906125196814,199000,390000,191000,49,3,tui-thoi-trang-nam
192129582,Túi xách nam công sở da PU màu trơn thanh lịch có khóa số chính hãng YVan F80175-5,2.0,9692586750050,620000,620000,0,0,1,tui-thoi-trang-nam
186580955,Túi đeo chéo nam vải cavans cao cấp phong cách mới,25.0,6378813911346,332500,350000,17500,5,8,tui-thoi-trang-nam
184316710,Túi đeo chéo nam vải canvas cao cấp phong cách mới,16.0,5254280096195,340100,358000,17900,5,3,tui-thoi-trang-nam
176749882,"Ví Nam Cao Cấp, Da Bò NAPA Láng Mịn In Caro, Mỏng Nhẹ, Size Lớn, Thiết Kế Đơn Giản - Sang Trọng, Dáng Ngang - Gập 2, Ngăn Đựng Tiền Có Khóa Kéo, Nhiều Ngăn Để Giấy Tờ Tiện Dụng - Hàng Chính Hãng SAIGIO",23.0,6729038889024,1199000,1199000,0,0,8,tui-thoi-trang-nam
174029563,Túi đeoTúi đeo chéo cao cấp phong cách mới BEE GEE – DCN9040A,1.0,1720140047360,420000,840000,420000,50,0,tui-thoi-trang-nam
170523409,Ví dài cầm tay nam The Zipper Wallet chính hãng NATOLI đựng thẻ điện thoại nhiều ngăn cao cấp,1.0,3068699834143,698000,698000,0,0,0,tui-thoi-trang-nam
154207423,Cặp Xách Nam Công Sở Gence Da Bò Thật CDT04,1.0,1179979985950,2000000,2000000,0,0,1,tui-thoi-trang-nam
125149562,"Ví nam, bóp nam da bò sáp Bụi Leather V108 - Bảo hành 12 tháng",63.0,3490238819574,289000,370000,81000,22,22,tui-thoi-trang-nam
124935591,"Ví nam, bóp nam da bò Nappa Bụi Leather V101 - Bảo hành 12 tháng",194.0,4965484766062,289000,370000,81000,22,78,tui-thoi-trang-nam
116785351,"Ví Da Nam Mềm Mại GENTLE, Size Lớn, Da Bò 100%, Thiết Kế Nhiều Ngăn, Đựng Giấy Tờ Xe, Đựng Tiền và Thẻ Tiện Dụng, Dáng Ngang - Gập 2 - Hàng Chính Hãng SAIGIO",80.0,1573847249259,799000,799000,0,0,39,tui-thoi-trang-nam
116296341,Túi đeo chéo nam cao cấp tích hợp cổng sạc USB ngoài 208211,0.0,3986459994162,72800,72800,0,0,0,tui-thoi-trang-nam
115643255,"Ví Nam Mini Nhỏ Gọn Cao Cấp, Da Bò NAPA Láng Mịn, Thiết Kế Cổ Điển, Tinh Tế - Sang Trọng, Dáng Ngang - Gập 2, Đựng Tiền và Thẻ ATM Tiện Dụng - Hàng Chính Hãng SAIGIO",21.0,4423153378445,999000,999000,0,0,10,tui-thoi-trang-nam
103560049,Túi đeo chéo nam nữ phom đứng nắp gập IDIGO UB2-2006-00,0.0,1344580419802,360000,360000,0,0,0,tui-thoi-trang-nam
95004244,Túi đeo chéo nam vải canvas cao cấp phong cách mới,90.0,5898487306718,275500,290000,14500,5,23,tui-thoi-trang-nam
89176321,Túi xách túi đeo chéo nam vải canvas cao cấp phong cách mới,31.0,4799542989752,370500,390000,19500,5,10,tui-thoi-trang-nam
77746659,Túi đeo chéo nam vải canvas cao cấp phong cách mới,144.0,7293652171483,340100,358000,17900,5,35,tui-thoi-trang-nam
58478574,Túi Trita ( Thời trang nam phối ngăn - Túi đeo chéo da RTN3 ),308.0,3830846870218,219000,420000,201000,48,126,tui-thoi-trang-nam
56801124,Túi đeo chéo nam vải canvas TX0012 - Đi học - đi làm - đi chơi,72.0,6087377743390,288000,288000,0,0,29,tui-thoi-trang-nam
51064454,VÍ SEN TO - CHÍNH HÃNG KHACTEN.COM,41.0,4863641491066,950000,950000,0,0,17,tui-thoi-trang-nam
51060914,VÍ SEN 3 - CHÍNH HÃNG KHACTEN.COM,242.0,3558104284231,500000,500000,0,0,101,tui-thoi-trang-nam
50491493,"Túi đeo ngực,đeo chéo nam đã tích hợp công nghệ 4.0",126.0,3713755215830,598500,630000,31500,5,38,tui-thoi-trang-nam
19730058,Túi đeo chéo nam thời trang vải canvas TX0010 - đi học - đi chơi,92.0,5832042875323,295000,295000,0,0,21,tui-thoi-trang-nam
4353345,Túi đựng ipad Simplecarry LC Ipad2,11.0,2701036106442,390000,390000,0,0,2,tui-thoi-trang-nam
276807044,"Túi Đeo Chéo, Túi Bao Tử Đa Năng, Mẫu Thể Thao Năng Động Chống Thấm Nước, Có 4 Ngăn Đựng Đồ Tiện Dụng",1.0,6671515710759,45000,45000,0,0,1,tui-thoi-trang-nam
275991186,Túi đeo vai nam Aldo ALEXANDRE,0.0,2939213223955,1350000,1350000,0,0,0,tui-thoi-trang-nam
275774807,Túi đeo chéo nam phong cách mới  - BEE GEE DCN9372,0.0,5380336001813,320000,640000,320000,50,0,tui-thoi-trang-nam
275738833,Túi đeo chéo nam phong cách mới  - BEE GEE DCN9360,0.0,9527592878140,100000,200000,100000,50,0,tui-thoi-trang-nam
275592827,Cặp công sở nam cao cấp da bò BHM7612 Túi xách công sở nam,0.0,7465676581682,1750000,1750000,0,0,0,tui-thoi-trang-nam
275407096,Túi đeo chéo nam DA BÒ THẬT – BEE GEE DCN9355,1.0,9077332675249,620000,1240000,620000,50,0,tui-thoi-trang-nam
274892437,Mũ phớt cao bồi - Mũ cao bồi - Mũ golf thủ - Chất liệu da thô nguyên miếng cao cấp nhãn hiệu Macsim,0.0,9525830099130,4500000,4500000,0,0,0,tui-thoi-trang-nam
274713073,Ví dài da bò EMO | MNLW-01 | Anh Tho leather,0.0,6487943852657,729000,750000,21000,3,0,tui-thoi-trang-nam
271887337,Túi đeo chéo nam ngang nhỏ gọn BHM1238 chuẩn da bò thật,1.0,4123461455829,759000,759000,0,0,0,tui-thoi-trang-nam
252103766,"Túi Đeo Chéo Nam Teement Cao Cấp, Thời Trang Đa Phong Cách Mẫu Mới Siêu Hot Hiện Nay - Hàng Chính Hãng",11.0,4707918214855,180000,180000,0,0,1,tui-thoi-trang-nam
248762163,Túi đeo chéo nam phong cách mới  - BEE GEE DCN9179B,0.0,4433719770730,600000,1200000,600000,50,0,tui-thoi-trang-nam
244316262,Ví nam đựng tiền đựng chìa khóa đựng thẻ đa năng 100% da bò thật cao cấp phong cách mới,21.0,8615457103539,325850,343000,17150,5,2,tui-thoi-trang-nam
243046545,Cặp Da Công Sở Cao Cấp vừa Laptop 15.6inch MARRANT - BHM8841  Hàng chính hãng.,3.0,9505905487683,1550000,1550000,0,0,0,tui-thoi-trang-nam
241819867,"Ví nam đựng thẻ tin dụng, bóp nam cầm tay đựng thẻ ngân hàng atm, card,... có lẫy tự động cao cấp",17.0,9907179184502,139000,278000,139000,50,6,tui-thoi-trang-nam
221303491,Túi đeo chéo đeo vai nam vải canvas cao cấp phong cách mới,19.0,9205650098320,275500,290000,14500,5,4,tui-thoi-trang-nam
203226713,Ví đựng card bằng da cao cấp,5.0,8292347275462,185999,185999,0,0,0,tui-thoi-trang-nam
203146939,Túi đeo chéo King Bag Bamboo,1.0,4968580820220,290000,290000,0,0,1,tui-thoi-trang-nam
195822656,"Túi đựng iPad, máy tính bảng Wiwu Tablet Bag 11inch- Hàng chính hãng ",1.0,8561924407710,399000,399000,0,0,0,tui-thoi-trang-nam
193546263,"Bóp Nam Da Bò SÁP Họa Tiết Polka Dot, Size Lớn, Thiết Kế Cổ Điển, Đơn Giản - Mỏng Nhẹ, Dáng Ngang - Gập 2, Ngăn Đựng Tiền Có Khóa Kéo, Nhiều Ngăn Để Giấy Tờ Tiện Dụng",2.0,7546130605420,899000,899000,0,0,0,tui-thoi-trang-nam
190109508,"Ví Nam Mini Nhỏ Gọn Cao Cấp, Da Bò SMALL PEBBLE Mềm Mại - Bền Bỉ, Chống Xước - Chống Nhăn Tốt, Thiết Kế Đơn Giản, Dáng Ngang - Gập 2, Đựng Tiền và Thẻ ATM Tiện Dụng",2.0,8156247014542,899000,899000,0,0,1,tui-thoi-trang-nam
189641771,Ví Đứng Mini Da Sáp Handmade LEALUX Mini Handmade 5,1.0,9185973225847,529000,529000,0,0,1,tui-thoi-trang-nam
185991219,Túi đeo chéo nam đa năng cao cấp phong cách mới,44.0,5820066375250,351500,370000,18500,5,17,tui-thoi-trang-nam
184517203,Túi đeo chéo nam cao cấp phong cách mới,29.0,3665833038510,304000,320000,16000,5,10,tui-thoi-trang-nam
184491427,Túi đeo chéo nam 100% da bò thật cao cấp phong cách mới,55.0,4020926183434,477850,503000,25150,5,19,tui-thoi-trang-nam
184123552,Túi xách nam thời trang công sở chống thấm nước cao cấp,41.0,8594328437997,456000,480000,24000,5,9,tui-thoi-trang-nam
166227487,Túi Lata ( Thời trang nam công sở cỡ trung - Túi đeo chéo da TN27 ),9.0,4582835384865,620000,620000,0,0,7,tui-thoi-trang-nam
163281652,Túi đeo chéo đeo ngực nam cao cấp phong cách châu âu,33.0,2694069178265,655500,690000,34500,5,9,tui-thoi-trang-nam
144225073,Ví nam mini đựng thẻ atm phong cách mới nhỏ gọn thanh lịch,6.0,4892453467519,99000,99000,0,0,3,tui-thoi-trang-nam
135626167, Ví nam da bò thật VO 041005 ví đứng,1.0,4127972708046,198000,198000,0,0,0,tui-thoi-trang-nam
120036392,Túi đeo trước nam da đà điểu Huy Hoàng màu nâu đất HP6444,0.0,6689043233215,5999000,5999000,0,0,0,tui-thoi-trang-nam
119989735,"HP2301-02-03 - Ví nam Huy Hoàng da trăn màu da nguyên thủy, đen, nâu",0.0,6502572579762,599000,599000,0,0,0,tui-thoi-trang-nam
112218056,Túi đeo chéo nam đa năng cao cấp phong cách mới,38.0,3491156574918,218500,230000,11500,5,14,tui-thoi-trang-nam
96032830,"Túi Đeo Bụng, Túi Đeo Hông Nam Nữ Thời Trang Phong Cách Hàn Quốc Sport",4.0,2105097978462,50000,50000,0,0,0,tui-thoi-trang-nam
93842772,Túi đeo chéo đeo ngực nam cao cấp phong cách mới,40.0,4937773394161,655500,690000,34500,5,19,tui-thoi-trang-nam
57924770,Ví đứng da bò pull-up AT Leather 063D,174.0,6915290414892,299000,325000,26000,8,67,tui-thoi-trang-nam
56345077,"Túi đeo ngực,đeo chéo nam phong cách hiện đại mới",40.0,1299875013515,427500,450000,22500,5,18,tui-thoi-trang-nam
6114005,Ví Nam Da Thật Lata LVN25,155.0,2224138409605,209000,350000,141000,40,38,tui-thoi-trang-nam
711402,Túi Đeo Chéo Nam HARAS HRTK127 (32 x 18 cm) - Đen,1645.0,7106372815600,150000,150000,0,0,91,tui-thoi-trang-nam
481730,Túi Đeo Chéo Ipad Mikkor Betty Tablet BT005 - Camo ,3.0,7106398097424,203000,203000,0,0,1,tui-thoi-trang-nam
277561522,Clutch Ví Cầm Tay Túi Xách Nam GENCE RB15 Chất Liệu Da Bò Khóa Vân Tay Cao Cấp Màu Nâu,0.0,3328825896977,3000000,3000000,0,0,0,tui-thoi-trang-nam
277463956,Ví nam da bò Trita ( Thời trang nam dáng đứng da bò cao cấp - Ví da RVN18 ),0.0,7214680490361,195000,390000,195000,50,0,tui-thoi-trang-nam
276623015,"Túi đeo chéo Innostyle Flexicarry Crossbody -Khoá YKK, Chất liệu kháng nước Lựa chọn hoàn hảo mỗi ngày, Hàng chính hãng",0.0,2570223698203,890000,890000,0,0,0,tui-thoi-trang-nam
275765206,Clutch đựng tài liệu A4 da bò Nappa CL05-Ví cầm tay đựng giấy tờ A4-Túi đựng laptop 13 inch,0.0,7917065341108,1850000,1850000,0,0,0,tui-thoi-trang-nam
274359663,Cặp Xách Công Sở Thời Trang Cao Cấp SAKOS ORION 15.6 Inch,2.0,8624184305669,2272000,2840000,568000,20,1,tui-thoi-trang-nam
273702120,Clutch túi da vân cá sấu LOUIS,3.0,2913322977717,1650000,1650000,0,0,0,tui-thoi-trang-nam
251775338,Túi đeo chéo nam DA BÒ THẬT phong cách mới  - BEE GEE TDCN9195,0.0,3315147293473,1120000,2240000,1120000,50,0,tui-thoi-trang-nam
244305461,Túi đeo chéo nam phong cách mới  - BEE GEE DCN9184,0.0,5926736611295,210000,420000,210000,50,0,tui-thoi-trang-nam
243300434,Túi xách laptop nam thời trang công sở cao cấp phong cách mới 15.6inh,9.0,8982059862236,446500,470000,23500,5,2,tui-thoi-trang-nam
217540928,Túi Đeo Chéo Thời Trang SAKOS MINUS - Size S,11.0,3033093547790,724000,900000,176000,20,2,tui-thoi-trang-nam
204988917,"Ví Da Nam Gence, Bóp Nam Da Bò Epsom Màu Đen Cao Cấp C12 Dáng Ngang | Bảo Hành Chính Hãng",1.0,3755844449536,600000,600000,0,0,0,tui-thoi-trang-nam
202041721,Bóp ví da nam da bò thật - Vân cá sấu cao cấp 3 màu,2.0,9210868267379,139000,139000,0,0,0,tui-thoi-trang-nam
196758828,Túi Cầm Tay Đeo Chéo Nam Gence Da Bò Togo TC02,0.0,6003905872647,1600000,1600000,0,0,0,tui-thoi-trang-nam
186767942,Túi đeo chéo chính hãng TOMTOC (USA) Urban Codura Sling Bag Travel & Work - H02-B04 cho iPad 9.7-11 inch,0.0,8422338546161,1690000,1690000,0,0,0,tui-thoi-trang-nam
186208860,"Túi xách nam công sở, cặp da nam đựng laptop và tài liệu cao cấp GCE23",0.0,7537813505296,2800000,2800000,0,0,0,tui-thoi-trang-nam
180995094,"Túi Xách, Cặp Thời Trang Công Sở Nam Da Bò Alran Cao Cấp GCE12 Đen",0.0,7744528032478,2700000,2700000,0,0,0,tui-thoi-trang-nam
163572486,Ví da đứng Venumi Handcrafted Wallet,2.0,4387296147236,425000,425000,0,0,1,tui-thoi-trang-nam
163570697,Ví da Mini Handcrafted Smile Wallet,0.0,5336555832936,380000,380000,0,0,0,tui-thoi-trang-nam
160693811,Bao da Passport Vintage HAVIAS,1.0,5453552871902,190000,190000,0,0,0,tui-thoi-trang-nam
155330335,"Ví da nam, bóp da nam mini Bụi Leather V115 - Da bò Nappa cao cấp - Bảo hành 12 tháng",107.0,5572733456033,215000,278000,63000,23,34,tui-thoi-trang-nam
143112945,Túi Crossbody Oxford HAVIAS_ Túi Bao Tử Xanh Navy,1.0,3663128234532,350000,350000,0,0,1,tui-thoi-trang-nam
143112596,Ví Da Eclipse Handcrafted Mini Wallet HAVIAS,0.0,7994466922010,330000,330000,0,0,0,tui-thoi-trang-nam
129355668,Hộp quà tặng ví nam cao cấp,0.0,3487551868033,620000,620000,0,0,0,tui-thoi-trang-nam
127210944,Túi đeo chéo nam da bò thật BIGBEN cao cấp TXBB02,0.0,1659569577680,499000,499000,0,0,0,tui-thoi-trang-nam
125280023,"Ví nam, bóp nam da bò Saffiano Bụi Leather V128 - Bảo hành 12 tháng",22.0,4945512096574,289000,412000,123000,30,11,tui-thoi-trang-nam
125256490,"Ví nam, bóp nam da bò Saffiano Bụi Leather V126 - Bảo hành 12 tháng",86.0,5726058949415,287000,375000,88000,23,39,tui-thoi-trang-nam
119976867,Cặp Xách Nam Khóa Số Da Bò CTS07,1.0,9249461726932,3850000,3850000,0,0,0,tui-thoi-trang-nam
119132514,Ví Trita ( Thời trang nam đựng namecard tiện lợi - Ví da Liberal RVN11 ),32.0,7158777320896,75000,150000,75000,50,7,tui-thoi-trang-nam
117036103,"Ví Nam Cao Cấp, Da Bò NAPA Láng Mịn, Mỏng Nhẹ, Size Lớn, Kiểu Cổ Điển Tinh Tế - Sang Trọng, Dáng Ngang - Gập 2, Ngăn Đựng Tiền Có Khóa Kéo, Nhiều Ngăn Để Giấy Tờ Tiện Dụng - Hàng Chính Hãng SAIGIO",35.0,6067769458313,1199000,1199000,0,0,14,tui-thoi-trang-nam
102908331,Ví Da Nam Mini Handmade Da Sáp Lealux Mini Handmade 2,0.0,8215680947025,559000,559000,0,0,0,tui-thoi-trang-nam
71178766,Túi đeo chéo nam nữ du lịch tiện ích unisex thời trang Bee Gee 100 siêu đẹp chống thấm nước,2.0,3177819671756,90000,180000,90000,50,1,tui-thoi-trang-nam
58421960,"Ví Nam Cao Cấp KEIO NIPPON Da Bò Mill Nhập Khẩu Ý  | Size Lớn 12 x 9,5 cm | Đựng CMND, Bằng Lái Xe, CàVẹt Xe ",269.0,4492310715532,219000,219000,0,0,105,tui-thoi-trang-nam
56029758,VÍ SEN 1 - CHÍNH HÃNG KHACTEN.COM,46.0,8107180109409,300000,300000,0,0,14,tui-thoi-trang-nam
53104227,Combo 3 Túi Đeo Chéo Nam HARAS CBHR83VN (26 x 17 cm),33.0,1366156908959,300000,300000,0,0,0,tui-thoi-trang-nam
52608879,Ví Da Havias đứng Gen8 Handcrafted Wallet,1.0,1110603868439,455000,455000,0,0,0,tui-thoi-trang-nam
52478995,Túi xách đeo chéo nam nữ unisex thời trang Hàn quốc BEE GEE 077 siêu nhẹ chống thấm cực kỳ cá tính,5.0,7720690985595,69000,138000,69000,50,0,tui-thoi-trang-nam
52333333,Túi Đeo Chéo Thời Trang Hàn Quốc HARAS HR264,12.0,5281347147879,150000,150000,0,0,3,tui-thoi-trang-nam
22180357,Ví Nam Da Bò Thật Teramo Cao Cấp,1.0,2009532229031,129000,129000,0,0,0,tui-thoi-trang-nam
13645401,Túi đeo chéo nam nữ unisex thời trang Bee Gee 03,210.0,9484105305344,65000,130000,65000,50,16,tui-thoi-trang-nam
594977,Ví Dài Nam Baellerry Sang Trọng Đẳng Cấp GL WL1006,12.0,5103327213629,99000,99000,0,0,6,tui-thoi-trang-nam
277501956,Túi xách nam công sở da thật cao cấp phong cách mới,0.0,4863496663923,465500,490000,24500,5,0,tui-thoi-trang-nam
277359619,Túi đeo chéo nam 100% da bò thật cao cấp phong cách mới,2.0,2333174661132,503500,530000,26500,5,1,tui-thoi-trang-nam
276863275,Túi đựng điện thoại COMMAN_chiến thuật_chống nước,0.0,6666946740731,150000,150000,0,0,0,tui-thoi-trang-nam
276826311,Túi đeo chéo nam 100% da bò thật cao cấp phong cách mới,0.0,5357767281894,560500,590000,29500,5,0,tui-thoi-trang-nam
276626301,Túi đeo chéo nam TiMa nhiều ngăn chống nước cao cấp DTM M6,2.0,7207924306502,229000,229000,0,0,1,tui-thoi-trang-nam
275991160,Túi đeo chéo nam Aldo AFENDANNOR,0.0,3608638934121,2050000,2050000,0,0,0,tui-thoi-trang-nam
275106085,Túi Đeo Chéo Đa Năng Chống Nước Sức Chứa Lớn Mẫu Mới Dành Cho Nam M2 - Hàng chính hãng,3.0,1993177942090,289000,289000,0,0,1,tui-thoi-trang-nam
274423287,Ví nam Gence dáng dọc da bò Epsom màu đen C09,0.0,8527370321987,600000,600000,0,0,0,tui-thoi-trang-nam
262523630,Túi đeo chéo nam phong cách mới  - BEE GEE TDCN9191,1.0,6609483980512,290000,580000,290000,50,0,tui-thoi-trang-nam
254188884,Túi đeo chéo nam DA BÒ THẬT phong cách mới  - BEE GEE DCN9214,1.0,4282327056139,340000,680000,340000,50,1,tui-thoi-trang-nam
253111686,Túi đeo vai nam công sở thông minh vải oxford cao cấp chống thấm nước phong cách hàn quốc,8.0,3246148382425,332500,350000,17500,5,0,tui-thoi-trang-nam
219453468,Túi đeo chéo nam phong cách mới  - BEE GEE TDCN9170,1.0,2470468131087,320000,640000,320000,50,0,tui-thoi-trang-nam
214887642,Túi đeo chéo nam phong cách mới  - BEE GEE TDCN9165,1.0,8829372631563,210000,420000,210000,50,0,tui-thoi-trang-nam
205279845,Túi Đeo Chéo Túi Da Nam Cầm Tay GENCE TC02 Chất Liệu Da Bò Cao Cấp Màu Đen,0.0,2205210857709,1600000,1600000,0,0,0,tui-thoi-trang-nam
205082376,Túi đeo chéo nam đa năng cao cấp phong cách mới,10.0,5184613002183,351500,370000,18500,5,4,tui-thoi-trang-nam
198311724,Ví nam da đà điểu màu nâu đỏ HJ92422-24-28-37 ,0.0,8135565148476,899000,899000,0,0,0,tui-thoi-trang-nam
196789928,Túi đeo chéo nam phong cách mới  - BEE GEE DCN9078,0.0,4652082639645,485000,970000,485000,50,0,tui-thoi-trang-nam
189267895,Túi xách nam da PU cao cấp thời trang công sở YVan 2050-5,0.0,4682782694816,650000,650000,0,0,0,tui-thoi-trang-nam
177017362,Túi đeo chéo đeo vai nam vải canvas cao cấp phong cách mới,28.0,9680279216349,342000,360000,18000,5,8,tui-thoi-trang-nam
171665602,Ví nam da bò cao cấp Gianni Conti Italy 587012BLU - Màu xanh,0.0,4510269413110,1600000,1600000,0,0,0,tui-thoi-trang-nam
170498952,Ví da nam nữ dáng đứng NATOLI gập đôi đựng thẻ cao cấp BST Simple Vertical Wallet V3,96.0,9989747593216,256000,256000,0,0,40,tui-thoi-trang-nam
125097857,"Ví nam, bóp nam da bò sáp Bụi Leather V105 - Bảo hành 12 tháng",22.0,1970856884631,289000,370000,81000,22,11,tui-thoi-trang-nam
125078612,Túi đeo hông Marshall Underground Belt Bag - Hàng Chính Hãng,9.0,1738792938884,890000,890000,0,0,4,tui-thoi-trang-nam
125037676,"Ví nam, bóp nam da bò Nappa Bụi Leather V104 - Bảo hành 12 tháng",208.0,5321855774834,289000,370000,81000,22,70,tui-thoi-trang-nam
120469617,"Ví Nam Da Bò NAPA Mềm Mại - Vân Tự Nhiên, Size Lớn, Thiết Kế Cổ Điển, Đơn Giản - Mỏng Nhẹ, Dáng Đứng - Gập 2, Ngăn Đựng Tiền Có Khóa Kéo, Nhiều Ngăn Để Giấy Tờ Tiện Dụng - Hàng Chính Hãng SAIGIO",37.0,2693397913575,899000,899000,0,0,15,tui-thoi-trang-nam
113760273,Ví nam da bò cao cấp phong cách mới,33.0,8595151428104,408500,430000,21500,5,8,tui-thoi-trang-nam
112549741,Ví da nam Gianni Conti Italy 1607220BLA ,6.0,4423873556315,1600000,1600000,0,0,2,tui-thoi-trang-nam
107366288,Túi đeo chéo nam thời trang cao cấp ,34.0,8971057042508,332500,350000,17500,5,14,tui-thoi-trang-nam
99078225,Túi đeo chéo nam đa năng cao cấp phong cách mới,102.0,5312998726486,275500,290000,14500,5,35,tui-thoi-trang-nam
90519788,Túi đeo chéo đeo ngực nam cao cấp phong cách châu âu,89.0,3188127651444,617500,650000,32500,5,29,tui-thoi-trang-nam
87354662,"Túi xách laptop, công sở vải canvas kết hợp da hiệu MOYYI TXMY004",1.0,7714112889640,310000,310000,0,0,1,tui-thoi-trang-nam
75728670,Túi đeo chéo nam tích hợp khóa chống trộm chống nước cao cấp phong cách mới,119.0,1830627959714,313500,330000,16500,5,50,tui-thoi-trang-nam
56345302,Túi xách da nam cao cấp phong cách hiện đại mới,68.0,5728384143926,370500,390000,19500,5,26,tui-thoi-trang-nam
54902648,Ví Nam Da Cá Sấu Thật  BIGGBEN Cao Cấp BG6,10.0,6235205013416,999000,999000,0,0,2,tui-thoi-trang-nam
51299303,Túi xách da bò nam công sở cao cấp phong cách châu âu,8.0,1990266980781,931000,980000,49000,5,4,tui-thoi-trang-nam
50028638,Túi đeo chéo đeo ngực nam thông minh đa chức năng thời trang cao cấp phong cách cá tính,28.0,7683508463398,517750,545000,27250,5,12,tui-thoi-trang-nam
48223908,"Túi đeo ngực,đeo chéo phong cách châu âu đã tích hợp công nghệ 4.0",37.0,9494549770042,560500,590000,29500,5,13,tui-thoi-trang-nam
44000845,Cặp Công Sở Lata ( Thời trang nam basic - Cặp da CA25 ),14.0,1973582154876,720000,720000,0,0,6,tui-thoi-trang-nam
11801361,Túi đeo chéo nam hàn quốc HR227,930.0,7162486053079,650000,650000,0,0,156,tui-thoi-trang-nam
2355761,Ví Nam Da Cá Sấu Ngăn Sau Huy Hoàng HT2284 - Rêu ,0.0,3206996178052,1049000,1049000,0,0,0,tui-thoi-trang-nam
275480634,Túi đeo chéo nam cao cấp BHM8710 Da bò nguyên tấm. Hàng chính hãng.,0.0,6648847148735,1199000,1199000,0,0,0,tui-thoi-trang-nam
273347958,Ví Cầm Tay Clutch Da Nam Hàng Hiệu GENCE CK20 Chất Liệu Da Bò Cao Cấp Màu Đen,0.0,5873270331159,1700000,1700000,0,0,0,tui-thoi-trang-nam
272073601,Ví mini khắc tên da bò V115 - Bụi leather,0.0,7899820977643,215000,322000,107000,33,0,tui-thoi-trang-nam
270115970,"Túi xách nam công sở da thật, túi đeo chéo nam du lịch đựng máy tính bảng 7.9 inch ngăn trước vạt chéo IDIGO MB1 - 6019",0.0,2106267434627,750000,750000,0,0,0,tui-thoi-trang-nam
263445903,Túi đeo chéo nam phong cách mới  - BEE GEE DCN9261,2.0,7294662378161,290000,580000,290000,50,1,tui-thoi-trang-nam
263368852,Túi đeo chéo nam phong cách mới  - BEE GEE DCN9252D,1.0,3584990446970,260000,520000,260000,50,0,tui-thoi-trang-nam
263318312,Túi đeo chéo nam DA BÒ THẬT phong cách mới  - BEE GEE DCN9279,0.0,3838841870274,360000,720000,360000,50,0,tui-thoi-trang-nam
259535067,"Túi Đeo Hông Đeo Đùi SWAT Chiến Thuật US ARMY Chống Nước Dùng Đi Phượt, Leo Núi, Dã Ngoại Thời Trang Phong Cách -HÀNG CHÍNH HÃNG",11.0,7703226592849,125000,250000,125000,50,4,tui-thoi-trang-nam
219456879,Túi đeo chéo nam phong cách mới  - BEE GEE TDCN9172,4.0,6216379229463,295000,590000,295000,50,1,tui-thoi-trang-nam
217540523,Túi Đeo Chéo Thời Trang SAKOS MINUS - Size SX,18.0,9020010614478,644000,800000,156000,20,9,tui-thoi-trang-nam
204883486,Ví nam da bò Trita ( Thời trang nam dáng ngang - Ví da RVN16 ),4.0,4508055699944,249000,450000,201000,45,1,tui-thoi-trang-nam
204031843,Ví đựng thẻ vải Polyester KANTAPRO dáng ngang - Mini Wallet (5 colors),0.0,3755193515738,220000,220000,0,0,0,tui-thoi-trang-nam
202770665,Túi đeo chéo nam đa năng cao cấp phong cách mới,5.0,9986475095056,218500,230000,11500,5,1,tui-thoi-trang-nam
189641639,Ví Nam Da Sáp Mini Dáng Ngang Handmade LEALUX Mini Handmade 4,3.0,7670434869085,529000,529000,0,0,1,tui-thoi-trang-nam
186254950,Túi đeo chéo nam cao cấp phong cách HÀN QUỐC BEE GEE– 01390,1.0,7204961326542,129000,258000,129000,50,0,tui-thoi-trang-nam
182726124,Túi đeo chéo Tomtoc H52-E02D01 Premium Messenger Bag Commuting &amp; Travel 16 inch,0.0,8878920712893,1750000,1750000,0,0,0,tui-thoi-trang-nam
148850139,"Ví nam đựng thẻ Arctic Hunter Q00013 thiết kế nhiều ngăn, chống nước, chống xước",48.0,6139182311571,99000,185000,86000,46,34,tui-thoi-trang-nam
126039327,"Bóp Đựng Thẻ ATM Nhỏ Gọn SUPPLE, Da Bò SMALL PEBBLE Mềm Mại - Bền Bỉ, Chống Xước - Chống Nhăn Tốt, Thiết Kế Hiện Đại, Ngăn Súp Lê Rộng, Đựng Được Nhiều Thẻ Ngân Hàng, Card Danh Thiếp, Căn Cước Công Dân, Dáng Đứng - Gập 2 – Hàng Chính Hãng SAIGIO",19.0,8930684684618,699000,699000,0,0,7,tui-thoi-trang-nam
125136680,"Ví nam, bóp nam da bò sáp Bụi Leather V106 - Bảo hành 12 tháng",21.0,5145044650462,289000,370000,81000,22,13,tui-thoi-trang-nam
115520033,Cặp da công sở tay rút nắp can VINADA ,12.0,6523744806132,269000,269000,0,0,4,tui-thoi-trang-nam
111868834,"Túi đeo chéo,đeo ngực Arctic Hunter XB00126 chất liệu Oxford chống thấm nước thiết kế đơn giản, hiện đại, phù hợp nam nữ",70.0,7413672514953,399000,720000,321000,45,58,tui-thoi-trang-nam
103047087,Ví Đựng Thẻ Nam Nữ Da Epsom Handmade Lealux Mini Epsom Wallet 1,10.0,2898542195190,599000,599000,0,0,2,tui-thoi-trang-nam
93712433,ví nam - ví nam cầm tay cao cấp,50.0,9353247279162,283100,298000,14900,5,18,tui-thoi-trang-nam
90507801,Túi đeo chéo đeo ngực nam có khóa chống trộm chống nước cao cấp,117.0,7720003604504,446500,470000,23500,5,39,tui-thoi-trang-nam
83677957,Balo Trita ( Thời trang nam đi chơi - Balo da RBAC01 ),139.0,4385716135954,199000,390000,191000,49,62,tui-thoi-trang-nam
75645911,Túi đeo chéo nam phong cách mới tích hợp khóa chống trộm và chống thấm nước cao cấp,142.0,7172223207306,351500,370000,18500,5,57,tui-thoi-trang-nam
75616814,Túi đeo chéo nam tích hợp khóa chống trộm và chống thấm nước cao cấp phong cách mới ,146.0,1870270535996,446500,470000,23500,5,67,tui-thoi-trang-nam
74926237,Túi Bao Tử Đeo Chéo Cao Cấp Đơn Giản Nhỏ Gọn Nam Nữ Để Điện Thoại Ví Galaxy Store GTBT02 - Hàng Chính Hãng,193.0,8957870161381,179000,350000,171000,49,48,tui-thoi-trang-nam
58210087,"Cặp nam công sở cao cấp BHM7355 Da bò nguyên tấm. Túi xách công sở nam. Vừa laptop 14inch,phom cứng. Sang trọng, lịch lãm",5.0,5486056505310,1999999,1999999,0,0,2,tui-thoi-trang-nam
54645206,"Cặp công sở nam MARRANT BHM2099 Da bò thật, vừa laptop 14inch, có khe cài vali, chính hãng.",14.0,9559010164154,800000,800000,0,0,6,tui-thoi-trang-nam
53459983,[ KEIO NIPPON ] Ví Nam Da Bò Saffiano Cao Cấp Nhập Khẩu | Bóp Nam Kiểu Ngang,442.0,6148500048581,209000,209000,0,0,173,tui-thoi-trang-nam
51147505,"Túi đeo ngực,đeo chéo nam đã tích hợp công nghệ 4.0",39.0,6830238585697,826500,870000,43500,5,20,tui-thoi-trang-nam
45018395,Túi đeo chéo nam nữ unisex thời trang BEE GEE 063,213.0,5052307109370,69000,138000,69000,50,52,tui-thoi-trang-nam
13420442,Túi đeo chéo nam BEE GEE 046 DENS,193.0,3232124879515,65000,130000,65000,50,7,tui-thoi-trang-nam
12134191,Túi đeo chéo ANELLO vải polyester chống thấm nước AT-B1717,1.0,9843079215972,1520000,1520000,0,0,1,tui-thoi-trang-nam
10761949,Túi đeo chéo nam thời trang HARAS HR241,333.0,2494758078776,150000,150000,0,0,42,tui-thoi-trang-nam
3978035,Ví nam da cá sấu BALZIO MWCROC H W01-BR,0.0,5635381373372,560000,980000,420000,43,0,tui-thoi-trang-nam
3937509,Ví Dài Nam Aligro ALGVD15 Màu Nâu (19 x 2cm),0.0,3097960045841,907500,907500,0,0,0,tui-thoi-trang-nam
710997,Túi Đeo Chéo Nam HARAS HRTK118 (27 x 17 cm) - Xám,1217.0,7101762230179,90000,90000,0,0,33,tui-thoi-trang-nam
481737,Túi Đeo Chéo Ipad Mikkor Betty Tablet BT006 - Nâu ,3.0,7109166166612,203000,203000,0,0,1,tui-thoi-trang-nam
277541766,Túi đeo chéo nam đựng ipad FADODA FDC11,0.0,8063575965924,299000,590000,291000,49,0,tui-thoi-trang-nam
277346085,Ví Nam Da Bò Thật – VNA9020,0.0,8293284193980,620000,1240000,620000,50,0,tui-thoi-trang-nam
275741764,Túi đeo chéo nam phong cách mới  - BEE GEE DCN9364,2.0,8291014508328,100000,200000,100000,50,0,tui-thoi-trang-nam
275121868,"Túi đeo vai nhỏ RONCATO EASY OFFICE 2.0 vải Polyester, Thương hiệu Ý (Mã 41272701 x 41272723)",1.0,9820059142842,610000,610000,0,0,0,tui-thoi-trang-nam
275029896,Túi đeo chéo nam đa năng cao cấp phong cách mới,0.0,1590302417167,351500,370000,18500,5,0,tui-thoi-trang-nam
273818918,Cặp công sở Trita ( Thời trang nam phong cách đựng vừa laptop 13.3 inch - Cặp da TCA25 ),2.0,5007157541493,349000,510000,161000,32,1,tui-thoi-trang-nam
273156397,"Túi đeo chéo Messenger cỡ to vải Poly cao cấp chống thấm nước, bền bỉ unisex nam nữ phong cách thời trang, cá tính-Hàng Chính Hãng DRU",5.0,2606633623661,120000,150000,30000,20,0,tui-thoi-trang-nam
270703645,Cặp Công Sở Lata ( Thời trang nam basic - Cặp da CA39 ),1.0,5503985326253,860000,860000,0,0,0,tui-thoi-trang-nam
255763034,Túi đeo chéo nam DA BÒ THẬT phong cách mới  - BEE GEE DCN9231,0.0,1396745174334,540000,1080000,540000,50,0,tui-thoi-trang-nam
253172056,Ví nam 100% da thật thông minh đa năng thời trang cao cấp phong cách mới,4.0,7649323455067,446500,470000,23500,5,1,tui-thoi-trang-nam
248759762,Túi đeo chéo nam phong cách mới  - BEE GEE TDCN9178,1.0,1436699553519,600000,1200000,600000,50,0,tui-thoi-trang-nam
248676443,"Túi Đeo Chéo 11 Inch có cổng sạc USB, vải trượt nước, nhiều ngăn phụ tiện ích KINGBAG JULIUS I - Hàng Chính Hãng",4.0,8707526048485,390000,780000,390000,50,1,tui-thoi-trang-nam
210155944,Balo Lata ( Thời trang nam cá tính cở nhỏ - Balo đeo chéo da BALC29 ),8.0,4940962125292,490000,490000,0,0,3,tui-thoi-trang-nam
208395919,Túi xách da bò nam công sở cao cấp phong cách châu âu,8.0,7891614647912,712500,750000,37500,5,3,tui-thoi-trang-nam
202414665,Túi đeo chéo nam nữ phong cách mới – BEE GEE DCN9097,8.0,1219980873996,240000,480000,240000,50,4,tui-thoi-trang-nam
193638928,Túi đeo chéo nam nữ thời trang đa năng cao cấp phong cách mới,9.0,6471187674552,104500,110000,5500,5,4,tui-thoi-trang-nam
193611368,Túi đeo chéo nam đa năng cao cấp phong cách mới,60.0,7074994047269,209000,220000,11000,5,13,tui-thoi-trang-nam
185995682,Túi đeo chéo đeo ngực nam đa năng cao cấp phong cách mới,54.0,8551916989869,275500,290000,14500,5,17,tui-thoi-trang-nam
183363493,Ví nam ngang da cá sấu 2 mặt  thương hiệu FA FCW04  vân bụng da cá sấu,1.0,4414179703646,1660000,1660000,0,0,1,tui-thoi-trang-nam
177057064,Túi đeo chéo Nam bằng vải cao cấp TDC02,1.0,2803492622178,54000,54000,0,0,1,tui-thoi-trang-nam
173805916,Túi đeo chéo nam da cá sấu cao cấp BEE GEE – DCN9042	,0.0,8839419055847,450000,900000,450000,50,0,tui-thoi-trang-nam
173660344,Ví Nam Da Bò Thật BIGGBEN Cao Cấp BG17,0.0,3415991195383,320000,320000,0,0,0,tui-thoi-trang-nam
173652490,Ví Nam Da Cá Sấu Thật BIGGBEN Cao Cấp BG8,0.0,1369662411448,1000000,1000000,0,0,0,tui-thoi-trang-nam
164338907,Túi đeo chéo đeo ngực nam cao cấp phong cách châu âu,23.0,1375173875318,513000,540000,27000,5,8,tui-thoi-trang-nam
152868978,Clutch Nam Ví Da Cầm Tay Thời Thượng GENCE HT02 Da Bò Cao Cấp Màu Đen,1.0,9308117422091,1650000,1650000,0,0,0,tui-thoi-trang-nam
109483831,Túi đeo chéo nam thời trang cao cấp ,28.0,1157445627402,474050,499000,24950,5,6,tui-thoi-trang-nam
109389766,Túi xách nam công sở da tự nhiên cao cấp phong cách mới,32.0,5801766358274,446500,470000,23500,5,12,tui-thoi-trang-nam
74793752,Túi đeo chéo nam cao cấp phong cách mới,30.0,3910479779017,560500,590000,29500,5,11,tui-thoi-trang-nam
58227879,Ví nam da bò Trita ( Thời trang nam dáng ngang - Ví da RVN002 ),22.0,6208881317048,199000,380000,181000,48,13,tui-thoi-trang-nam
58214240,Ví nam da bò Lata ( Thời trang nam dáng cầm tay cỡ lớn  - Ví da thật VN37 ),0.0,9709022878864,389000,590000,201000,34,0,tui-thoi-trang-nam
54902408,Ví Nam Da Cá Sấu Thật BIGGBEN Cao Cấp BG6,0.0,9623127475325,999000,999000,0,0,0,tui-thoi-trang-nam
54901081,Ví Nam Da Cá Sấu BIGGBEN Cao Cấp BG5,4.0,3537950858957,999000,999000,0,0,3,tui-thoi-trang-nam
54420877,"Túi đeo chéo,đeo ngực nam đã tích hợp công nghệ 4.0",37.0,6078042321227,655500,690000,34500,5,18,tui-thoi-trang-nam
44146712,Túi xách da bò công sở cao cấp phong cách châu âu TX DA BÒ 7618,2.0,6015512675473,931000,980000,49000,5,0,tui-thoi-trang-nam
44044629,Cặp công sở thời trang CAYUUMY07,34.0,2727925440961,235000,390000,155000,40,18,tui-thoi-trang-nam
21560454,Túi Xách Công Sở Nam Mikkor The Ralph Briefcase,49.0,6145163324243,690000,690000,0,0,14,tui-thoi-trang-nam
6893091,Ví nam da bò AT Leather 041,98.0,8540097359725,299000,325000,26000,8,16,tui-thoi-trang-nam
771480,Túi Đeo Chéo Praza DCTK090 (25 x 15 cm) - Đen,1253.0,7101640751895,59000,59000,0,0,36,tui-thoi-trang-nam
771471,Túi Đeo Chéo Praza DCTK095 (23 x 17 cm) - Xám,1938.0,7105835041440,49000,49000,0,0,82,tui-thoi-trang-nam
277553830,"[Mới] Viên rửa chén bát hương chanh Finish Ultimate plus All in 1, túi 33 viên - Dòng siêu cao cấp",51.0,9160657948939,299000,414000,115000,28,1,cham-soc-nha-cua
200618527,Viên Rửa Chén Bát Hương Chanh Finish Powerball Power All In 1 Max - Túi 100 viên siêu tiết kiệm,651.0,8634737443831,472000,560000,88000,16,54,cham-soc-nha-cua
200618708,Viên Rửa Chén Bát Hương Chanh Finish Powerball Power Essential Lemon Sparkle - Túi 100 viên siêu tiết kiệm,1947.0,3225364296581,375000,450000,75000,17,161,cham-soc-nha-cua
205290063,"Muối rửa bát Finish 4kg - Muối finish 4.0kg cho Máy rửa bát chén ly, Muối rửa chén finish hay gọi là Muối làm mềm nước Finish gói 1.5kg, 4 kg, 1.2kg",9.0,1644705400197,129000,129000,0,0,1,cham-soc-nha-cua
277553771,Viên Rửa Chén Bát Finish Powerball All In One Túi 24V x10 sức mạnh vượt trội,29.0,9932693639943,162000,169000,7000,4,0,cham-soc-nha-cua
277717564,Combo 2 Nước Giặt ARIEL Chuyên Gia Cửa Trước Ngăn Lem Màu Túi 3.7KG/3.9KG,5.0,5022246363501,399000,584000,185000,32,0,cham-soc-nha-cua
277522377,Nước Rửa Chén Bát Sunlight Chanh 100 Sạch Nhanh Xả Bọt Nhanh Rửa Sạch Dầu Mỡ - Túi 3.5KG,558.0,3003696403115,94000,94000,0,0,56,cham-soc-nha-cua
276230116,Túi Nước Giặt ARIEL Chuyên Gia Cửa Trên Ngăn Lem Màu - Hương Downy Nước Hoa 3.65KG,102.0,6229612997960,211000,236500,25500,11,7,cham-soc-nha-cua
276126456,Sáp thơm 230g Mr.Fresh Pure Aroma,19.0,8470903230529,37100,42000,4900,12,0,cham-soc-nha-cua
104883479,Nước Rửa Chén Gốc Thực Vật Peace Mass Công Nghệ Enzyme Rửa Sạch & Không Lưu Mùi (Thuộc nhóm Sản phẩm Lành tính / Hữu cơ/ Sinh học) Can 3.6 Lít,1148.0,3293533682221,169000,169000,0,0,191,cham-soc-nha-cua
277553813,Viên rửa chén bát Finish Quantum túi 21 viên,75.0,1355499894702,158000,219000,61000,28,2,cham-soc-nha-cua
276112994,"Túi 64 Viên Rửa Chén Bát Finish Powerball Quantum 12x sức mạnh, túi lớn siêu tiết kiệm",40.0,5505232918580,339000,559000,220000,39,1,cham-soc-nha-cua
277554059,Túi Viên Rửa Chén Bát Finish Powerball Power All In 1 - 100 Viên,0.0,5391636217327,1500000,3354000,1854000,55,0,cham-soc-nha-cua
277554073,"Combo Túi Viên Rửa Chén Bát Finish Powerball Quantum 12x sức mạnh, siêu tiết kiệm - Túi 64 viên",3.0,9382610088798,703000,828000,125000,15,0,cham-soc-nha-cua
276074946,Viên giặt xả Top Step hương Nắng mai tươi mát gói 15 viên (210g),27.0,2903149130538,75000,130000,55000,42,2,cham-soc-nha-cua
276074942,Viên giặt xả Top Step hương Nước hoa tinh tế gói 15 viên (210g),41.0,3055233611465,75000,130000,55000,42,2,cham-soc-nha-cua
276074941,Viên giặt xả Top Step hương Lavender nồng nàn gói 33 viên (462g),99.0,1390032244186,139000,250000,111000,44,8,cham-soc-nha-cua
275707347,Túi Viên Giặt Xả Maxkleen Hương Nước Hoa Huyền Diệu 15g x 34Viên,201.0,9795789299696,105000,140000,35000,25,13,cham-soc-nha-cua
275707340,Túi Viên Giặt Xả Maxkleen Hương Ngày Thư Thái 15g x 34Viên,76.0,9142480618949,105000,140000,35000,25,6,cham-soc-nha-cua
112710607,Nước Lau Sàn Gốc Thực Vật Peace Mass TD Chanh Sả - Bạc Hà Đuổi Muỗi và Côn Trùng (Thuộc nhóm Sản phẩm Lành tính / Hữu cơ/ Sinh học) Can 3.6 lít,322.0,5375629674870,217000,217000,0,0,47,cham-soc-nha-cua
275043342,Viên giặt xả tide pods 3 in 1  thùng 156 viên mẫu mới của mỹ,23.0,8969410328880,900000,900000,0,0,2,cham-soc-nha-cua
171320962,Thuốc diệt gián Nhật Bản hộp 12 viên  ,1517.0,9067608317294,59000,59000,0,0,96,cham-soc-nha-cua
275204679,"Viên diệt gián Nhật Bản hộp 12 viên Barracks Cap diệt sạch gián tận gốc, khử mùi hôi",174.0,2147648607032,125000,125000,0,0,7,cham-soc-nha-cua
174609723,Combo TLC1 Peace Mass Nước Lau Rửa Toilet Gốc Thực Vật700ml + Nước Lau Kính Gốc Thực Vật 700ml (Thuộc nhóm Sản phẩm Lành tính / Hữu cơ/ Sinh học),8.0,9142926632297,189000,189000,0,0,0,cham-soc-nha-cua
274778322,Thuốc diệt kiến sinh học anbio Chai 10ml An toàn hiệu quả Diệt tận gốc,582.0,2319192414221,13000,13000,0,0,15,cham-soc-nha-cua
274274524,Chai Xịt Đuổi Chuột Samurai Care Hương Bạc Hà Đuổi Chuột Hiệu Quả Dùng Trong Nhà Và Ô Tô Không Chút Độc Hại Thân Thiện Môi Trường,32.0,5944598459183,47481,93100,45619,49,2,cham-soc-nha-cua
273705617,Giấy ăn 5 lớp cao cấp - khăn giấy rút để bàn (400 tờ/gói),94.0,4764526543419,85000,108000,23000,21,4,cham-soc-nha-cua
273493650,"Khăn giấy 4 lớp Chef&Chef treo tường dạng rút tiết kiệm, an toàn, tiện lợi (Thùng 4 bịch)",110.0,8940716418260,245000,245000,0,0,7,cham-soc-nha-cua
273260717,Nước Xả Vải Comfort Dịu Nhẹ Cho Cả Gia Đình - Thơm Dịu Êm Túi 3.6L,0.0,9637067651289,230000,230000,0,0,6,cham-soc-nha-cua
270845002,Nước xả vải đậm đặt Thái lan Hygiene expert care 1150 ml,221.0,7800224842640,96000,96000,0,0,17,cham-soc-nha-cua
263982400,Túi Nước Giặt Omo Matic Cho Máy Giặt Cửa Trước Hương Hoa Anh Thảo - Ngăn Mùi Ẩm Mốc 4.1KG,149.0,7483475374345,206000,250000,44000,18,17,cham-soc-nha-cua
197777679,Viên giặt Kirkland Signature Premium - Túi 152 viên,284.0,6009819449204,770000,1000500,230500,23,48,cham-soc-nha-cua
181426565,Nước Xả Vải Comfort Thơm Mát Gấp 10 Lần/Hương Nước Hoa 100 Giờ Lưu Hương - Hương Nắng Mới Túi 3.7L,1138.0,2716376497028,231000,271000,40000,15,153,cham-soc-nha-cua
170565948,Chai Xịt Đuổi Chuột Rat Off - Anti Rat Spray Thái Lan 200ml Tặng kèm móc khóa (Mẫu Ngẫu nhiên),2058.0,7841597471037,83000,84000,1000,1,250,cham-soc-nha-cua
134799829, Nước rửa bát Kao CuCute 1380 ml Nhật Bản - hàng chính hãng,115.0,4184700826273,135000,135000,0,0,17,cham-soc-nha-cua
126022163,"Bột thông cống cực mạnh HGO SUPER bột thông bồn cầu, bồn rửa bát, đường ống, chai 250gram",8597.0,8045642374849,49000,75000,26000,35,622,cham-soc-nha-cua
125240682,Nước Xả Vải DOWNY,39604.0,9595434971017,215000,259000,44000,17,5451,cham-soc-nha-cua
116410159,Túi Nước Giặt Omo Matic Cho Máy Giặt Cửa Trước - Bền Đẹp Bền Màu 4.1KG,13662.0,5671347860876,206000,250000,44000,18,1646,cham-soc-nha-cua
116407260,Combo 2 Túi Nước Giặt Omo Matic Cho Máy Giặt Cửa Trước Hương Lavender - Khử Mùi Thư Thái 4.1KGx2,9236.0,5037400427202,413000,908000,495000,55,1148,cham-soc-nha-cua
116407258,Combo 2 Túi Nước Giặt Omo Matic Cho Máy Giặt Cửa Trước - Bền Đẹp Bền Màu 4.1KGx2,9620.0,2936481430956,420000,495000,75000,15,1202,cham-soc-nha-cua
111304924,"Túi Nước Giặt Omo Matic Cho Quần Áo Bé Yêu Chiết Xuất Tràm Trà Và Nha Đam Dịu Nhẹ, Sạch Khuẩn 4.1kg",10450.0,4985360277120,206000,250000,44000,18,1231,cham-soc-nha-cua
58202555,Giấy Lau Sàn Nhà Hòa Tan Thay Thế Nước Lau Sàn HOMI Mã HS01 Công Nghệ Tiên Tiến Vượt Trội Giúp Lau Sạch Bóng Sàn Nhà Chỉ Với Một Miếng Giấy - Hàng Chính Hãng,200.0,3253968689856,15000,29000,14000,48,20,cham-soc-nha-cua
57844916,Túi Nước Giặt Xả Maxkleen Hương Nước Hoa Huyền Diệu (3.8kg),15633.0,2134646328193,165000,210000,45000,21,1,cham-soc-nha-cua
57675962,Túi Nước Giặt Xả Maxkleen Hương Vườn Sớm Mai (3.8kg),4487.0,4683471162222,165000,210000,45000,21,2,cham-soc-nha-cua
48184895,Dung dịch tẩy rửa máy rửa chén Finish Dishwasher Cleaner Lemon 2x250ml QT04441 - hương chanh,3.0,5522639672762,169000,169000,0,0,0,cham-soc-nha-cua
37488247,"Túi Thơm Thảo Dược Treo Xe Hơi, Khử Mùi Xe, Hương Thơm Thư Giãn Hapaku",631.0,8243507524385,119000,119000,0,0,88,cham-soc-nha-cua
35322397,Combo 3 lọ Thuốc diệt kiến gián sinh học Hanpet- Dung dịch diệt kiến tận gốc,2906.0,3414654208151,32000,32000,0,0,399,cham-soc-nha-cua
10199645,Nước rửa bát Kao 1380ml hương trà xanh nội địa  Nhật Bản,79.0,4581181296063,157300,157300,0,0,9,cham-soc-nha-cua
275863520,Viên Rửa Chén Bát Finish Powerball Quantum Powerful Clean & Shine 64 viên,56.0,6714395222894,419000,559000,140000,25,3,cham-soc-nha-cua
277522477,Nước rửa chén Sunlight Bio-care Thiên Nhiên 100% Gốc thực vật - Hương Matcha Trà Nhật Túi 3.3KG,469.0,4392846045296,106000,114000,8000,7,45,cham-soc-nha-cua
277522384,Nước rửa chén Sunlight Bio-care Thiên Nhiên 100% Gốc thực vật - Muối Khoáng Lô Hội Túi 3.3KG,747.0,8779502323330,109000,114000,5000,4,65,cham-soc-nha-cua
277522367,Nước Lau Sàn Sunlight BIOSHIELD Ngăn Côn Trùng Hiệu Quả - Hương Quế & Cam Bergamot Túi 3.4KG,943.0,6179168754575,75100,80400,5300,7,82,cham-soc-nha-cua
277356829,[Tiết kiệm] Thùng 3 Túi Nước Giặt Xả Maxkleen Hương Nước Hoa Huyền Diệu (3.8kgx3),6.0,1729268914686,460000,573000,113000,20,1,cham-soc-nha-cua
277356652,[Tiết kiệm] Thùng 3 Túi Nước Giặt Xả MaxKleen Hương Hoa Nắng (3.8kgx3),4.0,5437727518672,460000,573000,113000,20,0,cham-soc-nha-cua
276333693,Túi Nước Giặt ARIEL Chuyên Gia Cửa Trên Ngăn Lem Màu - Hương Lavender 3.65KG,14.0,5928948953317,199000,236500,37500,16,1,cham-soc-nha-cua
276074948,Viên giặt xả Top Step hương Nước hoa tinh tế gói 33 viên (462g),111.0,4659774600170,139000,250000,111000,44,9,cham-soc-nha-cua
275009530,"Thuốc diệt gián sinh học AMB, Viện Hàn lâm khoa học Việt Nam, diệt tận gốc tất cả các loại gián, hiệu quả, an toàn.",74.0,7591989965271,35000,35000,0,0,2,cham-soc-nha-cua
205293880,Nước làm bóng finish 800ml dùng cho Máy rửa bát chén,515.0,9181114645075,110250,110250,0,0,93,cham-soc-nha-cua
276022641,"1 Kg Keo Sơn Mờ Kính Chống Nhìn Trộm TAIKOMI, Keo Sơn Bóng Mờ Kính Văn Phòng, Mờ Kính Cửa Sổ, Nhà Tắm, Phòng Ngủ",1.0,4990249128628,144500,289000,144500,50,1,cham-soc-nha-cua
198296613,Dung Dịch Tẩy Rửa Máy Rửa Chén Bát Finish Dishwasher Deep Cleaner,565.0,1314374129312,119000,135000,16000,12,44,cham-soc-nha-cua
274858021,Sáp Thơm Glade Hương Trầm Hương 180g,389.0,4663595103453,55000,55000,0,0,1,cham-soc-nha-cua
274742686,"Xịt chống muỗi và côn trùng cho bé PMY Nội địa Nhật Bản 200ml xịt muỗi cho bé,xịt đuổi muỗi",29.0,4322979818361,75000,75000,0,0,3,cham-soc-nha-cua
274667507,"Chai Bột Thông Cống Cực Mạnh Tẩy Vệ Sinh Bồn Cầu, Bồn Rửa Chén Bát, Đường Ống, Bồn Rửa Mặt Cực Kì Hiệu Quả",371.0,4977291819800,10000,13000,3000,23,12,cham-soc-nha-cua
274536010,"[Combo Tiện Lợi] Gói Men Bể Phốt EcoClean Septic - Men Vi Sinh Xử Lý Hầm Cầu, Bể Phốt Đầy, Tràn - Túi Gói 100gram",992.0,7245369251722,246000,246000,0,0,192,cham-soc-nha-cua
273926103,Combo 2 Chai Tẩy Rửa Nhà Tắm DUCK Siêu Tẩy Pro 900mlx2,9542.0,4055771799925,60100,86200,26100,30,3,cham-soc-nha-cua
273713238,"Xịt Tẩy Quần Áo Đa Năng - Tlex Làm Sạch Mọi Vết Bẩn Trên Quần Áo Trắng Và Màu, Xịt Làm Sạch Quần Áo - TLex 500ml , TLex - Xịt Làm Sạch Quần Áo Cao Cấp Không Làm Phai Màu Quần Áo, An Toàn Dịu Nhẹ Với Da Tay",131.0,4116399182603,52000,59000,7000,12,12,cham-soc-nha-cua
273281761,[Hàng chính hãng] Hộp thuốc diệt gián 12 viên Nhật Bản mẫu mới nhất năm 2023,99.0,9156393511289,45000,45000,0,0,6,cham-soc-nha-cua
273273512,"18 Gói Khăn Giấy Bỏ Túi LET-GRREN, 10 Tờ/Gói",10.0,8662416586272,36000,36000,0,0,0,cham-soc-nha-cua
271168875,Hộp khử mùi tủ lạnh diệt khuẩn bảo vệ đồ ăn Nội địa Hàn Quốc 150g,9.0,8571927009916,35000,35000,0,0,0,cham-soc-nha-cua
270966116,Nước Giặt Xả Đậm Đặt HYGIENE Túi 1800ml Sạch mọi viết bẩn - hương thơm tươi mát cả ngày dài,72.0,8340534959413,134000,134000,0,0,6,cham-soc-nha-cua
270851433,Khăn giấy lụa khăn giấy ăn rút Ecotissue gói 250 tờ thấm hút tốt mềm mịn an toàn sạch sẽ,91.0,8561122177409,25000,42500,17500,41,3,cham-soc-nha-cua
206706612,"Khăn Giấy Hộp, Khăn Giấy Rút Pulppy Lốc 5 Hộp180 tờ x 2 lớp mềm mịn siêu dai",94.0,1698044021783,145000,145000,0,0,1,cham-soc-nha-cua
204745983,"Ecoclean Septic - Men Vi Sinh Xử Lý Hầm Cầu Bể Phốt - Khử mùi, phân hủy chất thải, hết nghẹt hầm, hiệu quả sau 1 đêm - Gói 100g - 1 gói 100g",772.0,3969562311746,79000,86000,7000,8,64,cham-soc-nha-cua
199010742,"Thông cống Funu, thông tắc bồn cầu lavabo xử lý tắc nghẽn ống thoát nước khử mùi hôi - Hàng chính hãng",659.0,3167479019434,27000,30000,3000,10,28,cham-soc-nha-cua
176922003,"[COMBO 12 GÓI] Khăn giấy rút, khăn đa năng Premier VinaTissue 2 lớp 100% bột giấy nguyên sinh, không chất tẩy gói 200 tờ",382.0,2337073763760,90000,90000,0,0,33,cham-soc-nha-cua
175847142,Giấy vệ sinh loại 10 cuộn không lõi trắng mịn dai không bụi cao cấp ERO - HTpaper (10 cuộn),702.0,8840855677937,36000,36000,0,0,42,cham-soc-nha-cua
167543143,"Bình Xịt phòng tinh dầu Sả Chanh, Bạc hà, Quế, Bạch đàn chanh Vemoda giúp đuổi muỗi, thơm phòng nhanh chóng. Chai xịt đuổi muỗi từ tinh dầu thiên nhiên",802.0,9887930801228,129000,179000,50000,28,121,cham-soc-nha-cua
156219561,Xịt Thơm Phòng AMBIPUR Aerosol Chai 300 ML,34.0,7980602703488,58000,61500,3500,6,3,cham-soc-nha-cua
129278367,Nước Lau Sàn Sunlight Tinh Dầu Thảo Mộc - Hương Hoa Hạ Bạc Hà Túi 3.6KG,1749.0,1262928645866,75000,95000,20000,21,132,cham-soc-nha-cua
101148136,"Bột Thông Cống YUHAO 280gr - Thông Tắc Cực Mạnh, Đường Ống, Bồn Cầu, Bồn Rửa Mặt - Hàng Chính Hãng",3349.0,3044571652322,39000,39000,0,0,175,cham-soc-nha-cua
84304880,"Tẩy cặn canxi nhà tắm HGO PLUS làm sạch vòi sen inox, vách kính, bồn sứ, gạch men, Chai 500ml",4892.0,1793787561041,79000,150000,71000,47,870,cham-soc-nha-cua
74458728,Thuốc diệt chuột Storm 0.005% (1 gói x 20 viên) (bao bì mới),363.0,1173986788961,40000,40000,0,0,45,cham-soc-nha-cua
74458578,"Combo 5 gói thuốc diệt muỗi, gián, kiến, ruồi, bọ chét, kiến ba khoang Fendona 10SC (5ml) (Bao bì mới)",79.0,9698377768954,59800,59800,0,0,8,cham-soc-nha-cua
49904410,Nước Lau Sàn Diệt Khuẩn Mao Bao Hương Làn Gió Biển chai 1000ml,210.0,8273842271651,39500,45000,5500,12,16,cham-soc-nha-cua
37883466,Muối rửa bát Finish 4.0 kg,100.0,4325218499948,229000,229000,0,0,13,cham-soc-nha-cua
35322959,Thuốc diệt mối dạng nước có đầu xịt tiện dụng,541.0,4047379153742,55000,55000,0,0,61,cham-soc-nha-cua
33139668,Viên Giặt Quần Áo Kháng Khuẩn Kirkland Signature Ultra Clean 152 Viên Của Mỹ,117.0,3972000664629,740000,740000,0,0,27,cham-soc-nha-cua
2646887,Chất Tẩy Rửa Đa Năng Sumo (700g),352.0,9132556775086,54000,54000,0,0,41,cham-soc-nha-cua
576191,Nước Giặt Kháng Khuẩn Mao Bao 3200g,1022.0,3821963113302,127000,159000,32000,20,114,cham-soc-nha-cua
277680282,[Thùng 4 Túi] Nước Giặt ARIEL Chuyên Gia Cửa Trước Ngăn Lem Màu Túi 3.7KG/3.9KG,4.0,5442584433508,821000,1168000,347000,30,0,cham-soc-nha-cua
277553911,Dung Dịch Tẩy Rửa Máy Rửa Chén Bát Finish Dishwasher Deep Cleaner,22.0,5485498893377,209000,214000,5000,2,2,cham-soc-nha-cua
277474259,"Combo 3 Túi Viên Giặt Top Step Hàn Quốc 7in1 Công Nghệ Enzyme  An Toàn Cho Da, Sạch Đột Phá - 33 Viên (462gx3)",4.0,8447282840075,375000,750000,375000,50,0,cham-soc-nha-cua
276876242,Viên rửa bát Hữu cơ Finish Ultimate Eco 0% 100 viên không mùi chất tẩy rửa- BA LAN,2.0,9410897819273,669000,669000,0,0,0,cham-soc-nha-cua
276655313,"Dầu gội, xả Zn Compliment ngăn gàu, giảm ngứa vẩy nến da đầu 200ml/chai  ",2.0,1501138198591,110000,110000,0,0,1,cham-soc-nha-cua
276115055,Hộp bột tẩy vệ sinh lồng máy giặt Hando 200g (Hộp 2 x 100g),20.0,6958131262528,39000,45000,6000,13,0,cham-soc-nha-cua
275707334,Hộp Viên Giặt Xả Maxkleen Hương Nước Hoa Huyền Diệu 15g x 20Viên,54.0,3303189644063,84000,105000,21000,20,4,cham-soc-nha-cua
275589378,Combo Viên rửa bát Finish 100 viên Essential 6 in 1 + 800ml Nước làm bóng bát chén finish + 1.5kg Muối rửa bát Finish,1143.0,4874590211572,629000,629000,0,0,244,cham-soc-nha-cua
275567638,Xịt thơm phòng GLADE 280ml,46.0,8061699449825,54100,55000,900,2,4,cham-soc-nha-cua
275206202,"Combo 3 chai thuốc diệt kiến gián Anbio diệt tận gốc kiến hôi, kiến đen, kiên lửa, gián đức",98.0,1903419951560,69000,69000,0,0,6,cham-soc-nha-cua
275146515,Nước Xịt Vải Downy Antibac+ Hương Nắng Mai 370ml,18.0,1214863547432,87000,109000,22000,20,5,cham-soc-nha-cua
274881850,Nước tẩy trắng quần áo Javel Hando 1L,19.0,2121132288076,22000,22000,0,0,2,cham-soc-nha-cua
274858026,Sáp Thơm Glade Hương Chanh 180g,5444.0,7498003716057,55000,55000,0,0,1,cham-soc-nha-cua
274451664,Lọ tỏa hương Loveseed hương thơm tự nhiên dễ chịu khử mùi sáp thơm phòng thế hệ mới 60 ngày - Dung tích 200ml,37.0,1934369156039,61000,61000,0,0,3,cham-soc-nha-cua
273926105,Chai Tẩy Rửa Nhà Tắm DUCK Hương Hoa 900ml,56.0,5818135372735,35000,48000,13000,27,5,cham-soc-nha-cua
273849627,"Thuốc diệt kiến gián sinh học SAMI SAMI cao cấp thế hệ mới, diệt kiến gián tận gốc mạnh hơn gấp đôi hoạt chất sinh học",114.0,8922975685957,31500,45000,13500,30,10,cham-soc-nha-cua
273562898,Nước Giặt Orita Concentrated Laundry Detergent 550ml,23.0,7123591784971,85000,85000,0,0,2,cham-soc-nha-cua
273509283,"Giấy Ăn Nội Địa Trung Đa Năng Siêu Dai Loại Đẹp, Mềm Mịn Giấy Ăn 5 Lớp , Không Bở Khi Dính Nước, An Toàn Cho Sức Khỏe ",33.0,1217320954915,115000,115000,0,0,3,cham-soc-nha-cua
273302608,"Nước Lau Bếp Đa Năng,Tẩy Xoong Nồi Siêu Sạch,Tẩy Dầu Mỡ Nhà Bếp,Tẩy Dầu Mỡ Máy Hút Mùi,Tẩy Bếp Từ Bếp Gas Dr.c 500ml",9.0,4805704841280,104000,165000,61000,37,2,cham-soc-nha-cua
272446649,"Thuốc Diệt Mối Tận Gốc Greenhome Termize 200SC, Chai 50ml, Sinh Học Thế Hệ Mới, An Toàn, Không Mùi, Diệt Cả Đàn",50.0,4629906625419,176000,250000,74000,30,5,cham-soc-nha-cua
271587929,"Xả Vải Khô Dạng Xịt Công Nghệ Sinh Học Ecohome 100ml Hương Comfor While Vỏ Hồng Làm Mềm Vải Khử Mùi Hôi, Lưu Hương Lâu",3.0,7241797732573,65000,130000,65000,50,1,cham-soc-nha-cua
270673699,Dung dịch thông tắc đường ống Johnson 800g Nhật Bản,72.0,6334154260175,137000,137000,0,0,6,cham-soc-nha-cua
262795880,Bột tẩy trắng quần áo đồ gia dụng đa năng Oxi Clean Ximo 350G,9.0,7672796676434,65000,65000,0,0,0,cham-soc-nha-cua
262072976,"Nước giặt xả hữu cơ Bồ Hòn tinh dầu Hoa Bưởi ECOCARE 4 lít - Bền màu, giữ dáng, làm mềm vải, an toàn da nhạy cảm",328.0,8095202627848,334000,345000,11000,3,42,cham-soc-nha-cua
206706621,Lốc 10 cuộn Giấy vệ sinh Pulppy cao cấp siêu mềm mịn,228.0,7966793196274,98000,98000,0,0,5,cham-soc-nha-cua
175167978,GIẤY VỆ SINH CUỘN LỚN PRIME (0.8KG) 2 LỚP - COMBO 2 CUỘN,61.0,2170781281899,70000,70000,0,0,5,cham-soc-nha-cua
152924114,Cuộn Giấy Lau Nhà Bếp Đa Năng  200 Tờ Màu Trắng Siêu Dai - Giấy Mềm Có Thể Giặt Được - Hàng Chính Hãng ,29.0,2504729565355,12000,12000,0,0,7,cham-soc-nha-cua
148074025,KHĂN ĂN BLESSYOU GÓI 100 TỜ KÍCH THƯỚC 33X33CM,216.0,4387897034444,21200,21200,0,0,4,cham-soc-nha-cua
74459328,Thuốc diệt chuột Storm 0.005% (5 gói x 20 viên) (Bao bì mới),471.0,6370752342272,130000,130000,0,0,43,cham-soc-nha-cua
72875812,"Combo 20 gói khăn giấy lau tay Roto eco20-2 hai lớp 100% bột giấy nguyên sinh, dài 20cm, họa tiết chấm bi xốp, thấm hút 2 chiều, gồm 102 tờ/gói",1101.0,1816883138810,218000,218000,0,0,98,cham-soc-nha-cua
72711979,Nước thông cống 1L xuất khẩu,266.0,9464756864513,39000,39000,0,0,27,cham-soc-nha-cua
66698381,"Sáp thơm phòng khử mùi Pure Aroma 230g - an toàn, hiệu quả",2158.0,1343532137592,38000,38000,0,0,239,cham-soc-nha-cua
51520769,Nước Giặt Xả Gốc Thực Vật 2in1 Peace Mass (Thuộc nhóm Sản phẩm Lành tính / Hữu cơ/ Sinh học) Can 3.6l,242.0,9585132716896,274000,274000,0,0,28,cham-soc-nha-cua
48182043,Dung dịch tẩy rửa máy rửa chén Finish Dishwasher Cleaner Lemon 250ml PTT006774 - hương chanh,9.0,5161499848599,100000,100000,0,0,2,cham-soc-nha-cua
42824798,"Gói Bột Tẩy Rửa, Vệ Sinh Lồng Máy Giặt - Nội Địa Nhật",13.0,5111321305844,32500,32500,0,0,1,cham-soc-nha-cua
25271867,Thuốc diệt mối thế hệ mới Termize 200SC diệt cả đàn (50ml),504.0,4236123571073,120000,120000,0,0,57,cham-soc-nha-cua
25096869,Bột Tẩy Quần Áo Thiên Nhiên Mao Bao chứa Baking Soda (12g x 2 gói),2184.0,6122296405568,24000,32000,8000,25,111,cham-soc-nha-cua
10111752,Hộp Khử Mùi Than Hoạt Tính Chuyên Dụng Cho Tủ Giày - Nội Địa Nhật Bản,58.0,2283137049847,32500,32500,0,0,3,cham-soc-nha-cua
7248879,Bột Men Vi Sinh Xử Lý Hầm Cầu SiFa Bio Fast (300gr),899.0,5645884444356,39900,39900,0,0,54,cham-soc-nha-cua
504655,Nước Tẩy Quần Áo Màu Axo Hồng Hương Hoa Đào Chai 800ml,357.0,9203025519514,51000,54000,3000,6,1,cham-soc-nha-cua
277771961,Viên giặt xả Bold GelBall 4D P&G hương hoa tươi mát túi refill 36 viên,14.0,3472214315389,214000,249000,35000,14,1,cham-soc-nha-cua
277654169,[Thùng 4 Túi] Nước Giặt ARIEL Chuyên Gia Cửa Trên Ngăn Lem Màu Túi 4.1KG,1.0,3168429024032,808000,1168000,360000,31,0,cham-soc-nha-cua
276581595,Bột tẩy trắng quần áo Denkmit Oxi Power Đức 750gr tẩy mạnh vết ố bẩn cứng đầu,6.0,4023133566485,185000,185000,0,0,2,cham-soc-nha-cua
276126427,Nước xả Sandokkaebi 1.3L,35.0,7458015944637,33100,39000,5900,15,1,cham-soc-nha-cua
275920952,Combo Finish tiện lợi 3: Túi 100 Viên Rửa Bát All In 1+ Nước Làm Bóng Finish 500ml +Dung Dịch Vệ Sinh Máy Finish 250ml,7.0,7948331474413,720000,770000,50000,6,0,cham-soc-nha-cua
275618112,"Combo 2 lọ bột thông cống AMB, bột thông bồn cầu, bồn rửa bát, tắc cống siêu mạnh, hiệu quả an toàn",28.0,9734150399970,136500,136500,0,0,2,cham-soc-nha-cua
275048617,Viên Giặt Tide Pods Ultra Oxi 104 Viên 3.08kg – Mỹ,15.0,9496528279461,850000,850000,0,0,0,cham-soc-nha-cua
274957682,Gel rửa chén bát sinh học cho máy ENZYCO 850ml - Chiết xuất Bồ hòn và Enzyme Dứa,5.0,2003032982573,238000,238000,0,0,0,cham-soc-nha-cua
274900974,"DỤNG CỤ GẮP RÁC SIÊU TIỆN LỢI ( Dài 60cm )-que móc rác thông tắc bồn chậu rửa, nhà vệ sinh, nhà tắm, ống cống - HENRYSA",9.0,9891572358986,29000,50000,21000,42,1,cham-soc-nha-cua
274858040,Sáp Thơm Glade Hương Biển Phiêu Bồng 180g,619.0,3521284258371,45100,55000,9900,18,1,cham-soc-nha-cua
274858038,Sáp Thơm Glade Hương Hoa Lavender 180g,1831.0,4528457732667,45100,55000,9900,18,2,cham-soc-nha-cua
274361205,"Chai Xịt X-RUST 500ml Tẩy Sạch Gỉ Sét, Xịt Tẩy Rửa Nhà Tắm, Nhà Bếp, Đồ Dùng Gia Đình Tẩy Sạch Mọi Vết Bẩn Tặng Kèm Vòi Xịt",3.0,6815924267896,19000,36100,17100,47,0,cham-soc-nha-cua
274057116,"Viên Giặt Xả Quần Áo Tide Pods Free & Gentle 152 Viên 3,45kg Hàng Nhập Mỹ",8.0,5273821532715,910000,910000,0,0,1,cham-soc-nha-cua
273303551,"Bột Thông Cống Cực Mạnh,Tẩy Lồng Máy Giặt,Thông Bồn Cầu,Thông Bồn Rửa Bát Rửa Mặt Dr.C Be-easy 100g",5.0,6619098379080,59000,66000,7000,11,2,cham-soc-nha-cua
270129290,"Chai Xịt Tẩy Cặn Canxi CleanZ Chống Ăn Mòn Inox Vệ Sinh Vòi Rửa, Vòi Sen, Vách Kính",23.0,4114999365720,62000,62000,0,0,1,cham-soc-nha-cua
263119964,"Combo 2 Chai nước giặt kháng khuẩn, khử mùi Walch (3Lx2)",5.0,5315358731765,458000,458000,0,0,0,cham-soc-nha-cua
225195934,"Bột thông cống KG52 khử mùi chống nghẹt bồn cầu, lavabo, chậu rửa bát, đường ống phân hủy cực mạnh , xử lý triệt để nhanh chóng loại 280g- Hàng chính hãng",374.0,8456455814859,75000,75000,0,0,22,cham-soc-nha-cua
216099311,Miếng Dán Khử Mùi Toilet Than Hoạt Tính  MINIIN  Hình Thú Ngộ Nghĩnh - Mùi Hương Thơm Dễ Chịu Thơm Tủ Quần Áo - Hàng Loại 1 - Chính Hãng,10.0,4647285176114,9000,9000,0,0,1,cham-soc-nha-cua
205293864,Viên rửa bát finish quantum 100 viên ( Đức ),1.0,6577174765928,189000,189000,0,0,1,cham-soc-nha-cua
196381756,"Thông tắc bồn cầu toilet siêu tốc 5 phút SIFA 999 700ml, 800ml, 1400ml, 1600ml chống hôi khử khuẩn",22.0,1159356142699,81000,81000,0,0,0,cham-soc-nha-cua
191320779,Bình xịt muỗi Raid hương lavender 600ml,11.0,4578830413111,65000,65000,0,0,1,cham-soc-nha-cua
184505820,Nước Rửa Chén Gốc Thực Vật Peace Mass Công Nghệ Enzyme Rửa Sạch & Không Lưu Mùi - Can 3.6l (Thuộc nhóm Sản phẩm Lành tính / Hữu cơ/ Sinh học),42.0,6211029300072,171000,171000,0,0,8,cham-soc-nha-cua
176895202,Nước Giặt ARIEL Chuyên Gia Cửa Trước Ngăn Lem Màu,3294.0,1204387578896,199000,270000,71000,26,324,cham-soc-nha-cua
130742256,Viên Thả Làm Sạch Bồn Cầu (1 Gói 10 Viên)  - Loại tốt,98.0,3407947614534,25000,45000,20000,44,2,cham-soc-nha-cua
121315432,Nước làm bóng Finish 1150ml chính hãng dùng cho máy rửa bát ,20.0,3132460925735,249000,249000,0,0,1,cham-soc-nha-cua
118709704,"Gói 30 viên băng phiến long não khử mùi,xua đuổi côn trùng 120Gr(Thiên Nhiên)",92.0,8877637709859,20000,20000,0,0,7,cham-soc-nha-cua
102544225,Muối rửa chén bát Finish 4.0 kg Finish EU,2.0,2263516429841,268000,268000,0,0,0,cham-soc-nha-cua
89298871,Combo 10 cuộn giấy vệ sinh An khang Soft 700 hai lớp một cuộn 700gr,243.0,6066123484071,483000,483000,0,0,49,cham-soc-nha-cua
82007810,"Thuốc diệt muỗi, gián, kiến, ruồi, bọ chét, kiến ba khoang Fendona 10SC 50 ml x 1 chai KHÔNG MÙI (bao bì mới)",775.0,4285824131772,90000,90000,0,0,95,cham-soc-nha-cua
77333139,Combo 2 nước giặt sinh học ENZYCO 2L - Chiết xuất Bồ hòn và Enzyme Dứa,24.0,3613494992538,538000,538000,0,0,3,cham-soc-nha-cua
68258376,Nước rửa chén hữu cơ Bồ hòn Ecocare tinh dầu Vỏ Cam 2000ml,135.0,7125320918217,215000,280000,65000,23,16,cham-soc-nha-cua
61819456,"Nước rửa chén hữu cơ Bồ hòn Ecocare - 100% thực vật, không hóa chất, tinh dầu khử mùi, chăm sóc da tay, tiết kiệm nước 30% - Chai 500ml",170.0,8592713228434,70000,70000,0,0,32,cham-soc-nha-cua
54619802,"Chai Thả Bồn Cầu Nhật bản, Vệ Sinh Bồn Cầu, Giúp Hỗ Trợ Giảm Thông Tắc Bồn Cầu Và Khử Mùi, Diệt Sạch 99% Vi Khuẩn (Combo 02 Lọ) - Hàng Chính Hãng",2348.0,6430296253431,37000,37000,0,0,376,cham-soc-nha-cua
54509649,"Viên Khử Trùng và Vệ Sinh Bồn Cầu, Hỗ Trợ Diệt Khuẩn Giảm Thông Tắc Bồn Cầu Xuất Xứ Nhật Bản - Diệt Khuẩn, Khử Mùi, Vệ Sinh Bồn Cầu Cực Kì Hiệu Quả",1002.0,2921846302364,19000,19000,0,0,128,cham-soc-nha-cua
51953954,Combo Muối rửa bát finish 1.5kg+Nước làm bóng finish800ml dùng cho Máy rửa bát,21.0,8007238205940,255000,255000,0,0,5,cham-soc-nha-cua
16935264,"Nước rửa chén Mr.Fresh 4,2L Hương Quế",252.0,9049014934643,90000,90000,0,0,45,cham-soc-nha-cua
14289257,Nước giặt Layer Clean hương Poppy Coach 4L,31.0,7305341000997,239000,239000,0,0,9,cham-soc-nha-cua
4618495,Chai nước hoa xịt thơm phòng khử mùi Hando 200ml,87.0,5520170860211,29000,29000,0,0,8,cham-soc-nha-cua
501433,Nước Lau Sàn Mrs McKenic Chai 2L,33.0,9204661478098,251000,251000,0,0,4,cham-soc-nha-cua
277269499,"Xịt Khử Mùi Phòng Vệ Sinh Từ Tinh Dầu Thiên Nhiên , Khử Mùi Thơm Phòng Như Khách Sạn Spa 5 Sao Chai Lớn 300ml",9.0,2338137410049,97440,168000,70560,42,1,cham-soc-nha-cua
277228061,Hộp Viên Giặt Maxpure Hương Huyền Thoại 30v,2.0,6773929031646,105000,105000,0,0,1,cham-soc-nha-cua
276958260,Nước giặt đồ lót AVATAR lưu hương 48 hours 6 in1 (Chai 500ML) - Hương Anh Đào Ngọt Ngào,1.0,8222656242249,119000,198000,79000,40,0,cham-soc-nha-cua
276919410,"Viên giặt xả Gell Bold 4 in 1 Túi 90V, 76V, 70V (MÀU HỒNG, TÍM) -Hàng Nhật Nội Địa",3.0,8879714710922,435000,435000,0,0,0,cham-soc-nha-cua
276642985,"[MUA 2 LỐC TẶNG 1 GÓI KHĂN RÚT + 1 GÓI KHĂN ƯỚT] Khăn giấy rút cao cấp Tempo Softpack - 4 lớp bền dai, an toàn cho da - Thương hiệu Đức (4 gói/Lốc)",2.0,6631349519248,236000,236000,0,0,0,cham-soc-nha-cua
276556413,Nước rửa chén hương chanh nước hoa và muối hồng 800ml,4.0,4835451999095,28080,43200,15120,35,1,cham-soc-nha-cua
276115057,Chai tẩy vệ sinh toilet Hando 200g,3.0,9360592954389,42000,42000,0,0,0,cham-soc-nha-cua
275792281,Combo Viên rửa bát All in 1 100 viên + Muối Finish 1.5kg + Nước làm bóng Finish 800ml hương chanh,1.0,9530266021439,629000,629000,0,0,0,cham-soc-nha-cua
275779453,Gel rửa bát Finish Classic 1500ml,1.0,2206464572323,299000,299000,0,0,0,cham-soc-nha-cua
275414568,"Thùng 30 Gói Giấy Ăn Sakara XM - Giấy 4 Lớp Siêu Dai - Không Bở Khi Gặp Nước, Không Có Bụi Giấy",39.0,9978205818326,153000,153000,0,0,5,cham-soc-nha-cua
274844577,Nước lau sàn Dreame AWH6 thể tích 1L - Chuyên dụng dành cho Robot / Máy hút bụi - Phụ kiện chính hãng,30.0,7491231226185,350000,550000,200000,36,3,cham-soc-nha-cua
274591247,Khăn Ướt Lau Áo Khoác Tiện Lợi,2.0,5776857145084,15000,15000,0,0,0,cham-soc-nha-cua
274450604,Bột Tẩy Lồng Máy Giặt Cao Cấp CleanZ Giúp Làm Sạch Và Loại Bỏ Cặn Bẩn Hiệu Quả 99%,28.0,8557617473633,55000,55000,0,0,1,cham-soc-nha-cua
274057045,Viên Giặt Tide Pods 4in1 Downy April Fresh 104 viên 2.85kg Hàng Nhập Mỹ,5.0,6263790734570,850000,850000,0,0,0,cham-soc-nha-cua
273926122,Nước Lau Kính  Mr Muscle  Siêu Nhanh 500ml,55.0,1875394221862,34100,35100,1000,3,3,cham-soc-nha-cua
273926091,Bộ đôi Xịt thơm phòng GLADE  Hương Cỏ Hoa 280ml x2,48.0,4633438754328,99200,112300,13100,12,4,cham-soc-nha-cua
273610970,"Sáp Thơm Phòng Khử Mùi  200g Nội Địa Trung, Lọ Thơm Phòng Vệ Sinh Lưu Hương Lâu Cho Không Gian Luôn Sạch Và Thơm - HÀNG CHÍNH HÃNG MINIIN",6.0,9732336723122,17500,17500,0,0,0,cham-soc-nha-cua
270505649,"[Special Edition] Xịt thơm quần áo hương nước hoa cao cấp arFUM lưu hương lâu, khử mùi hiệu quả (250ml)",10.0,2995222330988,139000,139000,0,0,0,cham-soc-nha-cua
263054794,Lọ tỏa hương Ximo Lovenose hương thơm tự nhiên dễ chịu khử mùi thơm phòng 60 ngày - Dung tích 250ml,43.0,4300558880036,45000,45000,0,0,3,cham-soc-nha-cua
250462355,KHĂN GIẤY VUÔNG NAPKIN MYLAN CAO CẤP 24x24 SIÊU TIẾT KIỆM 1KG/GÓI,1.0,5317547566989,77000,77000,0,0,1,cham-soc-nha-cua
249384344,"Bình xịt thơm phòng tự động Air.Wick  250ml, nhập khẩu Châu Âu",14.0,1297364131056,199000,199000,0,0,2,cham-soc-nha-cua
206249713,Viên rửa bát Finish Nhật 150 viên - viên rửa chén finish 150 viên dùng cho máy rửa bát loại nhỏ,283.0,4408350753049,249000,249000,0,0,56,cham-soc-nha-cua
205822414,Muối Rửa Chén Bát Finish Salt - Bịch 1KG,51.0,5829202669380,96000,96000,0,0,5,cham-soc-nha-cua
205507071,Viên Rửa Chén All in 1 Finish Hộp 70 viên - Hương Chanh,7.0,7408782730717,399000,399000,0,0,1,cham-soc-nha-cua
205293768,Bột rửa bát Finish hương chanh 2.5kg ,2.0,5177413823145,169000,169000,0,0,0,cham-soc-nha-cua
205292693,"Combo Viên rửa bát Finish Nhật 150 viên + Muối Finish 1,2kg + Nước làm bóng Finish 400ml",12.0,4684642124492,409000,409000,0,0,2,cham-soc-nha-cua
199142505,Gói 100 tờ khăn giấy vuông Bless You Cao Cấp 33x33cm,435.0,4734579235129,19000,19000,0,0,8,cham-soc-nha-cua
192714846,Bình xịt tẩy nấm mốc Astonish C1121 750ml,5.0,7034456935058,149000,149000,0,0,0,cham-soc-nha-cua
178027215,Nước tẩy trắng quần áo Javel Hando 500ml,15.0,5729890697205,15000,15000,0,0,0,cham-soc-nha-cua
174619837,Combo 3 cuộn giấy giấy vệ sinh cuộn lớn 2 lớp 500g AN KHANG CARO  | 100% Bột giấy nguyên sinh,117.0,2939799490205,144000,144000,0,0,10,cham-soc-nha-cua
168369805,Combo Muối rửa bát Finish 4kg nhập khẩu Đức (PL) + Tặng viên Finish Nhật,11.0,7944141375723,71397,71397,0,0,1,cham-soc-nha-cua
156221768,Sáp Thơm AMBIPUR 180G,71.0,7841483184262,51100,61500,10400,17,6,cham-soc-nha-cua
153514472,Chai Xịt Tẩy Rửa Đa Năng Kitchen Cleaner 500ml – Tẩy Rửa Nhà Bếp Dạng Bọt - Hàng Loại 1 Chính Hãng,187.0,4522605271150,35000,35000,0,0,28,cham-soc-nha-cua
150877654,Combo Sản Phẩm Gốc Thực Vật NRTC1 Peace Mass Nước Rửa Tay 340ml + Nước Rửa Chén 500ml (Thuộc nhóm Sản phẩm Lành tính / Hữu cơ/ Sinh học),34.0,8891421468042,64800,64800,0,0,5,cham-soc-nha-cua
136876263,"Sáp khử mùi tủ lạnh - than hoạt tính, giúp khử mùi mạnh mẽ các mùi khó chịu đáng lo ngại với sức mạnh của than củi - nội địa Nhật Bản",17.0,9488834704530,39500,39500,0,0,1,cham-soc-nha-cua
122910442,Muối Rửa Bát Finish 4.0kg,19.0,9874505796219,108958,108958,0,0,1,cham-soc-nha-cua
121088301,"[TẶNG Chai Xịt 500ml] Dung Dịch Kháng Khuẩn, Khử mùi Nano Xpure Nano Silver 35ppm 4L (Không Mùi) Dùng với Máy Phun Sương – Nano Bạc AHT Corp (AHTC)",4.0,1642614925791,440000,550000,110000,20,1,cham-soc-nha-cua
62377753,Xịt phòng Sandokkaebi chai 300ml ( sản phẩm có nhiều mùi hương để bạn chọn lựa ) - Hàng nội địa Hàn Quốc.,5.0,9634714520328,68500,68500,0,0,1,cham-soc-nha-cua
16935103,"Nước rửa chén Mr.Fresh 4,2L Hàn Quốc Hương Trà Xanh",203.0,2178051241494,90000,90000,0,0,40,cham-soc-nha-cua
767334,Thuốc Diệt Kiến Trong 1 Ngày Sạch Kiến Không Quay Lại Hanvet,57.0,4743685991527,26999,26999,0,0,2,cham-soc-nha-cua
277839808,Combo 5 Bộ Viên Treo Vệ Sinh Bồn Cầu Vim Power 5 | Sạch Thơm Đến 300 Lần Xả (50g-55g/viên),3227.0,4753431325310,120000,120000,0,0,220,cham-soc-nha-cua
277564323,"Băng Dán Cá Nhân Hộp 100 Miếng – Băng Gâu Dán Vết Thương Nhiều Kích Cỡ, Bảo Vệ Hiệu Quả - HÀNG CHÍNH HÃNG MINIIN",1.0,4723444819515,19000,19000,0,0,0,cham-soc-nha-cua
277227998,Túi viên giặt Maxpure Hương Đắm Say 30v,1.0,1610667439572,95000,95000,0,0,0,cham-soc-nha-cua
276531129,Xịt Thơm & Làm Phẳng ( Ủi Thẳng) Quần Áo Zily 4.7 Kg,1.0,8957856822581,793100,924000,130900,14,0,cham-soc-nha-cua
276230118,Túi Nước Giặt ARIEL Chuyên Gia Cửa Trên Ngăn Lem Màu - Hương Downy Nắng Sớm 3.65KG,122.0,1241578579841,199000,236500,37500,16,7,cham-soc-nha-cua
275984452,[Mới] Viên rửa chén bát hương chanh Finish Ultimate Plus All in one túi 33 viên - dòng siêu cao cấp,39.0,6443121486807,315000,414000,99000,24,3,cham-soc-nha-cua
275591786,Viên rửa bát Finish All in one max 100 viên made in EU hoặc 100 viên finish Essential  6 chức năng trong 1,0.0,6111281371052,318900,318900,0,0,2,cham-soc-nha-cua
275243413,Dầu bồ đề Thái Lan Massage Balm - ￼Dầu Cù Là Dầu Lăn Dầu Gió Lá Bồ Đề Nội Địa Thái Lan,25.0,9749749201851,45000,45000,0,0,2,cham-soc-nha-cua
275210514,Giấy ăn rút treo tường PRIME kích thước 175 x 190 (400gr)  làm từ bột gỗ nguyên chất,9.0,8607894757463,69000,69000,0,0,0,cham-soc-nha-cua
273874372,Sáp ong đánh bóng đồ gỗ tặng kèm 1 khăn lau đa năng,24.0,1969631932396,49000,55000,6000,11,0,cham-soc-nha-cua
273455312,"Túi nước giặt xả Funu 3.6kg 5 in 1 hương nước hoa cao cấp, giặt sạch ngăn tái bám, giữ bền màu cho vải, làm mềm và ảo vệ sợi vải - Hàng chính hãng",19.0,8435239771731,123500,130000,6500,5,4,cham-soc-nha-cua
271961594,Dung Dịch Diệt Khuẩn Đa Năng Dettol 1L,129.0,3061529655654,239000,269000,30000,11,11,cham-soc-nha-cua
267416528,Giấy Thơm Quần Áo Bounce Dùng Cho Máy Sấy Outdoor Fresh 80 Tờ,20.0,2030389931088,168000,210000,42000,20,3,cham-soc-nha-cua
215466253,Viên rửa bát Finish Nhật bản 150 viên - Viên finish power cube 150v dùng cho máy rửa bát chén loại nhỏ từ 6 - 8 - 9 -10 bộ bát đĩa,10.0,8379744827538,258000,258000,0,0,1,cham-soc-nha-cua
205290855,"Muối rửa bát Finish 1.2kg, muối finish 1,2kg là muối làm mềm nước trong máy rửa chén bát ly 1200g",3.0,4887169415173,139000,278000,139000,50,0,cham-soc-nha-cua
191320689,"Nước Giặt Hương Hoa Surf 3,1L-3,5L",11.0,5654213867359,130000,130000,0,0,1,cham-soc-nha-cua
191320537,Bột giặt Surf ngát hương xuân 5.5kg,17.0,3750391586718,158000,158000,0,0,0,cham-soc-nha-cua
160299786,Nước Rửa Chén Bát Sunlight Chanh 100 Sạch Nhanh Xả Bọt Nhanh Rửa Sạch Dầu Mỡ 3.6kg,2367.0,4047680474074,105000,125000,20000,16,291,cham-soc-nha-cua
139723798,"Xịt Phòng Tinh Dầu Hữu Cơ Organic 24Care - Kháng khuẩn - Khử mùi hôi - Đuổi muỗi, kiến ba khoan - côn trùng - Hương thơm thư giãn. ",3167.0,3874570346979,25000,25000,0,0,266,cham-soc-nha-cua
115667006,"[COMBO 6 LỐC] Khăn giấy lụa, khăn đa năng Premier Vinatissue 2 lớp 100% bột giấy nguyên sinh, không chất tẩy 280 tờ",4134.0,2283295446954,111000,111000,0,0,339,cham-soc-nha-cua
107741822,"[TỰ CHỌN 13 MÙI] Xịt Phòng Tinh Dầu Hữu Cơ Organic 24Care 50ML - Khử Mùi, Đuỗi Muỗi và Côn Trùng, Xịt Thơm Quần Áo",307.0,6281770333641,25000,25000,0,0,21,cham-soc-nha-cua
103332605,COMBO 8 GÓI GIẤY ĂN ĐA NĂNG 3 LỚP 150 TỜ ll TISSUE ,13.0,4699410373250,90000,90000,0,0,0,cham-soc-nha-cua
89802357,Nước rửa chén bát sinh học ENZYCO 850ml - Chiết xuất Bồ hòn và Enzyme Dứa,243.0,4629113860156,129000,129000,0,0,28,cham-soc-nha-cua
73594204,Dung Dịch Diệt Khuẩn Đa Năng Dettol 1L,114.0,5691306940548,202400,202400,0,0,22,cham-soc-nha-cua
73314753,Combo 02 Viên thả khử mùi bồn tiểu đứng (dành cho nam) 15g - Nhập khẩu Nhật Bản,76.0,2596289388499,75500,75500,0,0,6,cham-soc-nha-cua
72895399,"Set 03 Hộp hút ẩm, khử mùi Kokubo 450ml - Nội địa Nhật Bản",6.0,4021579407126,135000,135000,0,0,0,cham-soc-nha-cua
68257367,Nước rửa chén hữu cơ Bồ hòn Ecocare tinh dầu Chanh Gừng 2000ml ,119.0,8347509843274,215000,280000,65000,23,24,cham-soc-nha-cua
58918466,Viên Giặt Kirkland Signature Ultra Clean 152 Viên Của Mỹ - Mẫu mới,88.0,6707854634583,740000,740000,0,0,19,cham-soc-nha-cua
55882427,Viên rửa bát Finish Quantum Max 60 Viên 14 in 1 - Hanoimart,33.0,2775175256016,399000,399000,0,0,3,cham-soc-nha-cua
51315018,Nước Rửa Chén Layer Clean - Nước Rửa Chén Hữu Cơ - Nước Rửa Chén 5L,616.0,9085000575063,172000,172000,0,0,83,cham-soc-nha-cua
41356464,Nước Rửa Chén Bát Sunlight Thiên Nhiên Muối Khoáng & Lô Hội 3.6kg,26553.0,1648617548929,127000,150000,23000,15,2697,cham-soc-nha-cua
39324852,Nước lau sàn S.P.Ca Premium 4.5 Lít - Sả & Chanh,223.0,5540919063369,104800,131000,26200,20,29,cham-soc-nha-cua
39292644,Nước làm bóng Finish 1150ml,17.0,1237106910189,265000,265000,0,0,3,cham-soc-nha-cua
34007082,Chai Tẩy vệ sinh toilet Mr.Fresh 1L siêu mạnh hương ngàn hoa,171.0,9438989622127,26000,26000,0,0,28,cham-soc-nha-cua
29882824,Túi than hoạt tính khử mùi xe hơi Hapaku - 100% từ gáo dừa Bến Tre,1135.0,9452045601895,119000,119000,0,0,145,cham-soc-nha-cua
10005081,Sáp thơm phòng Hando 87g 5 Hương Thơm Tùy Chọn,64.0,3842470233031,17500,17500,0,0,9,cham-soc-nha-cua
7250239,Chất Thông Cống Siêu Mạnh SiFa (1.6kg),58.0,9095548484734,84000,84000,0,0,5,cham-soc-nha-cua
6515571,Combo 6 Hộp Hút Ẩm Khử Mùi Nấm Mốc Hương Lavender 450Ml,37.0,2590392883261,186000,186000,0,0,9,cham-soc-nha-cua
277553834,Nước Làm Bóng Chén Bát  Finish Rinse & Shine Aid 500ML,14.0,5607214825514,290000,370000,80000,22,0,cham-soc-nha-cua
277505354,Nước Giặt Xả Maxkleen Hương Nước Hoa Huyền Diệu Túi 3.6kg,4.0,5891287270859,165000,220000,55000,25,1,cham-soc-nha-cua
277344954,"Xịt phòng tinh dầu Funu cao cấp 400ml, xua đuổi muỗi, côn trùng, khử mùi, làm thơm phòng",7.0,9760079764958,76000,80000,4000,5,3,cham-soc-nha-cua
276292896,"Chế Phẩm Diệt Kiến Greenhome, TKG Bio, Chai 10ml, Thành Phần Tự Nhiên,Diệt Tận Gốc Kiến Hôi,Kiến Lửa",42.0,6156817209168,5900,10000,4100,41,1,cham-soc-nha-cua
276126418,Bột thông cống Hando 100g nội địa,88.0,4624686054411,19000,20000,1000,5,4,cham-soc-nha-cua
275646726,Combo 2 Gói Bột Vệ Sinh Lồng Máy Giặt ,24.0,1563026260675,65000,75000,10000,13,2,cham-soc-nha-cua
275540324,"Thuốc Diệt Kiến Greenhome, Anbio, Chai 10ml, Thành Phần Tự Nhiên, Diệt Tận Gốc Kiến Hôi, Kiến Lửa",42.0,9364623221442,17900,30000,12100,40,3,cham-soc-nha-cua
275430142,"Thuốc diệt mối tận gốc SAMI SAMI, thuốc diệt mối sinh học, diệt cả đàn mà vẫn an toàn cho người, không mùi không ảnh hưởng sức khoẻ",31.0,5228702083272,70000,90000,20000,22,3,cham-soc-nha-cua
275043376,Viên giặt xả tide pods 3in1 mẫu mới bịch 39 viên của mỹ  ,9.0,6181939058874,235000,235000,0,0,1,cham-soc-nha-cua
274507015,"Keo Chà Ron, Trám Chỉ Gạch Chống Nước, Chống Mốc",50.0,8204270123689,24900,24900,0,0,1,cham-soc-nha-cua
274352770,"Chai Nước Thuốc Tẩy X5000, Nước Tẩy Trắng, Tẩy Mốc, Vết Ố Quần Áo, Chăn Ga Nước Tẩy Trắng Cao Cấp X5000 Đánh Bay Mọi Vết Bẩn Không Làm Phai Màu Vải Khử Khuẩn",27.0,4295555738704,49000,55000,6000,11,4,cham-soc-nha-cua
273926133,Xịt Bóng Gỗ Pledge Hương Chanh 300ML,35.0,5408030421371,79900,84200,4300,5,3,cham-soc-nha-cua
273926092,Bộ 2 Sáp Thơm GLADE Hương Anh Đào Lily 180gx2,53.0,6110952433134,90100,113000,22900,20,1,cham-soc-nha-cua
273784529,Viên rửa chén bát Finish Quantum túi 21 viên,186.0,8175521284568,180000,219000,39000,18,7,cham-soc-nha-cua
271377004,Nước xả vải Zily 20ml (10 gói/ dây),21.0,5411140219097,15862,24000,8138,34,0,cham-soc-nha-cua
253132536,Bình Xịt Diệt Mọt/Gián/Kiến/Kiến ba khoang/Muỗi/Côn Trùng Chaindrite - Thái Lan 600ml Chính hãng an toàn sủ dụng,59.0,6406048438782,76000,76000,0,0,2,cham-soc-nha-cua
205881726,"Muối rửa chén Finish Dishwasher Salt 4kg - muối rửa bát finish 4 kg, muối finish 1.2kg, muối finish 1.5kg",436.0,7543878569779,85000,85000,0,0,64,cham-soc-nha-cua
205538329,"Combo Bột rửa bát finish 2,5kg + Muối rửa bát finish1.5kg dùng cho Máy rửa bát",6.0,4639396182253,179000,179000,0,0,2,cham-soc-nha-cua
205417135,Combo Viên rửa bát fnish All in one 120 viên + Dung dịch nước làm bóng finish 800ml + Muối rửa bát chén finish 1.5kg cho Máy rửa bát,1.0,4706582172296,425000,425000,0,0,0,cham-soc-nha-cua
205293596,Vệ sinh máy rửa bát Finish,4.0,8398150813124,115000,115000,0,0,1,cham-soc-nha-cua
205293281,Viên rửa bát Finish Nhật bản 150 viên - Viên finish power cube 150v dùng cho máy rửa bát chén loại nhỏ từ 6 - 8 - 9 -10 bộ bát đĩa,7.0,7801007514677,247999,247999,0,0,0,cham-soc-nha-cua
205293181,"Bột rửa bát Finish 2.5kg dùng cho Máy rửa bát chén, bột finish chính hãng có các trọng lượng bột finish 4.5kg, bột rửa chén finish  2,5kg, bot rua bat finish 1kg",4.0,9089919149265,189000,189000,0,0,1,cham-soc-nha-cua
205291610,"Viên rửa bát Finish All in one 120 viên made in EU, viên finish all in 1 hộp 120 tabs với 6 chức năng trong 1 viên,  viên rửa chén finish 90 viên - viên finish 110 viên - viên finish 100 viên, vienruabat 120V",4.0,3009765226946,118000,118000,0,0,1,cham-soc-nha-cua
188785413,"Lọ thả bồn cầu khử mùi hương thơm tự nhiên, chai thả vệ sinh bồn cầu diệt khuẩn khử mùi cao cấp - Chính hãng MINIIN (Giao mẫu ngẫu nhiên)",74.0,6465929945955,30000,30000,0,0,26,cham-soc-nha-cua
161212458,Nước rửa chén bát Fuwa3e hữu cơ Enzyme sinh học organic 3.8L an toàn cho bé bảo vệ da tay,13.0,8538078584281,335000,335000,0,0,1,cham-soc-nha-cua
157086086,"Hộp 12 Viên Tẩy Vệ Sinh Lồng Máy Giặt, Diệt Khuẩn Và Tẩy Chất Cặn Lồng Máy Giặt Hiệu Quả - Hàng Loại 1 - Chính Hãng MINIIN",343.0,6107102634610,15000,15000,0,0,58,cham-soc-nha-cua
121326211,Muối rửa bát Finish chuyên dùng cho máy rửa chén bát -hàng nhập khẩu,21.0,5379737405066,99000,99000,0,0,2,cham-soc-nha-cua
119363030,"Combo 2 Túi Than Hoạt Tính ECODEALS 250g - Khử mùi, chống nấm mốc, vi khuẩn, khí độc đến 2 năm",273.0,6929307388108,135000,135000,0,0,26,cham-soc-nha-cua
114771870,Nước Giặt Comfort Dưỡng Vải Đa Năng - Hương Thanh Lịch Túi 3.8KG,8017.0,7286667761132,196000,215000,19000,9,829,cham-soc-nha-cua
89261232,Combo 20 gói khăn giấy lau tay An Khang AK20-2 loại hai lớp dài 20cm - 102 tờ/gói,606.0,4094015035599,440000,440000,0,0,68,cham-soc-nha-cua
79555646,"Combo 2 hộp Sáp thơm khử mùi Ami - Hương thơm chiết xuất thiên nhiên, Tỏa hương suốt nhiều tuần (Nhiều lựa chọn mùi hương)",102.0,9642997178268,66000,76950,10950,14,9,cham-soc-nha-cua
72597497,"Nước rửa chén hữu cơ Bồ hòn Ecocare - 100% thực vật, không hóa chất, tinh dầu khử mùi, chăm sóc da tay, tiết kiệm nước 30% - Chai 4000ml",99.0,3748784011559,396000,396000,0,0,13,cham-soc-nha-cua
68522389,Nước làm bóng chén bát Finish Eco 0% - 400ml/ chai,18.0,5456520079562,170000,170000,0,0,5,cham-soc-nha-cua
51567691,Muối rửa bát finish 1.5kg,23.0,9359072371305,128000,128000,0,0,0,cham-soc-nha-cua
50943158, Nước xịt đa năng hữu cơ Bồ hòn và Tinh dầu Sả Chanh 500ml thương hiệu Ecocare,212.0,4249895003581,75000,120000,45000,38,30,cham-soc-nha-cua
20833280,Nước rửa chén bát siêu đậm đặc Mr.fresh 5L hương cam,87.0,2211520976593,96000,96000,0,0,21,cham-soc-nha-cua
2213433,"Diệt Côn Trùng Gián, Kiến, Kiến Ba Khoang, Muỗi, Ruồi, Mối, Mọt 100% Sinh Học Thảo Mộc 10s Hương Sả Chanh Chai Xịt 500ml An Toàn Cho Sức Khỏe Em Bé Và Người Già, Đã Được Bộ Y Tế Cho Phép Lưu Hành",258.0,9749633313606,165000,165000,0,0,47,cham-soc-nha-cua
463748,Chất Làm Sạch Lồng Giặt Mao Bao Ion Bạc Nâng Cấp Mới 300g + 6g,1913.0,9200800953174,43000,50000,7000,14,109,cham-soc-nha-cua
276281186,Nước giặt cao cấp Earth Choice 1L,9.0,3899482311536,93900,105000,11100,11,1,cham-soc-nha-cua
275611423,"Nước tẩy vệ sinh lồng máy giặt Rocket 99,9% của Nhật bản 550g",7.0,2116431453255,95000,95000,0,0,1,cham-soc-nha-cua
275590663,"Nước làm bóng Finish 1600ml, hoặc 800ml dung dịch dầu làm bóng bát finish dùng cho máy rửa bát chén 500ml, 400ml",0.0,1678276393657,158900,158900,0,0,0,cham-soc-nha-cua
275568674,Nước Giặt Xả 5 in 1 Clean & Clean Dùng Cho Cả Giặt Tay Và Giặt Máy 3.2l/túi,5.0,6291633649890,99000,99000,0,0,1,cham-soc-nha-cua
275413034,Thuốc diệt chuột thái lan tiêu diệt cả đàn sau 3 ngày tặng kèm thuốc diệt dán và kiến,60.0,1387373383085,70000,70000,0,0,2,cham-soc-nha-cua
274593528,"Thùng 30 gói Khăn Giấy Rút Gấu Trúc 3 Lớp MyLan Siêu Dai, Mềm Mịn, thấm hút tốt",21.0,9026572431637,198000,198000,0,0,3,cham-soc-nha-cua
273399877,"Giấy ăn giấy rút PRIME thùng 30 gói rút, giấy ăn hàng cao cấp",21.0,5512998681394,65000,65000,0,0,2,cham-soc-nha-cua
272619673,Khăn Ăn Premier VinaTissue 100 Tờ,27.0,8167100108712,12200,12200,0,0,4,cham-soc-nha-cua
271322352,Nước rửa chén hữu cơ enzyme sinh học dứa Fuwa3e 3.8L ,19.0,1802408376773,302000,302000,0,0,7,cham-soc-nha-cua
270690235,Giấy thơm quần áo Bounce Outdoor Fresh 5in1 của Mỹ (320 tờ),19.0,5587782808360,399000,399000,0,0,1,cham-soc-nha-cua
212563547,"Thuốc Diệt Muỗi Greenhome, Fendona 10sc, Gói 5ml, Hiệu Quả, Không Mùi, Dễ Dùng, Diệt Gián, Ruồi, Kiến Ba Khoang",169.0,5386707170103,16800,32000,15200,48,5,cham-soc-nha-cua
205293913,Combo Muối rửa bát finish 1.5kg + Nước làm bóng finish 800ml dùng cho Máy rửa bát chén,10.0,8907435125954,268000,268000,0,0,1,cham-soc-nha-cua
201938903,Combo 2 Kem tẩy chuyên dụng Sunlight | Phiên bản nâng cấp từ Cif | Siêu sạch Siêu sáng | Chai 690g,252.0,6213918343128,65000,80000,15000,19,19,cham-soc-nha-cua
197740208,"Muối rửa ly Somat Spezial Salz 1,2 Kg",193.0,6364217755669,109000,162000,53000,33,14,cham-soc-nha-cua
196177335,Lốc 10 Cuộn Giấy Vệ Sinh Bless You À La Vie Cao Cấp Mềm Mịn,681.0,7394749307315,96000,96000,0,0,22,cham-soc-nha-cua
178951602,Khăn giấy bỏ túi Tempo Petit hương Gỗ Táo (18 gói),1.0,9962789374548,75000,75000,0,0,0,cham-soc-nha-cua
172573467,Nước Lau Kính Kết Hợp Lau Bếp Gốc Thực Vật - Tinh dầu Bạc hà Peace Mass Làm Sạch Hoàn Hảo Vết Mỡ Ở Bếp Nấu (Thuộc nhóm Sản phẩm Lành tính / Hữu cơ/ Sinh học) Chai Xịt 700ml,127.0,8235637857948,92000,92000,0,0,10,cham-soc-nha-cua
169270858,Gói vệ sinh tẩy rửa lồng máy giặt sinh học Kokubo 750g - Hàng nội địa Nhật Bản (#Made in Japan),4.0,3394384467470,364500,364500,0,0,0,cham-soc-nha-cua
168369843,Viên rửa bát Finish all in one 120 viên,16.0,3075212006951,469000,469000,0,0,2,cham-soc-nha-cua
162209815,Gel rửa chén Finish Eco 0% 900ml,9.0,1058946593148,329000,329000,0,0,0,cham-soc-nha-cua
133419682,Viên rửa bát finish nhật dùng cho máy rửa bát 100 viên,14.0,9299452070816,319000,319000,0,0,2,cham-soc-nha-cua
124954933,[HCM] Vệ sinh máy rửa bát finish vỉ 3 viên,58.0,4224391145995,130000,130000,0,0,9,cham-soc-nha-cua
121326912,Nước làm bóng (dầu bóng ) chuyên dùng cho máy rửa chén ly bát,0.0,9447683937827,112000,224000,112000,50,0,cham-soc-nha-cua
121326249,"Viên rửa bát FinishAllin1 sh ,Muối rửa bát Finish ,Muối rửa bát Finish.",3.0,4742042466536,99000,99000,0,0,1,cham-soc-nha-cua
117286335,"Nước rửa chén bát thiên nhiên, không hại da tay Nhật bản chính hãng",11.0,5900564427242,38500,38500,0,0,0,cham-soc-nha-cua
104950776,"Đầy đủ phụ kiện thay thế cho Robot Medion MD 18500, 18501, 19510, 19511 (chổi quét, màng hepa, giẻ, khay dính giẻ,..)",136.0,6262904185776,70000,70000,0,0,14,cham-soc-nha-cua
101359079,Combo 3 Cốc thả bồn cầu tẩy xanh toilet Hàn Quốc Mr Fresh 180g hương ngàn hoa,154.0,5247765527230,113000,113000,0,0,33,cham-soc-nha-cua
84796848,Bột thông cống Hando 280g,51.0,3134263182835,28000,28000,0,0,6,cham-soc-nha-cua
84795188,Chai xịt  thơm lau nhà bếp tẩy dầu mỡ Hando 500ml,243.0,1098652700769,26000,26000,0,0,16,cham-soc-nha-cua
84794032,Nước lau bàn khử mùi hương quế Hando 500ml,289.0,2491525541378,30000,30000,0,0,11,cham-soc-nha-cua
74003941,Túi thơm Pure Aroma 26g,101.0,2700815224803,25000,25000,0,0,9,cham-soc-nha-cua
68179518,Nước Tẩy Nhà Tắm Mao Bao 600ml,221.0,8895813574426,44000,50000,6000,12,25,cham-soc-nha-cua
52789196,"Bột rửa chén Finish Dishwasher Power Powder Lemon Sparkle 2,5 kg QT017384 - hương chanh",46.0,1925060925607,355000,355000,0,0,7,cham-soc-nha-cua
52232693,Combo Tiết Kiệm 5 Chai Xịt Chống Muỗi Và Côn Trùng Cho Trẻ Nhỏ Và Gia Đình Bảo Nhiên Chai 100ml - Chăm Sóc Và Bảo Vệ Làn Da Trẻ Nhỏ,20.0,4259447117642,195000,329000,134000,41,2,cham-soc-nha-cua
52052246,Nước làm bóng finish 800ml dùng cho Máy rửa bát chén,14.0,3205258409286,160000,160000,0,0,2,cham-soc-nha-cua
44970520,Nước Rửa Chén Gốc Thực Vật Peace Mass Dùng Được Cho Máy Rửa Chén (Thuộc nhóm Sản phẩm Lành tính / Hữu cơ/ Sinh học) Chai 500ml,334.0,6753464493607,36000,36000,0,0,35,cham-soc-nha-cua
24495867,"Bột Thông Tắc Bồn Cầu, Thông Tắc Cống Sifa Đa Năng Siêu Nhanh 200g",466.0,2366811631658,32900,32900,0,0,18,cham-soc-nha-cua
15519960,Men Vi Sinh Xử Lý Hầm Cầu Ecoclean septic 1 gói 100g,2310.0,5150632663076,82000,82000,0,0,121,cham-soc-nha-cua
12482348,Nước Lau Kính Hando Hương Hoa 600ml,0.0,5132893659159,26000,26000,0,0,0,cham-soc-nha-cua
576195,Nước Giặt Cổ Áo Mao Bao 600ml,562.0,3829625483251,48000,60000,12000,20,66,cham-soc-nha-cua
277227989,Mua 3 Vỉ Viên treo bồn cầu Evershine Hương Lavender 54gr được tặng 1 Viên treo bồn cầu hương chanh,1.0,2525560351701,75000,75000,0,0,0,cham-soc-nha-cua
276643286,"[MUA 1 LỐC TẶNG 1 CUỘN GVS 4 LỚP PRESTIGE] Giấy vệ sinh cao cấp Tempo Toipa - 3 lớp bền dai, an toàn cho da - Thương hiệu Đức (Lốc 10 Cuộn)",4.0,8247262762134,210000,210000,0,0,0,cham-soc-nha-cua
276281188,Nước xả cao cấp Earth Choice 1L,7.0,1167500595130,97900,105000,7100,7,0,cham-soc-nha-cua
276251356,Khăn Giấy Hộp Giấy Rút Pulppy 2 Lớp Mềm Mịn Siêu Dai 180 Tờ 2 Lớp,3.0,5911058459323,35000,65000,30000,46,0,cham-soc-nha-cua
276117111,"SÁP THƠM PHÒNG RENUZIT 198G SỬ DỤNG PHÒNG LÀM VIỆC, PHÒNG NGỦ, PHÒNG VỆ SINH - NHẬP KHẨU MỸ - NHIỀU MÙI HƯƠNG",4.0,2873072595494,42300,45000,2700,6,1,cham-soc-nha-cua
276081641,Viên giặt xả Bold GelBall 4D P&G hương hoa tươi mát hộp 11 viên,8.0,7552206271895,80200,89000,8800,10,1,cham-soc-nha-cua
275617849,"Bột thông cống sinh học AMB, Viện Hàn lâm khoa học Việt Nam thông tác cống, đường ống bồn rửa bát, rửa mặt",37.0,3281601011205,68000,68000,0,0,4,cham-soc-nha-cua
274654430,Thùng Giấy Ăn 30 Gói Giấy Rút Gấu Trúc Cao Cấp Sipiao Mềm Mịn Dẻo Dai Tiện Lợi Thấm Hút Tốt,7.0,1989415856509,3000,4000,1000,25,0,cham-soc-nha-cua
274574776,"Siêu Tẩy Cặn CanXi Đa Năng, Các Vết Ố Lâu Ngày Siêu Sáng Bóng Tẩy Cặn Canxi Nhà Tắm Đa Năng Tẩy Kính Vòi Sen Bồn Cầu Chậu Tắm Gạch Men Nhà Vệ Sinh Chống Ăn Mòn Inox ",21.0,9359246904432,19000,36100,17100,47,1,cham-soc-nha-cua
274036338,"Chai Thả Bồn Cầu Ma Thuật Khử Mùi Diệt Khuẩn Cao Cấp, Lọ Tẩy Bồn Cầu Hương Thơm Tự Nhiên",97.0,5668712575068,7000,13000,6000,46,4,cham-soc-nha-cua
273726132,Giấy Ăn Rút Hình Chữ Nhật Dạng Cây (1 Cây 1680 Tờ) Hình Thỏ Bịch Khăn Giấy Rút 1680 Tờ 4 Lớp Treo Tường Cỡ Lớn Tiện Dụng,14.0,9520577011528,65000,75000,10000,13,0,cham-soc-nha-cua
273716910,Sáp Thơm Phòng Khử Mùi Phòng Ngủ Nhà Vệ Sinh Toilet Ô Tô Với Mùi Hương Tự Nhiên Siêu Tiện Lợi - Giao mùi ngẫu nhiên,125.0,3165176677603,10000,19000,9000,47,5,cham-soc-nha-cua
273185463,Viên & nước giặt xả BOLD 4D gelball Lip Happiness hương Lavender & Floral Garden (túi/hộp),30.0,8225128096624,90000,90000,0,0,5,cham-soc-nha-cua
271621656,Nước Tẩy Trắng - Tẩy Mốc Quần Áo Công Nghệ SInh Học ECOHOME 280G Đánh Bay Mọi Vết Ố Mốc Lâu Ngày Bám Trên Balo Túi,16.0,6456279997474,56000,112000,56000,50,1,cham-soc-nha-cua
205293933,"Combo 2 Can Bột rửa bát finish 2,5kg dùng cho máy rửa bát (2.5x2=5kg)",0.0,8874479860497,239000,478000,239000,50,0,cham-soc-nha-cua
201852320,"Giấy vệ sinh cuộn lớn chất lượng cao, siêu mịn PONYO JB700 2 lớp hoạ tiết caro/trơn 700g - Thiên An Nam paper",168.0,6253275722972,29750,35000,5250,15,4,cham-soc-nha-cua
197581415,1Kg Bột Baking Soda Đa Rửa Rau Hay Trái Cây TETE,54.0,6931324718507,62000,62000,0,0,9,cham-soc-nha-cua
196177336,Khăn Giấy Lụa Rút 2 lớp Bless You À La Vie cao cấp x 250 tờ,981.0,5396550462241,28900,28900,0,0,12,cham-soc-nha-cua
186106374,NƯỚC GIẶT GOOD CARE 3L.,26.0,8141363419991,182080,182080,0,0,4,cham-soc-nha-cua
176050461,COMBO (10 bịch/ 100 cuộn) Giấy vệ sinh Ero giá sỉ chất lượng (10 cuộn/ bịch),18.0,2380819655905,240000,240000,0,0,7,cham-soc-nha-cua
172842237,Bột thông tắc bồn cầu bể phốt xuất khẩu Hando 250Gr ,10.0,2399971644169,39000,39000,0,0,1,cham-soc-nha-cua
171812394,Giấy Ăn Gấu Trúc Cao Cấp Siêu Dai MINIIN - Giấy Rút Sợi Tre An Toàn Không Chất Tẩy Trắng ,98.0,8756169533438,26000,26000,0,0,11,cham-soc-nha-cua
166561434,Combo 03 túi Viên Rửa Chén Bát Hương Chanh Finish Powerball All In 1 Max Lemon Sparkle 30 viên,12.0,5809016382325,397000,397000,0,0,1,cham-soc-nha-cua
154501654,KEM TẨY RỬA XOONG NỒI ĐA NĂNG - Hàng Loại 1 - Chính Hãng MINIIN,96.0,8064463857011,15000,15000,0,0,20,cham-soc-nha-cua
150786728,"diệt muỗi , kiến , gián, ve DIỆT CÔN TRÙN VEMEDIM",11.0,5897714506868,28000,28000,0,0,1,cham-soc-nha-cua
133619317,"Giấy ăn Slisoft Trắng 100 tờ x 3 lớp, khăn giấy khô thân thiện môi trường không chất tẩy trắng an toàn cho cả gia đình",179.0,9118231196133,11000,12000,1000,8,2,cham-soc-nha-cua
127493804,"Xịt kháng khuẩn Sả Chanh 24Care - Dung tích 50ml/100ml/250ml - Diệt khuẩn 99,9%, làm sạch, đuổi muỗi, côn trùng",83.0,7063684974690,39000,39000,0,0,15,cham-soc-nha-cua
125409721,Nước lau sàn Nanoka đánh bay mọi vết bẩn - Hàng Chính Hãng,56.0,9981364333065,95000,95000,0,0,1,cham-soc-nha-cua
122910407,Viên rửa bát chén Finish All in 1 Hộp 100 viên(  OEM ),0.0,1474376231210,318900,318900,0,0,0,cham-soc-nha-cua
121325843,Túi Thơm TỦ Quần Áo Denkmit HÀNG CHUẨN ĐỨC,21.0,4863163591022,92000,92000,0,0,2,cham-soc-nha-cua
96708638,Máy xịt thơm phòng cảm biến Glade nội địa Nhật (gồm máy & 01 lõi tinh dầu),243.0,5953400563034,175000,175000,0,0,57,cham-soc-nha-cua
75521920,Combo 10 cuộn giấy vệ sinh lớn An Khang AKC500 hai lớp loại 500gr,1310.0,4346693980431,321000,321000,0,0,205,cham-soc-nha-cua
72476756,"ComBo 2 Chai Nước Rửa Chén Hữu Cơ Layer Clean - Hương Qủa Hồng, Thể Tích: 800ml",14.0,1697775390666,69000,69000,0,0,1,cham-soc-nha-cua
66587401,"Nước Lau Sàn Hữu Cơ Bồ Hòn Ecocare - 100% thực vật, tinh dầu khử mùi, đuổi muỗi, chống trượt, kháng khuẩn - Chai 1000ml",55.0,9881504895641,72000,75000,3000,4,9,cham-soc-nha-cua
41619873,Chất Làm Sạch Bình Đun Nước Mao Bao 25g x 1 gói,907.0,6758499426118,21500,25000,3500,14,43,cham-soc-nha-cua
39327784,LỐC GIẤY THƠM QUẦN ÁO BOUNCE 160x2 TỜ (TOTAL 320 SHEETS) CỦA MỸ ,15.0,1455566666518,399000,399000,0,0,1,cham-soc-nha-cua
12425736,"Lốc 4 Gói Khăn Giấy Cao Cấp Tempo Softpack Mùi Bạc Hà, 4 Lớp, Không Gây Kích Ứng Da (90 Tờ/ Gói) - Thương Hiệu Đức",328.0,7577788139688,122000,122000,0,0,12,cham-soc-nha-cua
5183153,"Combo 4 chai tẩy diệt khuẩn bồn cầu, toilet hương hoa ly Mr.Fresh Korea 180g",4.0,5284765226515,165000,165000,0,0,0,cham-soc-nha-cua
3904895,Combo 2 túi nước rửa chén hương táo loại túi 500 ml Rocket nội địa Nhật Bản,86.0,3071737438654,62682,62682,0,0,6,cham-soc-nha-cua
2983889,Chất Tẩy Bẩn Đa Năng Siêu Sạch Sumo (700g),166.0,7622257655067,54000,54000,0,0,28,cham-soc-nha-cua
